Rk,Player,Att,Rec,Touch,Season,Age,Team,G,GS,Att,Yds,Y/A,TD,Y/G,1D,Succ%,Tgt,Rec,Yds,Y/R,TD,Y/G,Ctch%,Y/Tgt,1D,Succ%,Touch,TotOff,YScm,APYd,RtY,Pos
1,Ameer Abdullah,66,40,106,2024,31,LVR,16,3,66,311,4.7,2,19.4,14,50,47,40,261,6.5,3,16.3,85.1,5.6,16,59.6,106,311,572,959,387,RB
2,De'Von Achane,203,78,281,2024,23,MIA,17,16,203,907,4.5,6,53.4,37,49.3,87,78,592,7.6,6,34.8,89.7,6.8,30,57.5,281,907,1499,1531,32,RB
3,Cam Akers,104,14,118,2024,25,"HOU,MIN",17,2,104,444,4.3,2,26.1,21,38.5,18,14,68,4.9,3,4,77.8,3.8,4,33.3,118,444,512,588,76,RB
4,Rasheen Ali,10,0,10,2024,23,BAL,6,0,10,31,3.1,0,5.2,2,40,2,0,0,,0,0,0,0,0,0,10,31,31,138,107,RB
5,Braelon Allen,92,19,111,2024,20,NYJ,17,2,92,334,3.6,2,19.6,22,51.1,27,19,148,7.8,1,8.7,70.4,5.5,8,51.9,111,334,482,482,0,RB
6,Tyler Allgeier,137,13,150,2024,24,ATL,17,0,137,644,4.7,3,37.9,43,58.4,13,13,88,6.8,0,5.2,100,6.8,2,46.2,150,644,732,732,0,RB
7,Tyler Badie,11,3,14,2024,24,DEN,3,0,11,86,7.8,0,28.7,4,54.5,3,3,-2,-0.7,0,-0.7,100,-0.7,0,0,14,86,84,84,0,RB
8,Saquon Barkley,345,33,378,2024,27,PHI,16,16,345,2005,5.8,13,125.3,82,52.5,43,33,278,8.4,2,17.4,76.7,6.5,12,44.2,378,2003,2283,2283,0,RB
9,Andrew Beck,0,0,0,2024,28,"GNB,HOU",4,0,0,0,,0,0,0,,2,0,0,,0,0,0,0,0,0,0,0,0,0,0,FB
10,Trey Benson,63,6,69,2024,22,ARI,13,1,63,291,4.6,1,22.4,16,49.2,6,6,59,9.8,0,4.5,100,9.8,3,100,69,291,350,350,0,RB
11,Tank Bigsby,168,7,175,2024,23,JAX,16,1,168,766,4.6,7,47.9,39,49.4,12,7,54,7.7,0,3.4,58.3,4.5,1,25,175,766,820,1015,195,RB
12,Raheem Blackshear,15,0,15,2024,25,CAR,16,1,15,80,5.3,0,5,2,46.7,0,0,0,,0,0,,,0,,15,80,80,1016,936,RB
13,Khari Blasingame,0,0,0,2024,28,"CHI,PHI",5,0,0,0,,0,0,0,,0,0,0,,0,0,,,0,,0,0,0,0,0,FB
14,Mike Boone,13,1,14,2024,29,CAR,6,0,13,51,3.9,0,8.5,3,61.5,3,1,-2,-2,0,-0.3,33.3,-0.7,0,0,14,51,49,49,0,RB
15,Gary Brightwell,0,0,0,2024,25,CLE,2,0,0,0,,0,0,0,,0,0,0,,0,0,,,0,,0,0,0,36,36,RB
16,British Brooks,1,0,1,2024,25,HOU,5,0,1,2,2,0,0.4,0,0,0,0,0,,0,0,,,0,,1,2,2,2,0,RB
17,Chris Brooks,36,11,47,2024,24,GNB,15,0,36,183,5.1,1,12.2,12,55.6,13,11,69,6.3,0,4.6,84.6,5.3,2,46.2,47,183,252,252,0,RB
18,Jonathon Brooks,9,3,12,2024,21,CAR,3,1,9,22,2.4,0,7.3,0,33.3,3,3,23,7.7,0,7.7,100,7.7,2,66.7,12,22,45,45,0,RB
19,Chase Brown,229,54,283,2024,24,CIN,16,10,229,990,4.3,7,61.9,49,52.4,65,54,360,6.7,4,22.5,83.1,5.5,23,52.3,283,990,1350,1536,186,RB
20,Michael Burton,7,10,17,2024,32,DEN,17,2,7,8,1.1,1,0.5,3,57.1,10,10,65,6.5,1,3.8,100,6.5,3,60,17,8,73,73,0,FB
21,Michael Carter,35,11,46,2024,25,ARI,3,1,35,131,3.7,1,43.7,9,57.1,11,11,57,5.2,0,19,100,5.2,2,63.6,46,131,188,188,0,RB
22,Ty Chandler,56,6,62,2024,26,MIN,17,0,56,182,3.3,0,10.7,9,37.5,6,6,42,7,0,2.5,100,7,2,66.7,62,181,224,429,205,RB
23,Zach Charbonnet,135,42,177,2024,23,SEA,17,6,135,569,4.2,8,33.5,32,47.4,52,42,340,8.1,1,20,80.8,6.5,6,40.4,177,569,909,909,0,RB
24,Julius Chestnut,22,2,24,2024,24,TEN,17,0,22,102,4.6,0,6,2,45.5,3,2,11,5.5,0,0.6,66.7,3.7,0,33.3,24,102,113,450,337,RB
25,Nick Chubb,102,5,107,2024,29,CLE,8,8,102,332,3.3,3,41.5,17,41.2,11,5,31,6.2,1,3.9,45.5,2.8,3,27.3,107,332,363,363,0,RB
26,Chris Collier,5,1,6,2024,24,"LVR,BAL",8,0,5,12,2.4,0,1.5,0,20,2,1,-4,-4,0,-0.5,50,-2,0,0,6,12,8,294,286,RB
27,James Conner,236,47,283,2024,29,ARI,16,16,236,1094,4.6,8,68.4,67,51.7,55,47,414,8.8,1,25.9,85.5,7.5,17,56.4,283,1094,1508,1508,0,RB
28,Dalvin Cook,8,1,9,2024,29,DAL,2,0,8,20,2.5,0,10,0,37.5,1,1,10,10,0,5,100,10,1,100,9,20,30,30,0,RB
29,James Cook,207,32,239,2024,25,BUF,16,16,207,1009,4.9,16,63.1,48,53.1,38,32,258,8.1,2,16.1,84.2,6.8,14,50,239,1009,1267,1267,0,RB
30,Blake Corum,58,7,65,2024,24,LAR,17,1,58,207,3.6,0,12.2,12,43.1,8,7,58,8.3,0,3.4,87.5,7.3,5,87.5,65,207,265,451,186,RB
31,DeeJay Dallas,9,3,12,2024,26,ARI,17,0,9,49,5.4,0,2.9,4,66.7,3,3,11,3.7,1,0.6,100,3.7,1,33.3,12,49,60,519,459,RB
32,Isaiah Davis,30,9,39,2024,22,NYJ,17,0,30,174,5.8,1,10.2,10,63.3,12,9,75,8.3,1,4.4,75,6.3,4,41.7,39,174,249,481,232,RB
33,Ray Davis,113,17,130,2024,25,BUF,17,0,113,442,3.9,3,26,25,45.1,19,17,189,11.1,3,11.1,89.5,9.9,8,63.2,130,442,631,778,147,RB
34,Tyrion Davis-Price,3,0,3,2024,24,PHI,1,0,3,7,2.3,0,7,0,0,0,0,0,,0,0,,,0,,3,7,7,7,0,RB
35,Emari Demercado,24,16,40,2024,25,ARI,13,0,24,223,9.3,1,17.2,8,50,20,16,104,6.5,0,8,80,5.2,3,35,40,223,327,391,64,RB
36,J.K. Dobbins,195,32,227,2024,26,LAC,13,11,195,905,4.6,9,69.6,47,42.6,38,32,153,4.8,0,11.8,84.2,4,6,26.3,227,905,1058,1058,0,RB
37,Rico Dowdle,235,39,274,2024,26,DAL,16,15,235,1079,4.6,2,67.4,53,53.6,49,39,249,6.4,3,15.6,79.6,5.1,13,53.1,274,1079,1328,1328,0,RB
38,Clyde Edwards-Helaire,13,3,16,2024,25,NOR,2,0,13,46,3.5,0,23,2,46.2,5,3,24,8,0,12,60,4.8,1,20,16,46,70,70,0,RB
39,Gus Edwards,101,3,104,2024,29,LAC,11,6,101,365,3.6,4,33.2,17,49.5,5,3,6,2,0,0.5,60,1.2,0,0,104,365,371,371,0,RB
40,Austin Ekeler,77,35,112,2024,29,WAS,12,6,77,367,4.8,4,30.6,19,51.9,41,35,366,10.5,0,30.5,85.4,8.9,14,53.7,112,367,733,1327,594,RB
41,Ezekiel Elliott,74,12,86,2024,29,DAL,15,2,74,226,3.1,3,15.1,14,43.2,15,12,69,5.8,0,4.6,80,4.6,3,46.7,86,226,295,295,0,RB
42,Audric Estime,76,5,81,2024,21,DEN,13,1,76,310,4.1,2,23.8,15,51.3,5,5,27,5.4,0,2.1,100,5.4,2,40,81,310,337,337,0,RB
43,Travis Etienne,150,39,189,2024,25,JAX,15,15,150,558,3.7,2,37.2,31,45.3,52,39,254,6.5,0,16.9,75,4.9,13,38.5,189,558,812,812,0,RB
44,Darrynton Evans,3,0,3,2024,26,CHI,5,0,3,3,1,0,0.6,0,33.3,0,0,0,,0,0,,,0,,3,3,3,3,0,RB
45,Jerome Ford,104,37,141,2024,25,CLE,14,6,104,565,5.4,3,40.4,25,47.1,43,37,225,6.1,0,16.1,86,5.2,10,37.2,141,565,790,1178,388,RB
46,D'Onta Foreman,71,6,77,2024,28,CLE,11,3,71,232,3.3,0,21.1,10,39.4,8,6,54,9,0,4.9,75,6.8,1,37.5,77,232,286,402,116,RB
47,Kenneth Gainwell,75,16,91,2024,25,PHI,17,1,75,290,3.9,1,17.1,12,24,22,16,116,7.3,0,6.8,72.7,5.3,5,40.9,91,290,406,862,456,RB
48,Myles Gaskin,3,1,4,2024,27,MIN,5,0,3,-1,-0.3,0,-0.2,0,0,1,1,11,11,0,2.2,100,11,0,100,4,-1,10,70,60,RB
49,Jahmyr Gibbs,250,52,302,2024,22,DET,17,4,250,1412,5.6,16,83.1,70,53.6,63,52,517,9.9,4,30.4,82.5,8.2,25,55.6,302,1412,1929,1929,0,RB
50,Antonio Gibson,120,23,143,2024,26,NWE,17,3,120,538,4.5,1,31.6,24,45,29,23,206,9,0,12.1,79.3,7.1,11,51.7,143,538,744,983,239,RB
51,Reggie Gilliam,3,0,3,2024,27,BUF,15,0,3,7,2.3,0,0.5,1,33.3,0,0,0,,0,0,,,0,,3,7,7,7,0,FB
52,Tyler Goodson,32,11,43,2024,24,IND,16,0,32,153,4.8,1,9.6,6,46.9,15,11,61,5.5,1,3.8,73.3,4.1,3,33.3,43,153,214,451,237,RB
53,Eric Gray,14,10,24,2024,25,NYG,17,0,14,31,2.2,0,1.8,1,28.6,11,10,82,8.2,0,4.8,90.9,7.5,3,54.5,24,31,113,667,554,RB
54,Isaac Guerendo,84,15,99,2024,24,SFO,16,3,84,420,5,4,26.3,18,47.6,16,15,152,10.1,0,9.5,93.8,9.5,7,56.3,99,420,572,735,163,RB
55,Troy Hairston,0,0,0,2024,26,HOU,2,0,0,0,,0,0,0,,0,0,0,,0,0,,,0,,0,0,0,0,0,FB
56,Breece Hall,209,57,266,2024,23,NYJ,16,16,209,876,4.2,5,54.8,40,46.4,76,57,483,8.5,3,30.2,75,6.4,15,36.8,266,876,1359,1359,0,RB
57,C.J. Ham,2,5,7,2024,31,MIN,17,3,2,10,5,1,0.6,1,100,6,5,35,7,0,2.1,83.3,5.8,1,33.3,7,10,45,45,0,FB
58,Najee Harris,263,36,299,2024,26,PIT,17,17,263,1043,4,6,61.4,50,43.7,48,36,283,7.9,0,16.6,75,5.9,13,45.8,299,1043,1326,1326,0,RB
59,Hassan Haskins,34,3,37,2024,25,LAC,17,0,34,89,2.6,2,5.2,13,50,3,3,49,16.3,1,2.9,100,16.3,2,100,37,89,138,173,35,RB
60,Jamycal Hasty,20,10,30,2024,28,NWE,15,0,20,69,3.5,0,4.6,4,45,12,10,59,5.9,1,3.9,83.3,4.9,2,41.7,30,69,128,366,238,RB
61,Derrick Henry,325,19,344,2024,30,BAL,17,17,325,1921,5.9,16,113,94,58.8,22,19,193,10.2,2,11.4,86.4,8.8,11,68.2,344,1921,2114,2114,0,RB
62,Khalil Herbert,36,10,46,2024,26,"CHI,CIN",14,1,36,130,3.6,1,9.3,10,55.6,11,10,25,2.5,0,1.8,90.9,2.3,0,27.3,46,130,155,279,124,RB
63,Justice Hill,47,42,89,2024,27,BAL,15,0,47,228,4.9,1,15.2,14,44.7,51,42,383,9.1,3,25.5,82.4,7.5,17,49,89,228,611,794,183,RB
64,George Holani,3,1,4,2024,25,SEA,5,0,3,10,3.3,0,2,1,66.7,1,1,-1,-1,0,-0.2,100,-1,0,0,4,10,9,9,0,RB
65,Travis Homer,6,3,9,2024,26,CHI,10,0,6,23,3.8,0,2.3,2,66.7,3,3,11,3.7,0,1.1,100,3.7,0,33.3,9,23,34,63,29,RB
66,Chuba Hubbard,250,43,293,2024,25,CAR,15,15,250,1195,4.8,10,79.7,62,54.8,54,43,171,4,1,11.4,79.6,3.2,10,31.5,293,1195,1366,1366,0,RB
67,Evan Hull,0,0,0,2024,24,IND,1,0,0,0,,0,0,0,,0,0,0,,0,0,,,0,,0,0,0,0,0,RB
68,Kareem Hunt,200,23,223,2024,29,KAN,13,8,200,728,3.6,7,56,42,55.5,32,23,176,7.7,0,13.5,71.9,5.5,10,53.1,223,728,904,904,0,RB
69,Alec Ingold,10,11,21,2024,28,MIA,15,10,10,17,1.7,1,1.1,6,60,12,11,96,8.7,0,6.4,91.7,8,3,66.7,21,17,113,113,0,FB
70,Keaontay Ingram,0,0,0,2024,25,KAN,1,0,0,0,,0,0,0,,0,0,0,,0,0,,,0,,0,0,0,0,0,RB
71,Bucky Irving,207,47,254,2024,22,TAM,17,3,207,1122,5.4,8,66,52,55.1,52,47,392,8.3,0,23.1,90.4,7.5,16,65.4,254,1122,1514,1690,176,RB
72,Josh Jacobs,301,36,337,2024,26,GNB,17,17,301,1329,4.4,15,78.2,73,52.2,43,36,342,9.5,1,20.1,83.7,8,15,53.5,337,1329,1671,1671,0,RB
73,Jermar Jefferson,6,1,7,2024,24,DET,2,0,6,22,3.7,0,11,1,83.3,1,1,10,10,0,5,100,10,1,100,7,22,32,32,0,RB
74,Terrell Jennings,13,0,13,2024,23,NWE,3,0,13,33,2.5,0,11,0,23.1,1,0,0,,0,0,0,0,0,0,13,33,33,33,0,RB
75,D'Ernest Johnson,32,12,44,2024,28,JAX,14,1,32,143,4.5,0,10.2,7,50,19,12,96,8,0,6.9,63.2,5.1,3,26.3,44,143,239,239,0,RB
76,Jakob Johnson,0,0,0,2024,30,NYG,3,1,0,0,,0,0,0,,0,0,0,,0,0,,,0,,0,0,0,0,0,FB
77,Roschon Johnson,55,16,71,2024,23,CHI,14,0,55,150,2.7,6,10.7,17,56.4,20,16,104,6.5,0,7.4,80,5.2,6,40,71,150,254,254,0,RB
78,Ty Johnson,41,18,59,2024,27,BUF,17,1,41,213,5.2,1,12.5,13,65.9,25,18,284,15.8,3,16.7,72,11.4,14,60,59,213,497,627,130,RB
79,Aaron Jones,255,51,306,2024,30,MIN,17,17,255,1138,4.5,5,66.9,49,49.8,62,51,408,8,2,24,82.3,6.6,20,58.1,306,1138,1546,1546,0,RB
80,Tony Jones,4,0,4,2024,27,ARI,1,0,4,55,13.8,1,55,1,50,0,0,0,,0,0,,,0,,4,55,55,55,0,RB
81,Kyle Juszczyk,5,19,24,2024,33,SFO,17,15,5,26,5.2,1,1.5,1,20,31,19,200,10.5,2,11.8,61.3,6.5,8,48.4,24,26,226,234,8,FB
82,Alvin Kamara,228,68,296,2024,29,NOR,14,14,228,950,4.2,6,67.9,52,51.3,89,68,543,8,2,38.8,76.4,6.1,18,36,296,950,1493,1493,0,RB
83,John Kelly,0,0,0,2024,28,BAL,2,0,0,0,,0,0,0,,0,0,0,,0,0,,,0,,0,0,0,46,46,RB
84,Joshua Kelley,1,0,1,2024,27,TEN,3,0,1,2,2,0,0.7,0,0,0,0,0,,0,0,,,0,,1,2,2,2,0,RB
85,Jacob Kibodi,5,1,6,2024,26,CLE,1,0,5,24,4.8,0,24,1,20,3,1,15,15,0,15,33.3,5,1,33.3,6,24,39,39,0,RB
86,Dylan Laube,1,0,1,2024,25,LVR,10,0,1,0,0,0,0,0,0,0,0,0,,0,0,,,0,,1,0,0,164,164,RB
87,MarShawn Lloyd,6,1,7,2024,23,GNB,1,0,6,15,2.5,0,15,0,16.7,1,1,3,3,0,3,100,3,0,0,7,15,18,18,0,RB
88,Hunter Luepke,12,12,24,2024,24,DAL,16,4,12,38,3.2,0,2.4,6,50,16,12,111,9.3,0,6.9,75,6.9,5,50,24,38,149,149,0,RB
89,Jordan Mason,153,11,164,2024,25,SFO,12,6,153,789,5.2,3,65.8,37,47.1,14,11,91,8.3,0,7.6,78.6,6.5,5,64.3,164,789,880,907,29,RB
90,Scott Matlock,0,4,4,2024,24,LAC,17,11,0,0,,0,0,0,,5,4,28,7,0,1.6,80,5.6,1,60,4,0,28,28,0,FB/DL
91,Alexander Mattison,132,36,168,2024,26,LVR,14,7,132,420,3.2,4,30,25,35.6,48,36,294,8.2,1,21,75,6.1,13,35.4,168,420,714,714,0,RB
92,Christian McCaffrey,50,15,65,2024,28,SFO,4,4,50,202,4,0,50.5,12,44,19,15,146,9.7,0,36.5,78.9,7.7,6,52.6,65,202,348,348,0,RB
93,Jase McClellan,13,0,13,2024,22,ATL,2,0,13,32,2.5,0,16,2,46.2,0,0,0,,0,0,,,0,,13,32,32,32,0,RB
94,Sincere McCormick,39,6,45,2024,24,LVR,5,2,39,183,4.7,0,36.6,10,53.8,7,6,29,4.8,0,5.8,85.7,4.1,2,42.9,45,183,212,212,0,RB
95,Kenny McIntosh,31,3,34,2024,24,SEA,17,0,31,172,5.5,0,10.1,8,51.6,4,3,22,7.3,0,1.3,75,5.5,1,50,34,172,194,347,153,RB
96,Jaleel McLaughlin,113,24,137,2024,24,DEN,16,5,113,496,4.4,1,31,25,51.3,27,24,76,3.2,2,4.8,88.9,2.8,3,33.3,137,496,572,572,0,RB
97,Jeremy McNichols,55,9,64,2024,29,WAS,17,1,55,261,4.7,4,15.4,15,58.2,12,9,27,3,0,1.6,75,2.3,1,25,64,261,288,452,164,RB
98,Dante Miller,0,0,0,2024,25,NYG,2,0,0,0,,0,0,0,,0,0,0,,0,0,,,0,,0,0,0,0,0,RB
99,Kendre Miller,39,5,44,2024,22,NOR,6,2,39,148,3.8,1,24.7,11,48.7,8,5,33,6.6,0,5.5,62.5,4.1,2,37.5,44,148,181,357,176,RB
100,Kendall Milton,0,0,0,2024,22,CIN,2,0,0,0,,0,0,0,,0,0,0,,0,0,,,0,,0,0,0,0,0,RB
101,Jordan Mims,20,12,32,2024,25,NOR,11,0,20,70,3.5,0,6.4,2,40,18,12,71,5.9,0,6.5,66.7,3.9,4,22.2,32,70,141,160,19,RB
102,Keaton Mitchell,15,1,16,2024,22,BAL,5,0,15,30,2,0,6,2,40,1,1,28,28,0,5.6,100,28,1,100,16,30,58,214,156,RB
103,Joe Mixon,245,36,281,2024,28,HOU,14,14,245,1016,4.1,11,72.6,52,42.4,52,36,309,8.6,1,22.1,69.2,5.9,12,53.8,281,1016,1325,1325,0,RB
104,David Montgomery,185,36,221,2024,27,DET,14,14,185,775,4.2,12,55.4,50,55.1,38,36,341,9.5,0,24.4,94.7,9,16,73.7,221,778,1116,1116,0,RB
105,Zack Moss,74,23,97,2024,27,CIN,8,6,74,242,3.3,2,30.3,13,36.5,27,23,187,8.1,1,23.4,85.2,6.9,11,63,97,242,429,429,0,RB
106,Raheem Mostert,85,19,104,2024,32,MIA,13,1,85,278,3.3,2,21.4,13,37.6,23,19,161,8.5,0,12.4,82.6,7,10,52.2,104,278,439,481,42,RB
107,Kene Nwangwu,0,0,0,2024,26,NYJ,2,0,0,0,,0,0,0,,0,0,0,,0,0,,,0,,0,0,0,157,157,RB
108,Dare Ogunbowale,30,19,49,2024,30,HOU,17,1,30,112,3.7,0,6.6,5,36.7,28,19,198,10.4,1,11.6,67.9,7.1,8,35.7,49,112,310,322,12,RB
109,Isiah Pacheco,83,12,95,2024,25,KAN,7,6,83,310,3.7,1,44.3,14,53,16,12,79,6.6,0,11.3,75,4.9,4,37.5,95,310,389,389,0,RB
110,Cordarrelle Patterson,32,12,44,2024,33,PIT,13,1,32,135,4.2,0,10.4,7,43.8,14,12,80,6.7,1,6.2,85.7,5.7,5,50,44,135,215,455,240,RB
111,Jaret Patterson,0,0,0,2024,25,LAC,1,0,0,0,,0,0,0,,0,0,0,,0,0,,,0,,0,0,0,0,0,RB
112,Samaje Perine,20,28,48,2024,29,KAN,17,0,20,92,4.6,1,5.4,7,55,35,28,322,11.5,1,18.9,80,9.2,15,51.4,48,92,414,584,163,RB
113,Dameon Pierce,40,2,42,2024,24,HOU,11,0,40,293,7.3,2,26.6,7,42.5,4,2,2,1,0,0.2,50,0.5,0,0,42,293,295,634,339,RB
114,Tony Pollard,260,41,301,2024,27,TEN,16,16,260,1079,4.2,5,67.4,53,47.7,57,41,238,5.8,0,14.9,71.9,4.2,9,29.8,301,1079,1317,1317,0,RB
115,Adam Prentice,0,0,0,2024,27,NOR,17,7,0,0,,0,0,0,,4,0,0,,0,0,0,0,0,0,0,0,0,0,0,FB
116,Craig Reynolds,31,3,34,2024,28,DET,17,0,31,139,4.5,0,8.2,6,54.8,5,3,40,13.3,0,2.4,60,8,2,60,34,139,179,207,28,RB
117,Patrick Ricard,0,3,3,2024,30,BAL,17,6,0,0,,0,0,0,,5,3,22,7.3,1,1.3,60,4.4,1,60,3,0,22,22,0,FB
118,Ronnie Rivers,22,5,27,2024,25,LAR,17,0,22,99,4.5,0,5.8,6,54.5,6,5,34,6.8,0,2,83.3,5.7,1,50,27,99,133,133,0,RB
119,Bijan Robinson,304,61,365,2024,22,ATL,17,17,304,1456,4.8,14,85.6,82,60.2,72,61,431,7.1,1,25.4,84.7,6,20,41.7,365,1456,1887,1866,0,RB
120,Brian Robinson Jr.,187,20,207,2024,25,WAS,14,13,187,799,4.3,8,57.1,47,48.7,25,20,159,8,0,11.4,80,6.4,4,44,207,799,958,958,0,RB
121,Keilan Robinson,0,0,0,2024,24,JAX,6,0,0,0,,0,0,0,,0,0,0,,0,0,,,0,,0,0,0,34,34,RB
122,Chris Rodriguez,35,1,36,2024,24,WAS,9,0,35,173,4.9,2,19.2,10,74.3,1,1,12,12,0,1.3,100,12,1,100,36,173,185,185,0,RB
123,Miles Sanders,55,24,79,2024,27,CAR,11,2,55,205,3.7,2,18.6,12,45.5,30,24,148,6.2,1,13.5,80,4.9,5,23.3,79,205,353,367,14,RB
124,Cody Schrader,1,1,2,2024,25,LAR,1,0,1,3,3,0,3,0,0,1,1,6,6,0,6,100,6,0,100,2,3,9,9,0,RB
125,Trey Sermon,56,16,72,2024,25,IND,17,3,56,159,2.8,2,9.4,14,44.6,19,16,99,6.2,0,5.8,84.2,5.2,3,31.6,72,159,258,281,23,RB
126,Aaron Shampklin,6,0,6,2024,25,PIT,3,0,6,17,2.8,0,5.7,1,16.7,0,0,0,,0,0,,,0,,6,17,17,118,101,RB
127,Will Shipley,30,4,34,2024,22,PHI,16,1,30,82,2.7,0,5.1,2,26.7,4,4,35,8.8,0,2.2,100,8.8,2,75,34,82,117,290,173,RB
128,Devin Singletary,113,21,134,2024,27,NYG,15,5,113,437,3.9,4,29.1,24,47.8,24,21,119,5.7,0,7.9,87.5,5,4,45.8,134,437,556,556,0,RB
129,Tyjae Spears,84,30,114,2024,23,TEN,12,1,84,312,3.7,4,26,19,46.4,35,30,224,7.5,1,18.7,85.7,6.4,9,40,114,312,536,734,198,RB
130,Carson Steele,56,7,63,2024,22,KAN,17,3,56,183,3.3,0,10.8,14,55.4,11,7,26,3.7,0,1.5,63.6,2.4,0,18.2,63,183,209,347,138,RB
131,Rhamondre Stevenson,207,33,240,2024,26,NWE,15,14,207,801,3.9,7,53.4,40,50.2,41,33,168,5.1,1,11.2,80.5,4.1,8,39,240,801,969,969,0,RB
132,Pierre Strong,26,14,40,2024,26,CLE,14,0,26,108,4.2,0,7.7,6,46.2,22,14,104,7.4,0,7.4,63.6,4.7,3,22.7,40,108,212,467,255,RB
133,D'Andre Swift,253,42,295,2024,25,CHI,17,17,253,959,3.8,6,56.4,43,43.9,52,42,386,9.2,0,22.7,80.8,7.4,12,51.9,295,959,1345,1345,0,RB
134,J.J. Taylor,10,2,12,2024,26,HOU,5,0,10,44,4.4,0,8.8,1,50,3,2,0,0,0,0,66.7,0,0,0,12,44,44,44,0,RB
135,Jonathan Taylor,303,18,321,2024,25,IND,14,13,303,1431,4.7,11,102.2,71,45.9,31,18,136,7.6,1,9.7,58.1,4.4,7,32.3,321,1431,1567,1567,0,RB
136,Patrick Taylor,39,3,42,2024,26,SFO,13,1,39,183,4.7,1,14.1,11,53.8,11,3,25,8.3,0,1.9,27.3,2.3,2,18.2,42,183,208,312,104,RB
137,Tyrone Tracy Jr.,192,38,230,2024,25,NYG,17,12,192,839,4.4,5,49.4,39,44.3,53,38,284,7.5,1,16.7,71.7,5.4,13,47.2,230,839,1123,1184,61,RB
138,Sean Tucker,50,9,59,2024,23,TAM,17,0,50,308,6.2,2,18.1,17,56,12,9,109,12.1,1,6.4,75,9.1,6,75,59,308,417,827,410,RB
139,Sione Vaki,6,3,9,2024,23,DET,16,0,6,14,2.3,0,0.9,0,33.3,3,3,37,12.3,0,2.3,100,12.3,2,100,9,14,51,106,55,RB
140,Deuce Vaughn,17,3,20,2024,23,DAL,7,0,17,70,4.1,0,10,2,41.2,5,3,18,6,0,2.6,60,3.6,0,20,20,70,88,88,0,RB
141,Ke'Shawn Vaughn,2,0,2,2024,27,SFO,3,0,2,4,2,0,1.3,0,0,0,0,0,,0,0,,,0,,2,4,4,4,0,RB
142,Kimani Vidal,43,5,48,2024,23,LAC,10,0,43,155,3.6,0,15.5,7,32.6,9,5,62,12.4,1,6.2,55.6,6.9,2,33.3,48,155,217,217,0,RB
143,Kenneth Walker III,153,46,199,2024,24,SEA,11,11,153,573,3.7,7,52.1,28,44.4,53,46,299,6.5,1,27.2,86.8,5.6,19,54.7,199,573,872,869,0,RB
144,Jonathan Ward,5,0,5,2024,27,PIT,4,0,5,22,4.4,0,5.5,1,60,0,0,0,,0,0,,,0,,5,22,22,22,0,RB
145,Jaylen Warren,120,38,158,2024,26,PIT,15,0,120,511,4.3,1,34.1,28,50,47,38,310,8.2,0,20.7,80.9,6.6,16,46.8,158,511,821,1048,227,RB
146,Carlos Washington,0,0,0,2024,26,ATL,1,0,0,0,,0,0,0,,0,0,0,,0,0,,,0,,0,0,0,0,0,RB
147,Blake Watson,4,1,5,2024,25,DEN,2,0,4,10,2.5,0,5,2,75,2,1,13,13,0,6.5,50,6.5,0,50,5,10,23,23,0,RB
148,Rachaad White,144,51,195,2024,25,TAM,16,15,144,613,4.3,3,38.3,35,50.7,57,51,393,7.7,6,24.6,89.5,6.9,18,54.4,195,613,1006,1006,0,RB
149,Zamir White,65,6,71,2024,25,LVR,8,5,65,183,2.8,1,22.9,4,26.2,8,6,30,5,0,3.8,75,3.8,2,25,71,183,213,213,0,RB
150,Avery Williams,0,0,0,2024,26,ATL,17,0,0,0,,0,0,0,,0,0,0,,0,0,,,0,,0,0,0,593,593,RB
151,D.J. Williams,0,0,0,2024,24,TAM,1,0,0,0,,0,0,0,,0,0,0,,0,0,,,0,,0,0,0,54,54,RB
152,Jamaal Williams,48,9,57,2024,29,NOR,14,1,48,164,3.4,1,11.7,11,47.9,11,9,57,6.3,0,4.1,81.8,5.2,3,54.5,57,164,221,509,288,RB
153,Javonte Williams,139,52,191,2024,24,DEN,17,11,139,513,3.7,4,30.2,30,46.8,70,52,346,6.7,0,20.4,74.3,4.9,14,37.1,191,513,859,859,0,RB
154,Kyren Williams,316,34,350,2024,24,LAR,16,16,316,1299,4.1,14,81.2,85,50.9,40,34,182,5.4,2,11.4,85,4.6,6,45,350,1299,1481,1493,12,RB
155,Trayveon Williams,0,0,0,2024,27,CIN,17,0,0,0,,0,0,0,,0,0,0,,0,0,,,0,,0,0,0,97,97,RB
156,Emanuel Wilson,103,11,114,2024,25,GNB,17,0,103,502,4.9,4,29.5,27,59.2,14,11,48,4.4,1,2.8,78.6,3.4,3,21.4,114,502,550,550,0,RB
157,Jeff Wilson,16,3,19,2024,29,MIA,9,0,16,57,3.6,0,6.3,3,43.8,3,3,19,6.3,0,2.1,100,6.3,0,100,19,57,76,76,0,RB
158,Jaylen Wright,68,3,71,2024,21,MIA,15,1,68,249,3.7,0,16.6,11,39.7,6,3,8,2.7,0,0.5,50,1.3,1,16.7,71,249,257,286,29,RB
159,Israel Abanikanda,22,7,29,2023,21,NYJ,6,0,22,70,3.2,0,11.7,3,36.4,11,7,43,6.1,0,7.2,63.6,3.9,2,36.4,29,70,113,144,31,RB
160,Ameer Abdullah,15,19,34,2023,30,LVR,17,0,15,89,5.9,0,5.2,6,60,24,19,131,6.9,0,7.7,79.2,5.5,4,33.3,34,89,220,220,0,RB
161,De'Von Achane,103,27,130,2023,22,MIA,11,4,103,800,7.8,8,72.7,30,54.4,37,27,197,7.3,3,17.9,73,5.3,10,48.6,130,794,997,997,0,RB
162,Salvon Ahmed,22,16,38,2023,25,MIA,8,0,22,61,2.8,1,7.6,3,36.4,23,16,88,5.5,1,11,69.6,3.8,4,30.4,38,61,149,149,0,RB
163,Cam Akers,60,11,71,2023,24,"MIN,LAR",7,1,60,167,2.8,2,23.9,12,35,12,11,70,6.4,0,10,91.7,5.8,2,50,71,160,237,237,0,RB
164,Tyler Allgeier,186,18,204,2023,23,ATL,17,3,186,683,3.7,4,40.2,39,48.4,23,18,193,10.7,1,11.4,78.3,8.4,6,39.1,204,683,876,876,0,RB
165,Alex Armah,0,3,3,2023,29,WAS,8,0,0,0,,0,0,0,,3,3,13,4.3,0,1.6,100,4.3,1,33.3,3,0,13,13,0,RB
166,Saquon Barkley,247,41,288,2023,26,NYG,14,14,247,962,3.9,6,68.7,51,40.1,60,41,280,6.8,4,20,68.3,4.7,16,43.3,288,962,1242,1242,0,RB
167,Nick Bawden,2,3,5,2023,27,NYJ,16,2,2,4,2,1,0.3,1,50,3,3,21,7,0,1.3,100,7,1,66.7,5,4,25,25,0,FB
168,Andrew Beck,5,11,16,2023,27,HOU,15,12,5,3,0.6,1,0.2,2,40,13,11,55,5,2,3.7,84.6,4.2,4,53.8,16,3,58,152,94,FB
169,Tank Bigsby,50,1,51,2023,22,JAX,17,0,50,132,2.6,2,7.8,12,42,4,1,6,6,0,0.4,25,1.5,0,25,51,132,138,228,99,RB
170,Raheem Blackshear,14,6,20,2023,24,CAR,12,0,14,46,3.3,0,3.8,1,35.7,7,6,45,7.5,0,3.8,85.7,6.4,1,71.4,20,46,91,521,430,RB
171,Khari Blasingame,8,3,11,2023,27,CHI,16,2,8,26,3.3,0,1.6,0,25,6,3,2,0.7,0,0.1,50,0.3,0,16.7,11,26,28,28,0,FB
172,Brandon Bolden,4,0,4,2023,33,LVR,17,0,4,31,7.8,1,1.8,2,50,0,0,0,,0,0,,,0,,4,31,31,31,0,RB
173,Matt Breida,55,17,72,2023,28,NYG,17,4,55,151,2.7,1,8.9,7,34.5,21,17,88,5.2,0,5.2,81,4.2,2,19,72,151,239,239,0,RB
174,Gary Brightwell,9,5,14,2023,24,NYG,7,0,9,19,2.1,0,2.7,0,22.2,7,5,47,9.4,0,6.7,71.4,6.7,2,42.9,14,19,66,66,0,RB
175,Chris Brooks,19,0,19,2023,23,MIA,9,0,19,106,5.6,0,11.8,2,31.6,0,0,0,,0,0,,,0,,19,106,106,106,0,RB
176,Chase Brown,44,14,58,2023,23,CIN,12,0,44,179,4.1,0,14.9,6,34.1,15,14,156,11.1,1,13,93.3,10.4,4,53.3,58,179,335,379,44,RB
177,Michael Burton,7,3,10,2023,31,DEN,17,3,7,9,1.3,0,0.5,4,57.1,3,3,8,2.7,0,0.5,100,2.7,2,66.7,10,9,17,17,0,FB
178,Jason Cabinda,1,0,1,2023,27,DET,4,0,1,0,0,0,0,0,0,0,0,0,,0,0,,,0,,1,0,0,0,0,FB
179,Michael Carter,30,24,54,2023,24,"ARI,NYJ",15,0,30,187,6.2,0,12.5,9,40,31,24,101,4.2,1,6.7,77.4,3.3,5,32.3,54,187,288,288,0,RB
180,Ty Chandler,102,21,123,2023,25,MIN,17,4,102,461,4.5,3,27.1,20,45.1,25,21,159,7.6,0,9.4,84,6.4,7,48,123,461,620,717,97,RB
181,Zach Charbonnet,108,33,141,2023,22,SEA,16,2,108,462,4.3,1,28.9,32,49.1,40,33,209,6.3,0,13.1,82.5,5.2,7,45,141,462,671,671,0,RB
182,Julius Chestnut,0,0,0,2023,23,TEN,3,0,0,0,,0,0,0,,0,0,0,,0,0,,,0,,0,0,0,0,0,RB
183,Nick Chubb,28,4,32,2023,28,CLE,2,2,28,170,6.1,0,85,8,57.1,4,4,21,5.3,0,10.5,100,5.3,1,50,32,170,191,191,0,RB
184,Corey Clement,0,0,0,2023,29,ARI,3,0,0,0,,0,0,0,,0,0,0,,0,0,,,0,,0,0,0,0,0,RB
185,James Conner,208,27,235,2023,28,ARI,13,13,208,1040,5,7,80,57,49.5,33,27,165,6.1,2,12.7,81.8,5,11,39.4,235,1040,1205,1205,0,RB
186,Dalvin Cook,67,15,82,2023,28,"NYJ,BAL",15,1,67,214,3.2,0,14.3,10,38.8,20,15,78,5.2,0,5.2,75,3.9,3,30,82,214,292,292,0,RB
187,James Cook,237,44,281,2023,24,BUF,17,13,237,1122,4.7,2,66,53,55.7,54,44,445,10.1,4,26.2,81.5,8.2,16,59.3,281,1122,1567,1567,0,RB
188,Jashaun Corbin,1,3,4,2023,23,NYG,6,0,1,1,1,0,0.2,1,100,3,3,12,4,0,2,100,4,1,33.3,4,1,13,13,0,RB
189,DeeJay Dallas,10,6,16,2023,25,SEA,17,0,10,36,3.6,0,2.1,2,70,9,6,26,4.3,0,1.5,66.7,2.9,1,11.1,16,36,62,767,705,RB
190,Malik Davis,0,0,0,2023,25,DAL,3,0,0,0,,0,0,0,,0,0,0,,0,0,,,0,,0,0,0,0,0,RB
191,Tyrion Davis-Price,6,0,6,2023,23,SFO,1,0,6,21,3.5,0,21,1,50,0,0,0,,0,0,,,0,,6,21,21,21,0,RB
192,Emari Demercado,58,21,79,2023,24,ARI,14,2,58,284,4.9,2,20.3,12,43.1,30,21,119,5.7,0,8.5,70,4,4,30,79,284,403,403,0,RB
193,AJ Dillon,178,22,200,2023,25,GNB,15,6,178,613,3.4,2,40.9,32,50,28,22,223,10.1,0,14.9,78.6,8,10,57.1,200,613,836,836,0,RB
194,J.K. Dobbins,8,2,10,2023,25,BAL,1,1,8,22,2.8,1,22,1,50,3,2,15,7.5,0,15,66.7,5,0,66.7,10,22,37,37,0,RB
195,Elijah Dotson,4,2,6,2023,24,LAC,4,0,4,6,1.5,0,1.5,0,25,2,2,13,6.5,0,3.3,100,6.5,0,100,6,6,19,19,0,RB
196,Rico Dowdle,89,17,106,2023,25,DAL,16,0,89,361,4.1,2,22.6,17,47.2,22,17,144,8.5,2,9,77.3,6.5,6,40.9,106,361,505,591,86,RB
197,Kenyan Drake,2,2,4,2023,29,"GNB,BAL",3,0,2,0,0,0,0,0,0,3,2,31,15.5,0,10.3,66.7,10.3,0,66.7,4,0,31,31,0,RB
198,Chase Edmonds,49,14,63,2023,27,TAM,13,0,49,176,3.6,0,13.5,8,46.9,17,14,81,5.8,0,6.2,82.4,4.8,5,58.8,63,176,257,257,0,RB
199,Clyde Edwards-Helaire,70,17,87,2023,24,KAN,15,3,70,223,3.2,1,14.9,12,40,22,17,188,11.1,1,12.5,77.3,8.5,7,50,87,223,411,411,0,RB
200,Gus Edwards,198,12,210,2023,28,BAL,17,9,198,810,4.1,13,47.6,49,54,13,12,180,15,0,10.6,92.3,13.8,5,69.2,210,810,990,990,0,RB
201,Austin Ekeler,179,51,230,2023,28,LAC,14,14,179,628,3.5,5,44.9,34,47.5,74,51,436,8.5,1,31.1,68.9,5.9,20,43.2,230,628,1064,1063,0,RB
202,Ezekiel Elliott,184,51,235,2023,28,NWE,17,5,184,642,3.5,3,37.8,33,45.1,65,51,313,6.1,2,18.4,78.5,4.8,12,40,235,642,955,955,0,RB
203,Travis Etienne,267,58,325,2023,24,JAX,17,17,267,1008,3.8,11,59.3,53,43.1,73,58,476,8.2,1,28,79.5,6.5,23,49.3,325,1008,1484,1484,0,RB
204,Chris Evans,2,1,3,2023,26,CIN,8,0,2,12,6,0,1.5,0,0,1,1,-1,-1,0,-0.1,100,-1,0,0,3,12,11,56,45,RB
205,Darrynton Evans,32,7,39,2023,25,"CHI,MIA",7,0,32,121,3.8,1,17.3,10,40.6,12,7,49,7,0,7,58.3,4.1,2,33.3,39,121,170,170,0,RB
206,Zach Evans,9,0,9,2023,22,LAR,10,0,9,19,2.1,0,1.9,0,0,0,0,0,,0,0,,,0,,9,19,19,19,0,RB
207,Jerome Ford,204,44,248,2023,24,CLE,17,12,204,813,4,4,47.8,33,39.7,63,44,319,7.3,5,18.8,69.8,5.1,16,41.3,248,813,1132,1132,0,RB
208,D'Onta Foreman,109,11,120,2023,27,CHI,9,8,109,425,3.9,4,47.2,24,53.2,16,11,77,7,1,8.6,68.8,4.8,6,43.8,120,425,502,502,0,RB
209,Leonard Fournette,12,0,12,2023,28,BUF,2,0,12,40,3.3,0,20,2,41.7,0,0,0,,0,0,,,0,,12,40,40,57,17,RB
210,Royce Freeman,77,1,78,2023,27,LAR,14,0,77,319,4.1,2,22.8,17,51.9,2,1,13,13,0,0.9,50,6.5,1,50,78,319,332,332,0,RB
211,Jake Funk,2,1,3,2023,25,IND,4,0,2,10,5,0,2.5,0,0,1,1,12,12,0,3,100,12,1,100,3,10,22,22,0,RB
212,Kenneth Gainwell,84,30,114,2023,24,PHI,16,2,84,364,4.3,2,22.8,19,39.3,37,30,183,6.1,0,11.4,81.1,4.9,11,48.6,114,381,547,566,19,RB
213,Myles Gaskin,0,0,0,2023,26,"MIN,LAR",3,0,0,0,,0,0,0,,0,0,0,,0,0,,,0,,0,0,0,0,0,RB
214,Jahmyr Gibbs,182,52,234,2023,21,DET,15,3,182,945,5.2,10,63,42,46.7,71,52,316,6.1,1,21.1,73.2,4.5,20,46.5,234,945,1261,1261,0,RB
215,Antonio Gibson,65,48,113,2023,25,WAS,16,2,65,265,4.1,1,16.6,13,43.1,59,48,389,8.1,2,24.3,81.4,6.6,19,44.1,113,265,654,994,340,RB
216,Reggie Gilliam,0,1,1,2023,26,BUF,17,0,0,0,,0,0,0,,1,1,3,3,0,0.2,100,3,0,0,1,0,3,3,0,FB
217,Tyler Goodson,13,6,19,2023,23,IND,6,1,13,87,6.7,0,14.5,4,46.2,9,6,34,5.7,0,5.7,66.7,3.8,1,55.6,19,87,121,121,0,RB
218,Melvin Gordon,26,3,29,2023,30,BAL,4,0,26,81,3.1,1,20.3,4,30.8,3,3,46,15.3,0,11.5,100,15.3,3,100,29,81,127,127,0,RB
219,Derrick Gore,3,0,3,2023,29,WAS,6,0,3,26,8.7,0,4.3,1,33.3,0,0,0,,0,0,,,0,,3,26,26,26,0,RB
220,Eric Gray,17,6,23,2023,24,NYG,13,0,17,48,2.8,0,3.7,2,35.3,7,6,22,3.7,0,1.7,85.7,3.1,0,0,23,48,70,156,86,RB
221,Breece Hall,223,76,299,2023,22,NYJ,17,16,223,994,4.5,5,58.5,40,39.5,95,76,591,7.8,4,34.8,80,6.2,28,40,299,994,1585,1584,0,RB
222,C.J. Ham,1,7,8,2023,30,MIN,17,5,1,7,7,0,0.4,0,100,9,7,25,3.6,0,1.5,77.8,2.8,1,33.3,8,7,32,32,0,FB
223,Damien Harris,23,2,25,2023,26,BUF,6,0,23,94,4.1,1,15.7,9,65.2,2,2,16,8,0,2.7,100,8,0,0,25,94,110,151,41,RB
224,Kevin Harris,16,3,19,2023,23,NWE,4,0,16,65,4.1,1,16.3,2,50,3,3,58,19.3,0,14.5,100,19.3,2,66.7,19,65,123,143,20,RB
225,Najee Harris,255,29,284,2023,25,PIT,17,17,255,1035,4.1,8,60.9,51,48.2,38,29,170,5.9,0,10,76.3,4.5,9,50,284,1035,1205,1205,0,RB
226,Jamycal Hasty,0,0,0,2023,27,"JAX,NWE",5,0,0,0,,0,0,0,,2,0,0,,0,0,0,0,0,0,0,0,0,0,0,RB
227,Darrell Henderson,46,10,56,2023,26,LAR,4,4,46,112,2.4,2,28,5,37,14,10,103,10.3,0,25.8,71.4,7.4,3,28.6,56,112,215,215,0,RB
228,Derrick Henry,280,28,308,2023,29,TEN,17,17,280,1167,4.2,12,68.6,63,46.1,36,28,214,7.6,0,12.6,77.8,5.9,7,44.4,308,1181,1381,1381,0,RB
229,Khalil Herbert,132,20,152,2023,25,CHI,12,9,132,611,4.6,2,50.9,25,49.2,31,20,134,6.7,1,11.2,64.5,4.3,9,41.9,152,611,745,745,0,RB
230,Justice Hill,84,28,112,2023,26,BAL,16,5,84,387,4.6,3,24.2,19,48.8,39,28,206,7.4,1,12.9,71.8,5.3,8,30.8,112,387,593,712,119,RB
231,Travis Homer,0,0,0,2023,25,CHI,16,0,0,0,,0,0,0,,1,0,0,,0,0,0,0,0,0,0,0,0,0,0,RB
232,Chuba Hubbard,238,39,277,2023,24,CAR,17,12,238,902,3.8,5,53.1,59,47.5,44,39,233,6,0,13.7,88.6,5.3,9,36.4,277,902,1135,1135,0,RB
233,Evan Hull,1,1,2,2023,23,IND,1,0,1,1,1,0,1,0,0,1,1,6,6,0,6,100,6,0,100,2,1,7,7,0,RB
234,Kareem Hunt,135,15,150,2023,28,CLE,15,2,135,411,3,9,27.4,38,45.9,21,15,84,5.6,0,5.6,71.4,4,5,38.1,150,411,495,495,0,RB
235,Mohamed Ibrahim,0,0,0,2023,25,DET,1,0,0,0,,0,0,0,,0,0,0,,0,0,,,0,,0,0,0,22,22,RB
236,Godwin Igwebuike,0,0,0,2023,29,"ATL,PIT",12,0,0,0,,0,0,0,,0,0,0,,0,0,,,0,,0,0,0,282,282,RB
237,Alec Ingold,2,13,15,2023,27,MIA,17,13,2,0,0,0,0,0,0,16,13,119,9.2,0,7,81.3,7.4,5,62.5,15,0,119,119,0,FB
238,Keaontay Ingram,35,4,39,2023,24,ARI,8,1,35,74,2.1,0,9.3,4,20,4,4,26,6.5,0,3.3,100,6.5,1,50,39,74,100,100,0,RB
239,Deon Jackson,14,5,19,2023,24,"CLE,IND,NYG",4,1,14,16,1.1,0,4,1,14.3,6,5,14,2.8,0,3.5,83.3,2.3,0,33.3,19,16,30,30,0,RB
240,Josh Jacobs,233,37,270,2023,25,LVR,13,13,233,805,3.5,6,61.9,34,45.9,54,37,296,8,0,22.8,68.5,5.5,15,55.6,270,801,1101,1101,0,RB
241,D'Ernest Johnson,41,10,51,2023,27,JAX,17,0,41,108,2.6,0,6.4,5,39,12,10,140,14,0,8.2,83.3,11.7,6,50,51,108,248,374,126,RB
242,Jakob Johnson,0,1,1,2023,29,LVR,13,5,0,0,,0,0,0,,2,1,12,12,0,0.9,50,6,0,50,1,0,12,12,0,FB
243,Roschon Johnson,81,34,115,2023,22,CHI,15,0,81,352,4.3,2,23.5,16,43.2,40,34,209,6.1,0,13.9,85,5.2,6,27.5,115,352,561,561,0,RB
244,Ty Johnson,30,7,37,2023,26,BUF,10,0,30,132,4.4,0,13.2,8,63.3,7,7,62,8.9,1,6.2,100,8.9,2,71.4,37,132,194,355,161,RB
245,Aaron Jones,142,30,172,2023,29,GNB,11,11,142,656,4.6,2,59.6,34,62,43,30,233,7.8,1,21.2,69.8,5.4,13,39.5,172,656,889,888,0,RB
246,Taiwan Jones,0,0,0,2023,35,NYG,2,0,0,0,,0,0,0,,0,0,0,,0,0,,,0,,0,0,0,0,0,RB
247,Tony Jones,26,7,33,2023,26,"ARI,NOR",7,1,26,95,3.7,2,13.6,7,46.2,10,7,37,5.3,0,5.3,70,3.7,1,20,33,95,132,132,0,RB
248,Kyle Juszczyk,5,14,19,2023,32,SFO,17,16,5,6,1.2,0,0.4,2,60,17,14,119,8.5,2,7,82.4,7,8,82.4,19,6,125,143,18,FB
249,Alvin Kamara,180,75,255,2023,28,NOR,13,12,180,694,3.9,5,53.4,42,48.3,86,75,466,6.2,1,35.8,87.2,5.4,23,45.3,255,694,1160,1160,0,RB
250,John Kelly,0,0,0,2023,27,CLE,0,0,0,0,,0,,0,,0,0,0,,0,,,,0,,0,0,0,0,,RB
251,Joshua Kelley,107,8,115,2023,26,LAC,17,3,107,405,3.8,2,23.8,21,43,12,8,32,4,0,1.9,66.7,2.7,0,33.3,115,405,437,453,16,RB
252,Zonovan Knight,3,1,4,2023,22,DET,2,0,3,13,4.3,0,6.5,0,33.3,1,1,8,8,0,4,100,8,0,100,4,13,21,43,22,RB
253,Hunter Luepke,6,3,9,2023,23,DAL,17,0,6,19,3.2,1,1.1,5,83.3,4,3,18,6,0,1.1,75,4.5,1,50,9,19,37,52,15,RB
254,Ben Mason,0,0,0,2023,24,BAL,1,0,0,0,,0,0,0,,0,0,0,,0,0,,,0,,0,0,0,0,0,FB
255,Jordan Mason,40,3,43,2023,24,SFO,17,0,40,206,5.2,3,12.1,13,55,4,3,31,10.3,0,1.8,75,7.8,1,50,43,206,237,277,40,RB
256,Alexander Mattison,180,30,210,2023,25,MIN,16,13,180,700,3.9,0,43.8,28,45,44,30,192,6.4,3,12,68.2,4.4,5,34.1,210,700,892,891,0,RB
257,Christian McCaffrey,272,67,339,2023,27,SFO,16,16,272,1459,5.4,14,91.2,83,54,83,67,564,8.4,7,35.3,80.7,6.8,31,55.4,339,1459,2023,2023,0,RB
258,Anthony McFarland Jr.,0,2,2,2023,25,PIT,3,0,0,0,,0,0,0,,2,2,11,5.5,0,3.7,100,5.5,1,100,2,0,11,175,164,RB
259,Kenny McIntosh,0,0,0,2023,23,SEA,3,0,0,0,,0,0,0,,0,0,0,,0,0,,,0,,0,0,0,0,0,RB
260,Jerick McKinnon,21,25,46,2023,31,KAN,12,0,21,60,2.9,1,5,7,47.6,32,25,192,7.7,4,16,78.1,6,10,43.8,46,64,252,272,20,RB
261,Jaleel McLaughlin,76,31,107,2023,23,DEN,17,3,76,410,5.4,1,24.1,16,53.9,36,31,160,5.2,2,9.4,86.1,4.4,5,38.9,107,410,570,570,0,RB
262,Jeremy McNichols,0,0,0,2023,28,SFO,3,0,0,0,,0,0,0,,0,0,0,,0,0,,,0,,0,0,0,0,0,RB
263,Kendre Miller,41,10,51,2023,21,NOR,8,0,41,156,3.8,1,19.5,10,39,11,10,117,11.7,0,14.6,90.9,10.6,5,54.5,51,156,273,273,0,RB
264,Jordan Mims,0,0,0,2023,24,NOR,2,0,0,0,,0,0,0,,2,0,0,,0,0,0,0,0,0,0,0,0,0,0,RB
265,Elijah Mitchell,75,6,81,2023,25,SFO,11,1,75,281,3.7,2,25.5,14,48,8,6,14,2.3,0,1.3,75,1.8,2,37.5,81,281,295,295,0,RB
266,Keaton Mitchell,47,9,56,2023,21,BAL,8,2,47,396,8.4,2,49.5,19,68.1,11,9,93,10.3,0,11.6,81.8,8.5,5,63.6,56,396,489,489,0,RB
267,Joe Mixon,257,52,309,2023,27,CIN,17,17,257,1034,4,9,60.8,59,49.4,64,52,376,7.2,3,22.1,81.3,5.9,14,54.7,309,1034,1410,1410,0,RB
268,David Montgomery,219,16,235,2023,26,DET,14,14,219,1015,4.6,13,72.5,59,54.8,24,16,117,7.3,0,8.4,66.7,4.9,7,54.2,235,1015,1132,1132,0,RB
269,Ty Montgomery,3,5,8,2023,30,NWE,13,0,3,9,3,0,0.7,0,33.3,12,5,40,8,0,3.1,41.7,3.3,3,33.3,8,9,49,268,219,RB
270,Zack Moss,183,27,210,2023,26,IND,14,8,183,794,4.3,5,56.7,43,49.2,37,27,192,7.1,2,13.7,73,5.2,10,35.1,210,794,986,986,0,RB
271,Raheem Mostert,209,25,234,2023,31,MIA,15,15,209,1012,4.8,18,67.5,59,55,32,25,175,7,3,11.7,78.1,5.5,6,40.6,234,1012,1187,1186,0,RB
272,Latavius Murray,79,17,96,2023,33,BUF,16,4,79,300,3.8,4,18.8,27,57,22,17,119,7,0,7.4,77.3,5.4,7,45.5,96,300,419,419,0,RB
273,Kene Nwangwu,5,0,5,2023,25,MIN,9,0,5,13,2.6,0,1.4,0,40,0,0,0,,0,0,,,0,,5,13,13,393,380,RB
274,Dare Ogunbowale,8,2,10,2023,29,HOU,12,0,8,35,4.4,0,2.9,2,37.5,7,2,18,9,0,1.5,28.6,2.6,0,0,10,35,53,53,0,RB
275,Qadree Ollison,0,0,0,2023,27,PIT,2,0,0,0,,0,0,0,,0,0,0,,0,0,,,0,,0,0,0,0,0,RB
276,Devine Ozigbo,3,1,4,2023,27,DET,3,0,3,5,1.7,0,1.7,1,66.7,1,1,8,8,0,2.7,100,8,0,100,4,5,13,13,0,RB
277,Isiah Pacheco,205,44,249,2023,24,KAN,14,13,205,935,4.6,7,66.8,53,50.7,49,44,244,5.5,2,17.4,89.8,5,12,44.9,249,935,1179,1174,0,RB
278,Cordarrelle Patterson,50,9,59,2023,32,ATL,14,0,50,181,3.6,0,12.9,9,46,12,9,38,4.2,1,2.7,75,3.2,2,33.3,59,181,219,372,153,RB
279,Henry Pearson,0,0,0,2023,24,GNB,2,0,0,0,,0,0,0,,0,0,0,,0,0,,,0,,0,0,0,0,0,FB
280,Rashaad Penny,11,1,12,2023,27,PHI,3,0,11,33,3,0,11,1,45.5,1,1,5,5,0,1.7,100,5,0,100,12,33,38,38,0,RB
281,La'Mical Perine,22,3,25,2023,25,KAN,3,1,22,77,3.5,0,25.7,3,40.9,5,3,33,11,0,11,60,6.6,1,20,25,77,110,110,0,RB
282,Samaje Perine,53,50,103,2023,28,DEN,17,1,53,238,4.5,1,14,14,50.9,56,50,455,9.1,0,26.8,89.3,8.1,23,67.9,103,238,693,683,0,RB
283,Dameon Pierce,145,13,158,2023,23,HOU,14,7,145,416,2.9,2,29.7,14,37.9,17,13,101,7.8,0,7.2,76.5,5.9,3,52.9,158,416,517,742,225,RB
284,Tony Pollard,252,55,307,2023,26,DAL,17,17,252,1005,4,6,59.1,56,50,67,55,311,5.7,0,18.3,82.1,4.6,12,43.3,307,1005,1316,1316,0,RB
285,Adam Prentice,2,2,4,2023,26,NOR,13,1,2,12,6,0,0.9,1,100,3,2,12,6,0,0.9,66.7,4,0,33.3,4,12,24,24,0,FB
286,Deneric Prince,0,0,0,2023,23,KAN,2,0,0,0,,0,0,0,,0,0,0,,0,0,,,0,,0,0,0,0,0,RB
287,Craig Reynolds,41,5,46,2023,27,DET,17,0,41,179,4.4,1,10.5,11,43.9,5,5,47,9.4,0,2.8,100,9.4,2,60,46,179,226,359,133,RB
288,Patrick Ricard,0,5,5,2023,29,BAL,17,9,0,0,,0,0,0,,7,5,52,10.4,1,3.1,71.4,7.4,3,42.9,5,0,52,52,0,FB
289,Ronnie Rivers,32,5,37,2023,24,LAR,9,1,32,129,4,0,14.3,4,50,5,5,22,4.4,0,2.4,100,4.4,0,40,37,129,151,167,16,RB
290,Bijan Robinson,214,58,272,2023,21,ATL,17,16,214,976,4.6,4,57.4,50,43.5,86,58,487,8.4,4,28.6,67.4,5.7,24,45.3,272,976,1463,1464,8,RB
291,Brian Robinson Jr.,178,36,214,2023,24,WAS,15,15,178,733,4.1,5,48.9,47,47.8,43,36,368,10.2,4,24.5,83.7,8.6,15,53.5,214,733,1101,1101,0,RB
292,James Robinson,1,1,2,2023,25,GNB,1,0,1,2,2,0,2,0,0,1,1,-2,-2,0,-2,100,-2,0,0,2,2,0,0,0,RB
293,Chris Rodriguez,51,2,53,2023,23,WAS,13,0,51,247,4.8,2,19,14,47.1,2,2,12,6,0,0.9,100,6,1,100,53,247,259,259,0,RB
294,Miles Sanders,129,27,156,2023,26,CAR,16,5,129,432,3.3,1,27,24,40.3,41,27,154,5.7,0,9.6,65.9,3.8,8,39,156,432,586,586,0,RB
295,Boston Scott,20,4,24,2023,28,PHI,15,0,20,86,4.3,0,5.7,5,50,6,4,52,13,0,3.5,66.7,8.7,2,33.3,24,86,138,308,170,RB
296,Trey Sermon,35,3,38,2023,24,IND,14,0,35,160,4.6,0,11.4,7,45.7,6,3,13,4.3,0,0.9,50,2.2,0,33.3,38,160,173,173,0,RB
297,Devin Singletary,216,30,246,2023,26,HOU,17,10,216,898,4.2,4,52.8,41,47.7,38,30,193,6.4,0,11.4,78.9,5.1,7,36.8,246,904,1091,1181,90,RB
298,Keith Smith,0,3,3,2023,31,ATL,13,6,0,0,,0,0,0,,3,3,33,11,0,2.5,100,11,1,66.7,3,0,33,44,10,FB
299,Tyjae Spears,100,52,152,2023,22,TEN,17,1,100,453,4.5,2,26.6,24,44,70,52,385,7.4,1,22.6,74.3,5.5,17,34.3,152,453,838,1108,270,RB
300,Isaiah Spiller,37,6,43,2023,22,LAC,9,0,37,96,2.6,0,10.7,1,32.4,6,6,34,5.7,0,3.8,100,5.7,1,66.7,43,96,130,130,0,RB
301,Rhamondre Stevenson,156,38,194,2023,25,NWE,12,12,156,619,4,4,51.6,36,49.4,51,38,238,6.3,0,19.8,74.5,4.7,8,35.3,194,619,857,857,0,RB
302,Pierre Strong,63,5,68,2023,25,CLE,17,1,63,291,4.6,1,17.1,10,50.8,8,5,47,9.4,0,2.8,62.5,5.9,1,25,68,291,338,538,200,RB
303,D'Andre Swift,229,39,268,2023,24,PHI,16,15,229,1049,4.6,5,65.6,50,54.1,49,39,214,5.5,1,13.4,79.6,4.4,8,42.9,268,1049,1263,1263,0,RB
304,Jonathan Taylor,169,19,188,2023,24,IND,10,7,169,741,4.4,7,74.1,42,49.1,23,19,153,8.1,1,15.3,82.6,6.7,5,43.5,188,741,894,894,0,RB
305,Patrick Taylor,32,11,43,2023,25,GNB,11,0,32,141,4.4,0,12.8,7,46.9,17,11,49,4.5,0,4.5,64.7,2.9,4,29.4,43,141,190,190,0,RB
306,SaRodorick Thompson,0,0,0,2023,24,SEA,1,0,0,0,,0,0,0,,0,0,0,,0,0,,,0,,0,0,0,0,0,RB
307,Sean Tucker,15,2,17,2023,22,TAM,11,0,15,23,1.5,0,2.1,1,26.7,2,2,9,4.5,0,0.8,100,4.5,0,50,17,23,32,32,0,RB
308,Xazavian Valladay,0,0,0,2023,25,NYJ,1,0,0,0,,0,0,0,,0,0,0,,0,0,,,0,,0,0,0,0,0,RB
309,Deuce Vaughn,23,7,30,2023,22,DAL,7,0,23,40,1.7,0,5.7,1,8.7,7,7,40,5.7,0,5.7,100,5.7,1,42.9,30,40,80,99,19,RB
310,Ke'Shawn Vaughn,24,2,26,2023,26,TAM,6,0,24,42,1.8,0,7,0,20.8,5,2,2,1,0,0.3,40,0.4,0,0,26,42,44,44,0,RB
311,Kenneth Walker III,219,29,248,2023,23,SEA,15,15,219,905,4.1,8,60.3,46,46.6,37,29,259,8.9,1,17.3,78.4,7,9,43.2,248,905,1164,1157,0,RB
312,Jonathan Ward,3,0,3,2023,26,TEN,7,0,3,11,3.7,0,1.6,1,33.3,0,0,0,,0,0,,,0,,3,11,11,11,0,RB
313,Jaylen Warren,149,61,210,2023,25,PIT,17,0,149,784,5.3,4,46.1,36,49.7,74,61,370,6.1,0,21.8,82.4,5,19,44.6,210,784,1154,1154,0,RB
314,Dwayne Washington,0,0,0,2023,29,DEN,13,0,0,0,,0,0,0,,0,0,0,,0,0,,,0,,0,0,0,0,0,RB
315,Rachaad White,272,64,336,2023,24,TAM,17,17,272,990,3.6,6,58.2,46,40.8,70,64,549,8.6,3,32.3,91.4,7.8,23,54.3,336,990,1539,1542,0,RB
316,Zamir White,104,15,119,2023,24,LVR,17,4,104,451,4.3,1,26.5,19,51,19,15,98,6.5,0,5.8,78.9,5.2,4,52.6,119,451,549,549,0,RB
317,Damien Williams,11,2,13,2023,31,ARI,3,0,11,43,3.9,0,14.3,1,54.5,2,2,12,6,0,4,100,6,0,50,13,43,55,55,0,RB
318,Jamaal Williams,106,18,124,2023,28,NOR,13,4,106,306,2.9,1,23.5,19,39.6,20,18,62,3.4,0,4.8,90,3.1,1,30,124,306,368,368,0,RB
319,Javonte Williams,217,47,264,2023,23,DEN,16,13,217,774,3.6,3,48.4,41,40.6,58,47,228,4.9,2,14.3,81,3.9,10,48.3,264,774,1002,1002,0,RB
320,Jonathan Williams,1,0,1,2023,29,WAS,1,0,1,-2,-2,0,-2,0,0,1,0,0,,0,0,0,0,0,0,1,-2,-2,-2,0,RB
321,Kyren Williams,228,32,260,2023,23,LAR,12,11,228,1144,5,12,95.3,62,59.6,48,32,206,6.4,3,17.2,66.7,4.3,9,43.8,260,1144,1350,1379,29,RB
322,Trayveon Williams,15,7,22,2023,26,CIN,17,0,15,69,4.6,0,4.1,2,33.3,9,7,10,1.4,0,0.6,77.8,1.1,0,11.1,22,69,79,369,290,RB
323,Emanuel Wilson,14,4,18,2023,24,GNB,7,0,14,85,6.1,0,12.1,2,64.3,5,4,23,5.8,0,3.3,80,4.6,1,80,18,85,108,108,0,RB
324,Jeff Wilson,41,14,55,2023,28,MIA,10,0,41,188,4.6,0,18.8,8,51.2,17,14,85,6.1,0,8.5,82.4,5,3,29.4,55,188,273,273,0,RB
325,Owen Wright,0,0,0,2023,24,BAL,1,0,0,0,,0,0,0,,0,0,0,,0,0,,,0,,0,0,0,0,0,RB
326,Ameer Abdullah,4,25,29,2022,29,LVR,17,0,4,20,5,0,1.2,2,75,32,25,211,8.4,1,12.4,78.1,6.6,8,34.4,29,20,231,774,543,RB
327,Salvon Ahmed,12,1,13,2022,24,MIA,12,0,12,64,5.3,1,5.3,4,75,1,1,8,8,0,0.7,100,8,0,100,13,64,72,72,0,RB
328,Cam Akers,188,13,201,2022,23,LAR,15,9,188,786,4.2,7,52.4,39,52.7,18,13,117,9,0,7.8,72.2,6.5,8,50,201,786,903,903,0,RB
329,Tyler Allgeier,210,16,226,2022,22,ATL,16,7,210,1035,4.9,3,64.7,53,51.9,17,16,139,8.7,1,8.7,94.1,8.2,8,58.8,226,1035,1174,1174,0,RB
330,Alex Armah,0,0,0,2022,28,WAS,2,0,0,0,,0,0,0,,0,0,0,,0,0,,,0,,0,0,0,0,0,FB
331,Tyler Badie,1,1,2,2022,22,DEN,1,0,1,0,0,0,0,0,0,1,1,24,24,1,24,100,24,1,100,2,0,24,24,0,RB
332,Saquon Barkley,295,57,352,2022,25,NYG,16,16,295,1312,4.4,10,82,62,47.5,76,57,338,5.9,0,21.1,75,4.4,10,38.2,352,1312,1650,1650,0,RB
333,Eno Benjamin,77,25,102,2022,23,"ARI,HOU,NOR",15,3,77,313,4.1,2,20.9,14,46.8,34,25,193,7.7,0,12.9,73.5,5.7,10,44.1,102,313,506,686,180,RB
334,Giovani Bernard,8,2,10,2022,31,TAM,8,0,8,28,3.5,0,3.5,0,50,2,2,-1,-0.5,0,-0.1,100,-0.5,0,0,10,28,27,41,14,RB
335,Raheem Blackshear,23,10,33,2022,23,CAR,13,1,23,77,3.3,3,5.9,7,47.8,12,10,93,9.3,0,7.2,83.3,7.8,3,50,33,77,170,738,568,RB
336,Khari Blasingame,0,0,0,2022,26,CHI,16,6,0,0,,0,0,0,,1,0,0,,0,0,0,0,0,0,0,0,0,0,0,FB
337,Brandon Bolden,17,9,26,2022,32,LVR,16,0,17,66,3.9,0,4.1,3,35.3,9,9,57,6.3,1,3.6,100,6.3,2,44.4,26,66,123,155,32,RB
338,Mike Boone,24,9,33,2022,27,DEN,9,0,24,102,4.3,0,11.3,6,33.3,15,9,96,10.7,0,10.7,60,6.4,2,13.3,33,102,198,198,0,RB
339,Matt Breida,54,20,74,2022,27,NYG,17,1,54,220,4.1,1,12.9,13,50,25,20,118,5.9,0,6.9,80,4.7,5,36,74,220,338,338,0,RB
340,Gary Brightwell,31,5,36,2022,23,NYG,17,0,31,141,4.5,1,8.3,9,41.9,8,5,39,7.8,0,2.3,62.5,4.9,4,50,36,141,180,735,555,RB
341,Brittain Brown,0,0,0,2022,25,LVR,6,0,0,0,,0,0,0,,0,0,0,,0,0,,,0,,0,0,0,0,0,RB
342,Malcolm Brown,18,5,23,2022,29,LAR,11,0,18,81,4.5,1,7.4,3,33.3,6,5,37,7.4,0,3.4,83.3,6.2,2,50,23,81,118,118,0,RB
343,Spencer Brown,9,2,11,2022,24,CAR,2,0,9,43,4.8,0,21.5,1,66.7,4,2,10,5,0,5,50,2.5,0,25,11,43,53,53,0,RB
344,Rex Burkhead,26,37,63,2022,32,HOU,16,0,26,80,3.1,0,5,4,53.8,51,37,204,5.5,1,12.8,72.5,4,8,29.4,63,80,284,284,0,RB
345,Michael Burton,5,2,7,2022,30,KAN,17,0,5,7,1.4,0,0.4,2,40,3,2,11,5.5,0,0.6,66.7,3.7,0,33.3,7,7,18,47,29,RB
346,Trenton Cannon,0,0,0,2022,28,TEN,2,0,0,0,,0,0,0,,0,0,0,,0,0,,,0,,0,0,0,33,33,RB
347,Michael Carter,114,41,155,2022,23,NYJ,16,10,114,402,3.5,3,25.1,14,42.1,54,41,288,7,0,18,75.9,5.3,12,46.3,155,402,690,690,0,RB
348,Tory Carter,0,0,0,2022,23,TEN,9,3,0,0,,0,0,0,,0,0,0,,0,0,,,0,,0,0,0,0,0,FB
349,Ty Chandler,6,0,6,2022,24,MIN,3,0,6,20,3.3,0,6.7,1,33.3,0,0,0,,0,0,,,0,,6,20,20,20,0,RB
350,Julius Chestnut,9,3,12,2022,22,TEN,6,0,9,12,1.3,0,2,1,33.3,3,3,41,13.7,0,6.8,100,13.7,1,66.7,12,12,53,268,215,RB
351,Nick Chubb,302,27,329,2022,27,CLE,17,17,302,1525,5,12,89.7,69,50,37,27,239,8.9,1,14.1,73,6.5,12,51.4,329,1525,1764,1764,0,RB
352,Corey Clement,15,5,20,2022,28,ARI,9,1,15,55,3.7,1,6.1,6,60,7,5,54,10.8,0,6,71.4,7.7,3,42.9,20,55,109,109,0,RB
353,Tevin Coleman,12,3,15,2022,29,SFO,5,0,12,26,2.2,1,5.2,2,25,3,3,44,14.7,1,8.8,100,14.7,2,66.7,15,26,70,70,0,RB
354,James Conner,183,46,229,2022,27,ARI,13,13,183,782,4.3,7,60.2,48,55.2,58,46,300,6.5,1,23.1,79.3,5.2,13,44.8,229,782,1082,1082,0,RB
355,Snoop Conner,12,0,12,2022,23,JAX,8,0,12,42,3.5,1,5.3,2,58.3,0,0,0,,0,0,,,0,,12,42,42,42,0,RB
356,Dalvin Cook,264,39,303,2022,27,MIN,17,17,264,1173,4.4,8,69,50,47.3,56,39,295,7.6,2,17.4,69.6,5.3,16,41.1,303,1168,1468,1482,0,RB
357,James Cook,89,21,110,2022,23,BUF,16,0,89,507,5.7,2,31.7,25,50.6,32,21,180,8.6,1,11.3,65.6,5.6,5,46.9,110,507,687,687,0,RB
358,DeeJay Dallas,35,17,52,2022,24,SEA,15,0,35,186,5.3,0,12.4,9,54.3,19,17,126,7.4,0,8.4,89.5,6.6,5,57.9,52,186,312,731,372,RB
359,Malik Davis,38,6,44,2022,24,DAL,12,0,38,161,4.2,1,13.4,6,39.5,7,6,63,10.5,0,5.3,85.7,9,5,85.7,44,161,224,224,0,RB
360,Mike Davis,8,2,10,2022,29,BAL,8,0,8,18,2.3,0,2.3,1,37.5,2,2,4,2,0,0.5,100,2,0,0,10,18,22,22,0,RB
361,Tyrion Davis-Price,34,0,34,2022,22,SFO,6,0,34,99,2.9,0,16.5,5,32.4,2,0,0,,0,0,0,0,0,0,34,99,99,99,0,RB
362,AJ Dillon,186,28,214,2022,24,GNB,17,3,186,770,4.1,7,45.3,47,56.5,43,28,206,7.4,0,12.1,65.1,4.8,9,39.5,214,770,976,976,0,RB
363,J.K. Dobbins,92,7,99,2022,24,BAL,8,8,92,520,5.7,2,65,26,57.6,8,7,42,6,1,5.3,87.5,5.3,3,62.5,99,520,562,562,0,RB
364,Rico Dowdle,0,0,0,2022,24,DAL,5,0,0,0,,0,0,0,,0,0,0,,0,0,,,0,,0,0,0,0,0,RB
365,Kenyan Drake,109,17,126,2022,28,BAL,12,5,109,482,4.4,4,40.2,21,45,26,17,89,5.2,1,7.4,65.4,3.4,7,34.6,126,482,571,571,0,RB
366,Trestan Ebner,24,2,26,2022,23,CHI,17,0,24,54,2.3,0,3.2,2,33.3,8,2,8,4,0,0.5,25,1,0,25,26,54,62,270,226,RB
367,Chase Edmonds,68,16,84,2022,26,"DEN,MIA",13,3,68,245,3.6,2,18.8,8,42.6,24,16,157,9.8,1,12.1,66.7,6.5,7,41.7,84,245,402,402,0,RB
368,Clyde Edwards-Helaire,71,17,88,2022,23,KAN,10,6,71,302,4.3,3,30.2,15,49.3,23,17,151,8.9,3,15.1,73.9,6.6,11,60.9,88,302,453,457,0,RB
369,Gus Edwards,87,0,87,2022,27,BAL,9,4,87,433,5,3,48.1,30,59.8,2,0,0,,0,0,0,0,0,0,87,433,433,433,0,RB
370,Austin Ekeler,204,107,311,2022,27,LAC,17,17,204,915,4.5,13,53.8,46,48,127,107,722,6.7,5,42.5,84.3,5.7,36,48,311,915,1637,1637,0,RB
371,Ezekiel Elliott,231,17,248,2022,27,DAL,15,14,231,876,3.8,12,58.4,52,47.6,23,17,92,5.4,0,6.1,73.9,4,4,39.1,248,876,968,968,0,RB
372,Travis Etienne,220,35,255,2022,23,JAX,17,12,220,1125,5.1,5,66.2,52,50.9,45,35,316,9,0,18.6,77.8,7,16,44.4,255,1125,1441,1441,0,RB
373,Chris Evans,0,3,3,2022,25,CIN,12,0,0,0,,0,0,0,,4,3,38,12.7,1,3.2,75,9.5,2,50,3,0,38,249,211,RB
374,Darrynton Evans,14,1,15,2022,24,CHI,6,0,14,64,4.6,0,10.7,3,42.9,1,1,33,33,0,5.5,100,33,1,100,15,64,97,97,0,RB
375,Anthony Firkser,0,9,9,2022,27,ATL,11,1,0,0,,0,0,0,,13,9,100,11.1,0,9.1,69.2,7.7,5,38.5,9,0,100,100,0,FB
376,Jerome Ford,8,0,8,2022,23,CLE,13,0,8,12,1.5,0,0.9,1,12.5,0,0,0,,0,0,,,0,,8,12,12,735,723,RB
377,D'Onta Foreman,203,5,208,2022,26,CAR,17,9,203,914,4.5,5,53.8,45,48.8,9,5,26,5.2,0,1.5,55.6,2.9,1,22.2,208,914,940,940,0,RB
378,Leonard Fournette,189,73,262,2022,27,TAM,16,9,189,668,3.5,3,41.8,39,49.2,83,73,523,7.2,3,32.7,88,6.3,26,55.4,262,668,1191,1191,0,RB
379,Royce Freeman,41,6,47,2022,26,HOU,4,1,41,117,2.9,0,29.3,7,39,8,6,33,5.5,0,8.3,75,4.1,0,37.5,47,117,150,150,0,RB
380,Jake Funk,0,0,0,2022,24,"IND,LAR",6,0,0,0,,0,0,0,,0,0,0,,0,0,,,0,,0,0,0,0,0,RB
381,Kenneth Gainwell,53,23,76,2022,23,PHI,17,0,53,240,4.5,4,14.1,17,62.3,29,23,169,7.3,0,9.9,79.3,5.8,7,41.4,76,240,409,409,0,RB
382,Myles Gaskin,10,4,14,2022,25,MIA,4,0,10,26,2.6,0,6.5,2,30,6,4,28,7,0,7,66.7,4.7,0,50,14,26,54,54,0,RB
383,Antonio Gibson,149,46,195,2022,24,WAS,15,6,149,546,3.7,3,36.4,32,49.7,58,46,353,7.7,2,23.5,79.3,6.1,18,46.6,195,546,899,1385,486,RB
384,Cullen Gillaspia,0,0,0,2022,27,SEA,6,0,0,0,,0,0,0,,0,0,0,,0,0,,,0,,0,0,0,0,0,RB
385,Reggie Gilliam,0,8,8,2022,25,BUF,15,4,0,0,,0,0,0,,10,8,69,8.6,1,4.6,80,6.9,4,70,8,0,69,69,0,FB
386,Melvin Gordon,90,25,115,2022,29,DEN,10,6,90,318,3.5,2,31.8,15,50,32,25,223,8.9,0,22.3,78.1,7,11,46.9,115,318,541,541,0,RB
387,Breece Hall,80,19,99,2022,21,NYJ,7,2,80,463,5.8,4,66.1,20,50,31,19,218,11.5,1,31.1,61.3,7,8,35.5,99,463,681,681,0,RB
388,C.J. Ham,4,10,14,2022,29,MIN,17,4,4,7,1.8,2,0.4,3,75,12,10,86,8.6,0,5.1,83.3,7.2,7,83.3,14,7,93,93,0,FB
389,Damien Harris,106,17,123,2022,25,NWE,11,9,106,462,4.4,3,42,23,50,23,17,97,5.7,0,8.8,73.9,4.2,4,43.5,123,462,559,559,0,RB
390,Kevin Harris,18,0,18,2022,22,NWE,5,1,18,52,2.9,1,10.4,3,33.3,0,0,0,,0,0,,,0,,18,52,52,52,0,RB
391,Najee Harris,272,41,313,2022,24,PIT,17,17,272,1034,3.8,7,60.8,45,46,53,41,229,5.6,3,13.5,77.4,4.3,16,49.1,313,1038,1263,1263,0,RB
392,Hassan Haskins,25,11,36,2022,23,TEN,15,1,25,93,3.7,0,6.2,5,44,12,11,57,5.2,0,3.8,91.7,4.8,2,25,36,93,150,564,414,RB
393,Jamycal Hasty,46,20,66,2022,26,JAX,17,0,46,194,4.2,2,11.4,7,37,26,20,126,6.3,1,7.4,76.9,4.8,7,30.8,66,194,320,417,97,RB
394,Darrell Henderson,70,17,87,2022,25,LAR,10,7,70,283,4,3,28.3,14,42.9,22,17,102,6,0,10.2,77.3,4.6,5,50,87,283,385,386,0,RB
395,Derrick Henry,349,33,382,2022,28,TEN,16,16,349,1538,4.4,13,96.1,65,46.7,41,33,398,12.1,0,24.9,80.5,9.7,11,61,382,1542,1936,1930,0,RB
396,Khalil Herbert,129,9,138,2022,24,CHI,13,1,129,731,5.7,4,56.2,26,47.3,12,9,57,6.3,1,4.4,75,4.8,2,16.7,138,731,788,934,146,RB
397,Dontrell Hilliard,22,21,43,2022,27,TEN,12,1,22,145,6.6,0,12.1,4,45.5,26,21,177,8.4,4,14.8,80.8,6.8,8,38.5,43,145,322,349,27,RB
398,Justice Hill,49,12,61,2022,25,BAL,15,0,49,262,5.3,0,17.5,15,59.2,12,12,58,4.8,0,3.9,100,4.8,2,41.7,61,262,320,567,247,RB
399,Kylin Hill,1,0,1,2022,24,GNB,2,0,1,7,7,0,3.5,1,100,0,0,0,,0,0,,,0,,1,7,7,7,0,RB
400,Nyheim Hines,24,30,54,2022,26,"BUF,IND",16,5,24,33,1.4,1,2.1,2,20.8,37,30,241,8,1,15.1,81.1,6.5,11,56.8,54,33,274,1103,818,RB
401,Travis Homer,19,16,35,2022,24,SEA,10,1,19,74,3.9,0,7.4,4,47.4,18,16,157,9.8,1,15.7,88.9,8.7,7,50,35,74,231,231,0,RB
402,Zander Horvath,4,5,9,2022,24,LAC,15,2,4,8,2,0,0.5,2,50,8,5,8,1.6,2,0.5,62.5,1,2,37.5,9,8,16,16,0,FB
403,Jordan Howard,1,0,1,2022,28,NOR,2,0,1,1,1,0,0.5,0,0,0,0,0,,0,0,,,0,,1,1,1,1,0,RB
404,Chuba Hubbard,95,14,109,2022,23,CAR,15,2,95,466,4.9,2,31.1,23,45.3,17,14,171,12.2,0,11.4,82.4,10.1,5,47.1,109,466,637,745,104,RB
405,Caleb Huntley,76,2,78,2022,24,ATL,12,0,76,366,4.8,1,30.5,18,61.8,2,2,3,1.5,0,0.3,100,1.5,0,0,78,366,369,369,0,RB
406,Kareem Hunt,123,35,158,2022,27,CLE,17,0,123,468,3.8,3,27.5,30,48,44,35,210,6,1,12.4,79.5,4.8,11,38.6,158,468,678,678,0,RB
407,Godwin Igwebuike,3,1,4,2022,28,SEA,5,0,3,4,1.3,0,0.8,0,33.3,1,1,3,3,0,0.6,100,3,0,0,4,4,7,315,308,RB
408,Alec Ingold,6,15,21,2022,26,MIA,17,14,6,8,1.3,1,0.5,5,83.3,23,15,105,7,1,6.2,65.2,4.6,4,52.2,21,8,113,133,20,FB
409,Keaontay Ingram,27,4,31,2022,23,ARI,12,0,27,60,2.2,1,5,4,25.9,5,4,21,5.3,0,1.8,80,4.2,1,20,31,60,81,81,0,RB
410,Mark Ingram,62,16,78,2022,33,NOR,10,3,62,233,3.8,1,23.3,12,46.8,18,16,68,4.3,0,6.8,88.9,3.8,2,33.3,78,233,301,301,0,RB
411,Deon Jackson,68,30,98,2022,23,IND,16,2,68,236,3.5,1,14.8,13,38.2,34,30,209,7,1,13.1,88.2,6.1,10,47.1,98,236,445,445,0,RB
412,Justin Jackson,42,12,54,2022,26,DET,16,0,42,170,4,1,10.6,8,45.2,19,12,101,8.4,1,6.3,63.2,5.3,7,52.6,54,170,271,884,613,RB
413,Josh Jacobs,340,53,393,2022,24,LVR,17,17,340,1653,4.9,12,97.2,93,57.4,64,53,400,7.5,0,23.5,82.8,6.3,16,50,393,1653,2053,2053,0,RB
414,David Johnson,12,4,16,2022,31,NOR,5,0,12,24,2,0,4.8,0,33.3,4,4,47,11.8,0,9.4,100,11.8,3,100,16,24,71,71,0,RB
415,D'Ernest Johnson,4,3,7,2022,26,CLE,15,0,4,17,4.3,0,1.1,1,75,3,3,7,2.3,0,0.5,100,2.3,0,33.3,7,17,24,51,27,RB
416,Duke Johnson,2,0,2,2022,29,BUF,1,0,2,4,2,0,4,1,50,0,0,0,,0,0,,,0,,2,4,4,161,157,RB
417,Jakob Johnson,0,5,5,2022,28,LVR,17,9,0,0,,0,0,0,,6,5,10,2,0,0.6,83.3,1.7,0,0,5,0,10,25,15,FB
418,Ty Johnson,30,12,42,2022,25,NYJ,17,1,30,160,5.3,1,9.4,5,36.7,24,12,88,7.3,0,5.2,50,3.7,3,25,42,160,248,287,39,RB
419,Aaron Jones,213,59,272,2022,28,GNB,17,17,213,1121,5.3,2,65.9,54,54.9,72,59,395,6.7,5,23.2,81.9,5.5,19,44.4,272,1121,1516,1516,0,RB
420,Ronald Jones II,17,1,18,2022,25,KAN,6,0,17,70,4.1,1,11.7,4,52.9,1,1,22,22,0,3.7,100,22,1,100,18,70,92,92,0,RB
421,Taiwan Jones,0,0,0,2022,34,BUF,16,0,0,0,,0,0,0,,0,0,0,,0,0,,,0,,0,0,0,2,2,RB
422,Tony Jones,10,5,15,2022,25,"NOR,SEA",6,0,10,24,2.4,0,4,3,50,8,5,30,6,0,5,62.5,3.8,0,37.5,15,24,54,54,0,RB
423,Kyle Juszczyk,7,19,26,2022,31,SFO,16,12,7,26,3.7,1,1.6,5,71.4,23,19,200,10.5,1,12.5,82.6,8.7,9,56.5,26,26,226,226,0,FB
424,Alvin Kamara,223,57,280,2022,27,NOR,15,13,223,897,4,2,59.8,40,52,77,57,490,8.6,2,32.7,74,6.4,17,46.8,280,897,1387,1393,0,RB
425,John Kelly,0,0,0,2022,26,CLE,1,0,0,0,,0,0,0,,0,0,0,,0,0,,,0,,0,0,0,0,0,RB
426,Joshua Kelley,69,14,83,2022,25,LAC,13,1,69,287,4.2,2,22.1,16,56.5,25,14,101,7.2,0,7.8,56,4,4,44,83,287,388,403,15,RB
427,Zonovan Knight,85,13,98,2022,21,NYJ,7,4,85,300,3.5,1,42.9,14,38.8,14,13,100,7.7,0,14.3,92.9,7.1,5,71.4,98,300,400,418,18,RB
428,Phillip Lindsay,15,6,21,2022,28,IND,3,0,15,49,3.3,0,16.3,1,20,8,6,19,3.2,0,6.3,75,2.4,0,25,21,49,68,68,0,RB
429,Marlon Mack,16,8,24,2022,26,"DEN,SFO",8,0,16,84,5.3,1,10.5,4,75,10,8,99,12.4,1,12.4,80,9.9,2,40,24,84,183,203,20,RB
430,Jordan Mason,43,0,43,2022,23,SFO,16,0,43,258,6,1,16.1,10,58.1,0,0,0,,0,0,,,0,,43,258,258,258,0,RB
431,Alexander Mattison,74,15,89,2022,24,MIN,17,0,74,283,3.8,5,16.6,21,47.3,18,15,91,6.1,1,5.4,83.3,5.1,4,33.3,89,283,374,374,0,RB
432,Christian McCaffrey,244,85,329,2022,26,"CAR,SFO",17,16,244,1139,4.7,8,67,59,48.4,108,85,741,8.7,5,43.6,78.7,6.9,36,52.8,329,1173,1880,1880,0,RB
433,Anthony McFarland Jr.,6,2,8,2022,24,PIT,1,0,6,30,5,0,30,3,66.7,2,2,11,5.5,0,11,100,5.5,1,50,8,30,41,41,0,RB
434,J.D. McKissic,22,27,49,2022,29,WAS,8,0,22,95,4.3,0,11.9,5,40.9,40,27,173,6.4,0,21.6,67.5,4.3,7,42.5,49,95,268,268,0,RB
435,Jerick McKinnon,72,56,128,2022,30,KAN,17,0,72,291,4,1,17.1,12,45.8,71,56,512,9.1,9,30.1,78.9,7.2,28,54.9,128,291,803,803,0,RB
436,Sony Michel,36,9,45,2022,27,LAC,10,0,36,106,2.9,0,10.6,8,47.2,13,9,53,5.9,0,5.3,69.2,4.1,1,38.5,45,106,159,159,0,RB
437,Elijah Mitchell,45,3,48,2022,24,SFO,5,1,45,279,6.2,2,55.8,15,71.1,4,3,7,2.3,0,1.4,75,1.8,0,50,48,279,286,286,0,RB
438,Joe Mixon,210,60,270,2022,26,CIN,14,14,210,814,3.9,7,58.1,47,52.4,75,60,441,7.4,2,31.5,80,5.9,17,50.7,270,814,1255,1255,0,RB
439,David Montgomery,201,34,235,2022,25,CHI,16,16,201,801,4,5,50.1,41,44.8,40,34,316,9.3,1,19.8,85,7.9,10,50,235,801,1117,1117,0,RB
440,Zack Moss,93,11,104,2022,25,"BUF,IND",13,3,93,456,4.9,1,35.1,18,47.3,13,11,39,3.5,0,3,84.6,3,2,38.5,104,456,495,495,0,RB
441,Raheem Mostert,181,31,212,2022,30,MIA,16,14,181,891,4.9,3,55.7,44,55.2,42,31,202,6.5,2,12.6,73.8,4.8,11,47.6,212,891,1093,1595,502,RB
442,Latavius Murray,171,27,198,2022,32,"DEN,NOR",13,7,171,760,4.4,6,58.5,44,53.8,35,27,132,4.9,0,10.2,77.1,3.8,4,25.7,198,760,892,877,0,RB
443,Chris Myarick,0,7,7,2022,27,NYG,16,8,0,0,,0,0,0,,8,7,65,9.3,1,4.1,87.5,8.1,5,75,7,0,65,65,0,FB
444,Kene Nwangwu,9,2,11,2022,24,MIN,17,0,9,14,1.6,0,0.8,1,33.3,2,2,21,10.5,0,1.2,100,10.5,1,100,11,14,35,955,920,RB
445,Dare Ogunbowale,42,20,62,2022,28,HOU,17,4,42,123,2.9,1,7.2,10,42.9,26,20,104,5.2,0,6.1,76.9,4,5,34.6,62,123,227,273,46,RB
446,Qadree Ollison,0,0,0,2022,26,DAL,3,0,0,0,,0,0,0,,0,0,0,,0,0,,,0,,0,0,0,0,0,RB
447,Devine Ozigbo,3,1,4,2022,26,DEN,4,0,3,4,1.3,0,1,0,33.3,1,1,3,3,0,0.8,100,3,0,0,4,4,7,7,0,RB
448,Isiah Pacheco,170,13,183,2022,23,KAN,17,11,170,830,4.9,5,48.8,37,57.1,14,13,130,10,0,7.6,92.9,9.3,7,64.3,183,830,960,1559,597,RB
449,Cordarrelle Patterson,144,21,165,2022,31,ATL,13,11,144,695,4.8,8,53.5,39,60.4,31,21,122,5.8,0,9.4,67.7,3.9,6,38.7,165,695,817,1101,284,RB
450,Jaret Patterson,17,0,17,2022,23,WAS,3,0,17,78,4.6,0,26,3,47.1,1,0,0,,0,0,0,0,0,0,17,78,78,175,97,RB
451,Rashaad Penny,57,4,61,2022,26,SEA,5,5,57,346,6.1,2,69.2,15,47.4,5,4,16,4,0,3.2,80,3.2,2,60,61,346,362,362,0,RB
452,Samaje Perine,95,38,133,2022,27,CIN,16,2,95,394,4.1,2,24.6,19,49.5,51,38,287,7.6,4,17.9,74.5,5.6,11,41.2,133,394,681,676,0,RB
453,Dameon Pierce,220,30,250,2022,22,HOU,13,13,220,939,4.3,4,72.2,54,47.7,39,30,165,5.5,1,12.7,76.9,4.2,7,43.6,250,939,1104,1104,0,RB
454,Tony Pollard,193,39,232,2022,25,DAL,16,4,193,1007,5.2,9,62.9,46,47.7,55,39,371,9.5,3,23.2,70.9,6.7,18,47.3,232,1007,1378,1378,0,RB
455,Adam Prentice,4,3,7,2022,25,NOR,11,2,4,9,2.3,0,0.8,3,75,3,3,9,3,0,0.8,100,3,1,33.3,7,9,18,18,0,FB
456,D'Vonte Price,0,0,0,2022,23,IND,1,0,0,0,,0,0,0,,0,0,0,,0,0,,,0,,0,0,0,0,0,RB
457,Craig Reynolds,23,9,32,2022,26,DET,9,0,23,102,4.4,0,11.3,4,39.1,10,9,116,12.9,0,12.9,90,11.6,5,70,32,102,218,218,0,RB
458,Patrick Ricard,7,11,18,2022,28,BAL,17,16,7,16,2.3,0,0.9,5,71.4,13,11,74,6.7,0,4.4,84.6,5.7,1,61.5,18,16,90,105,15,FB
459,Ronnie Rivers,9,5,14,2022,23,LAR,8,1,9,21,2.3,0,2.6,1,44.4,5,5,29,5.8,0,3.6,100,5.8,1,80,14,21,50,50,0,RB
460,Brian Robinson Jr.,205,9,214,2022,23,WAS,12,9,205,797,3.9,2,66.4,49,52.7,12,9,60,6.7,1,5,75,5,3,50,214,797,857,857,0,RB
461,James Robinson,110,11,121,2022,24,"JAX,NYJ",11,5,110,425,3.9,3,38.6,22,35.5,14,11,51,4.6,2,4.6,78.6,3.6,5,50,121,425,476,476,0,RB
462,Larry Rountree,13,2,15,2022,23,LAC,4,0,13,19,1.5,0,4.8,0,7.7,2,2,14,7,0,3.5,100,7,1,50,15,19,33,33,0,RB
463,Miles Sanders,259,20,279,2022,25,PHI,17,15,259,1269,4.9,11,74.6,62,56.8,26,20,78,3.9,0,4.6,76.9,3,2,46.2,279,1269,1347,1349,0,RB
464,Boston Scott,54,5,59,2022,27,PHI,15,2,54,217,4,3,14.5,12,46.3,6,5,15,3,0,1,83.3,2.5,0,16.7,59,217,232,638,406,RB
465,Trey Sermon,2,0,2,2022,23,PHI,2,0,2,19,9.5,0,9.5,2,100,0,0,0,,0,0,,,0,,2,19,19,19,0,RB
466,Devin Singletary,177,38,215,2022,25,BUF,16,16,177,819,4.6,5,51.2,43,52.5,52,38,280,7.4,1,17.5,73.1,5.4,15,53.8,215,819,1099,1099,0,RB
467,Benny Snell Jr.,20,2,22,2022,24,PIT,17,0,20,90,4.5,1,5.3,6,70,2,2,17,8.5,0,1,100,8.5,1,50,22,90,107,137,30,RB
468,Isaiah Spiller,18,3,21,2022,21,LAC,6,0,18,41,2.3,0,6.8,2,22.2,3,3,13,4.3,0,2.2,100,4.3,0,33.3,21,41,54,54,0,RB
469,Rhamondre Stevenson,210,69,279,2022,24,NWE,17,7,210,1040,5,5,61.2,49,45.7,88,69,421,6.1,1,24.8,78.4,4.8,13,39.8,279,1040,1461,1461,0,RB
470,Pierre Strong,10,7,17,2022,24,NWE,15,0,10,100,10,1,6.7,5,70,7,7,42,6,0,2.8,100,6,3,42.9,17,100,142,257,115,RB
471,D'Andre Swift,99,48,147,2022,23,DET,14,8,99,542,5.5,5,38.7,21,47.5,70,48,389,8.1,3,27.8,68.6,5.6,17,38.6,147,542,931,931,0,RB
472,J.J. Taylor,10,1,11,2022,24,NWE,1,0,10,9,0.9,0,9,0,0,1,1,8,8,0,8,100,8,0,100,11,9,17,17,0,RB
473,Jonathan Taylor,192,28,220,2022,23,IND,11,11,192,861,4.5,4,78.3,39,48.4,40,28,143,5.1,0,13,70,3.6,4,32.5,220,861,1004,1004,0,RB
474,Patrick Taylor,10,1,11,2022,24,GNB,14,0,10,31,3.1,0,2.2,2,40,1,1,17,17,0,1.2,100,17,1,100,11,31,48,48,0,RB
475,Ke'Shawn Vaughn,17,3,20,2022,25,TAM,15,0,17,53,3.1,0,3.5,3,52.9,4,3,19,6.3,0,1.3,75,4.8,1,25,20,53,72,72,0,RB
476,Kenneth Walker III,228,27,255,2022,22,SEA,15,11,228,1050,4.6,9,70,51,39.9,35,27,165,6.1,0,11,77.1,4.7,6,37.1,255,1050,1215,1215,0,RB
477,Jonathan Ward,5,2,7,2022,25,"ARI,TEN",8,0,5,25,5,0,3.1,2,60,3,2,7,3.5,0,0.9,66.7,2.3,1,66.7,7,25,32,57,25,RB
478,Jaylen Warren,77,28,105,2022,24,PIT,16,0,77,379,4.9,1,23.7,20,53.2,33,28,214,7.6,0,13.4,84.8,6.5,14,51.5,105,379,593,596,0,RB
479,Dwayne Washington,11,1,12,2022,28,NOR,12,0,11,38,3.5,0,3.2,2,45.5,1,1,7,7,0,0.6,100,7,0,100,12,38,45,130,69,RB
480,Derek Watt,9,5,14,2022,30,PIT,17,3,9,21,2.3,1,1.2,8,88.9,5,5,11,2.2,1,0.6,100,2.2,1,40,14,21,32,32,0,FB
481,Rachaad White,129,50,179,2022,23,TAM,17,8,129,481,3.7,1,28.3,27,49.6,58,50,290,5.8,2,17.1,86.2,5,13,53.4,179,481,771,1015,244,RB
482,Zamir White,17,0,17,2022,23,LVR,14,0,17,70,4.1,0,5,4,41.2,0,0,0,,0,0,,,0,,17,70,70,70,0,RB
483,Jordan Wilkins,13,6,19,2022,28,IND,4,0,13,58,4.5,0,14.5,2,61.5,8,6,29,4.8,0,7.3,75,3.6,1,25,19,58,87,87,0,RB
484,Antonio Williams,0,0,0,2022,25,NYG,2,0,0,0,,0,0,0,,0,0,0,,0,0,,,0,,0,0,0,0,0,RB
485,Avery Williams,22,13,35,2022,24,ATL,17,3,22,109,5,1,6.4,6,45.5,14,13,61,4.7,0,3.6,92.9,4.4,3,35.7,35,109,170,775,605,RB
486,Damien Williams,2,0,2,2022,30,ATL,1,1,2,2,1,0,2,0,0,0,0,0,,0,0,,,0,,2,2,2,2,0,RB
487,Darrel Williams,21,4,25,2022,27,ARI,6,0,21,102,4.9,1,17,8,57.1,8,4,9,2.3,0,1.5,50,1.1,0,12.5,25,102,111,111,0,RB
488,Jamaal Williams,262,12,274,2022,27,DET,17,9,262,1066,4.1,17,62.7,65,53.1,16,12,73,6.1,0,4.3,75,4.6,4,37.5,274,1066,1139,1139,0,RB
489,Javonte Williams,47,16,63,2022,22,DEN,4,4,47,204,4.3,0,51,9,48.9,22,16,76,4.8,0,19,72.7,3.5,4,31.8,63,204,280,280,0,RB
490,Jonathan Williams,37,7,44,2022,28,WAS,13,2,37,152,4.1,0,11.7,6,43.2,10,7,40,5.7,0,3.1,70,4,2,30,44,152,192,211,19,RB
491,Kyren Williams,35,9,44,2022,22,LAR,10,0,35,139,4,0,13.9,6,42.9,12,9,76,8.4,0,7.6,75,6.3,5,58.3,44,139,215,215,0,RB
492,Trayveon Williams,6,2,8,2022,25,CIN,8,0,6,30,5,0,3.8,1,33.3,3,2,30,15,0,3.8,66.7,10,1,33.3,8,30,60,432,356,RB
493,Ty'Son Williams,0,1,1,2022,26,ARI,1,0,0,0,,0,0,0,,1,1,5,5,0,5,100,5,0,0,1,0,5,5,0,RB
494,Jeff Wilson,176,22,198,2022,27,"MIA,SFO",16,7,176,860,4.9,5,53.8,43,50,37,22,185,8.4,1,11.6,59.5,5,7,35.1,198,860,1045,1045,0,RB
495,Ameer Abdullah,51,38,89,2021,28,"CAR,MIN",17,1,51,166,3.3,0,9.8,8,45.1,53,38,289,7.6,1,17,71.7,5.5,13,45.3,89,166,455,1101,646,RB
496,Josh Adams,0,0,0,2021,25,NYJ,1,0,0,0,,0,0,0,,0,0,0,,0,0,,,0,,0,0,0,0,0,RB
497,Salvon Ahmed,54,12,66,2021,23,MIA,12,0,54,149,2.8,0,12.4,8,29.6,19,12,117,9.8,0,9.8,63.2,6.2,4,63.2,66,149,266,266,0,RB
498,Cam Akers,5,3,8,2021,22,LAR,1,0,5,3,0.6,0,3,0,0,3,3,10,3.3,0,10,100,3.3,0,0,8,3,13,13,0,RB
499,Alex Armah,5,1,6,2021,27,"NOR,WAS",11,2,5,21,4.2,0,1.9,4,80,1,1,1,1,1,0.1,100,1,1,100,6,21,22,50,28,FB
500,Ryquell Armstead,15,3,18,2021,25,JAX,2,0,15,80,5.3,0,40,3,60,4,3,16,5.3,0,8,75,4,1,50,18,80,96,96,0,RB
501,Kalen Ballage,12,2,14,2021,26,PIT,17,0,12,36,3,0,2.1,2,41.7,7,2,8,4,0,0.5,28.6,1.1,0,14.3,14,36,44,44,0,RB
502,Peyton Barber,55,10,65,2021,27,LVR,10,1,55,212,3.9,2,21.2,12,47.3,13,10,67,6.7,0,6.7,76.9,5.2,3,30.8,65,212,279,328,49,RB
503,Jake Bargas,0,0,0,2021,25,MIN,1,0,0,0,,0,0,0,,0,0,0,,0,0,,,0,,0,0,0,0,0,FB
504,Saquon Barkley,162,41,203,2021,24,NYG,13,13,162,593,3.7,2,45.6,27,42,57,41,263,6.4,2,20.2,71.9,4.6,13,36.8,203,593,856,856,0,RB
505,Kenjon Barner,4,0,4,2021,32,TAM,3,0,4,0,0,0,0,0,0,0,0,0,,0,0,,,0,,4,0,0,47,47,RB
506,Nick Bawden,0,1,1,2021,25,NYJ,9,1,0,0,,0,0,0,,1,1,20,20,0,2.2,100,20,1,100,1,0,20,20,0,RB
507,Le'Veon Bell,39,5,44,2021,29,"BAL,TAM",8,0,39,101,2.6,2,12.6,9,46.2,7,5,30,6,1,3.8,71.4,4.3,3,42.9,44,101,131,131,0,RB
508,Eno Benjamin,34,6,40,2021,22,ARI,9,0,34,118,3.5,1,13.1,4,41.2,7,6,42,7,0,4.7,85.7,6,4,71.4,40,118,160,322,162,RB
509,Giovani Bernard,8,23,31,2021,30,TAM,12,0,8,58,7.3,0,4.8,3,62.5,29,23,123,5.3,3,10.3,79.3,4.2,8,44.8,31,58,181,241,60,RB
510,Khari Blasingame,3,2,5,2021,25,TEN,11,3,3,6,2,0,0.5,1,33.3,2,2,4,2,0,0.4,100,2,0,50,5,6,10,22,12,RB
511,Brandon Bolden,44,41,85,2021,31,NWE,17,1,44,226,5.1,1,13.3,12,43.2,49,41,405,9.9,2,23.8,83.7,8.3,21,49,85,226,631,693,62,RB
512,Reggie Bonnafon,1,2,3,2021,25,CAR,4,0,1,4,4,0,1,0,100,2,2,12,6,0,3,100,6,1,100,3,4,16,16,0,RB
513,Devontae Booker,145,40,185,2021,29,NYG,16,4,145,593,4.1,2,37.1,31,44.1,45,40,268,6.7,1,16.8,88.9,6,11,51.1,185,593,861,861,0,RB
514,Mike Boone,4,2,6,2021,26,DEN,8,0,4,35,8.8,0,4.4,2,50,2,2,22,11,0,2.8,100,11,1,50,6,35,57,57,0,RB
515,Darius Bradwell,0,0,0,2021,24,LAC,2,0,0,0,,0,0,0,,1,0,0,,0,0,0,0,0,0,0,0,0,0,0,FB
516,Matt Breida,26,7,33,2021,26,BUF,9,0,26,125,4.8,1,13.9,5,65.4,9,7,72,10.3,2,8,77.8,8,4,66.7,33,125,197,224,27,RB
517,Gary Brightwell,1,1,2,2021,22,NYG,13,0,1,4,4,0,0.3,0,100,1,1,6,6,0,0.5,100,6,0,100,2,4,10,10,0,RB
518,Malcolm Brown,33,3,36,2021,28,MIA,7,3,33,125,3.8,1,17.9,6,51.5,5,3,10,3.3,0,1.4,60,2,0,40,36,125,135,135,0,RB
519,Spencer Brown,0,0,0,2021,23,CAR,4,0,0,0,,0,0,0,,0,0,0,,0,0,,,0,,0,0,0,0,0,RB
520,Rex Burkhead,122,25,147,2021,31,HOU,16,5,122,427,3.5,3,26.7,30,44.3,32,25,186,7.4,0,11.6,78.1,5.8,9,46.9,147,427,613,613,0,RB
521,Michael Burton,8,3,11,2021,29,KAN,16,0,8,26,3.3,1,1.6,8,100,3,3,31,10.3,0,1.9,100,10.3,2,66.7,11,26,57,78,21,RB
522,Trenton Cannon,3,0,3,2021,27,"BAL,SFO",12,0,3,4,1.3,0,0.3,0,33.3,0,0,0,,0,0,,,0,,3,4,4,334,328,RB
523,Chris Carson,54,6,60,2021,27,SEA,4,4,54,232,4.3,3,58,11,55.6,6,6,29,4.8,0,7.3,100,4.8,1,66.7,60,232,261,261,0,RB
524,Michael Carter,147,36,183,2021,22,NYJ,14,11,147,639,4.3,4,45.6,29,51,55,36,325,9,0,23.2,65.5,5.9,16,47.3,183,639,964,964,0,RB
525,Tory Carter,0,0,0,2021,22,TEN,8,2,0,0,,0,0,0,,0,0,0,,0,0,,,0,,0,0,0,0,0,FB
526,Nick Chubb,228,20,248,2021,26,CLE,14,14,228,1259,5.5,8,89.9,61,49.1,25,20,174,8.7,1,12.4,80,7,9,52,248,1259,1433,1433,0,RB
527,Corey Clement,33,6,39,2021,27,DAL,17,0,33,140,4.2,0,8.2,7,42.4,7,6,29,4.8,1,1.7,85.7,4.1,1,28.6,39,140,169,387,215,RB
528,Tevin Coleman,84,11,95,2021,28,NYJ,11,5,84,356,4.2,0,32.4,19,53.6,16,11,49,4.5,0,4.5,68.8,3.1,2,37.5,95,356,405,722,317,RB
529,Alex Collins,108,9,117,2021,27,SEA,11,6,108,411,3.8,2,37.4,22,50.9,10,9,87,9.7,0,7.9,90,8.7,3,60,117,411,498,498,0,RB
530,James Conner,202,37,239,2021,26,ARI,15,6,202,752,3.7,15,50.1,53,50,39,37,375,10.1,3,25,94.9,9.6,18,71.8,239,752,1127,1127,0,RB
531,Dalvin Cook,249,34,283,2021,26,MIN,13,13,249,1159,4.7,6,89.2,57,46.2,49,34,224,6.6,0,17.2,69.4,4.6,9,38.8,283,1159,1383,1383,0,RB
532,Nathan Cottrell,1,0,1,2021,25,JAX,4,0,1,3,3,0,0.8,0,0,0,0,0,,0,0,,,0,,1,3,3,3,0,RB
533,Damarea Crockett,3,0,3,2021,24,DEN,12,0,3,7,2.3,0,0.6,0,33.3,0,0,0,,0,0,,,0,,3,7,7,7,0,RB
534,DeeJay Dallas,33,21,54,2021,23,SEA,17,0,33,138,4.2,2,8.1,10,57.6,23,21,133,6.3,0,7.8,91.3,5.8,4,56.5,54,138,271,1035,764,RB
535,Mike Davis,138,44,182,2021,28,ATL,17,8,138,503,3.6,3,29.6,21,42,58,44,259,5.9,1,15.2,75.9,4.5,12,39.7,182,503,762,762,0,RB
536,AJ Dillon,187,34,221,2021,23,GNB,17,2,187,803,4.3,5,47.2,50,61,37,34,313,9.2,2,18.4,91.9,8.5,15,62.2,221,803,1116,1119,0,RB
537,Kenyan Drake,63,30,93,2021,27,LVR,12,2,63,254,4,2,21.2,15,44.4,40,30,291,9.7,1,24.3,75,7.3,12,57.5,93,254,545,737,192,RB
538,Chase Edmonds,116,43,159,2021,25,ARI,12,11,116,592,5.1,2,49.3,32,56.9,53,43,311,7.2,0,25.9,81.1,5.9,11,35.8,159,592,903,903,0,RB
539,Trey Edmunds,0,0,0,2021,27,PIT,2,0,0,0,,0,0,0,,0,0,0,,0,0,,,0,,0,0,0,0,0,RB
540,Clyde Edwards-Helaire,119,19,138,2021,22,KAN,10,10,119,517,4.3,4,51.7,21,56.3,23,19,129,6.8,2,12.9,82.6,5.6,8,56.5,138,517,646,646,0,RB
541,Austin Ekeler,206,70,276,2021,26,LAC,16,16,206,911,4.4,12,56.9,53,55.8,94,70,647,9.2,8,40.4,74.5,6.9,31,53.2,276,911,1558,1558,0,RB
542,Ezekiel Elliott,237,47,284,2021,26,DAL,17,17,237,1002,4.2,10,58.9,55,51.5,65,47,287,6.1,2,16.9,72.3,4.4,17,38.5,284,1006,1289,1289,0,RB
543,Chris Evans,17,15,32,2021,24,CIN,14,1,17,77,4.5,0,5.5,3,41.2,17,15,151,10.1,2,10.8,88.2,8.9,6,58.8,32,77,228,286,58,RB
544,Darrynton Evans,2,2,4,2021,23,TEN,1,0,2,7,3.5,0,7,0,0,2,2,11,5.5,0,11,100,5.5,1,100,4,7,18,35,17,RB
545,Tavien Feaster,0,0,0,2021,24,ARI,3,0,0,0,,0,0,0,,0,0,0,,0,0,,,0,,0,0,0,0,0,RB
546,Anthony Firkser,0,34,34,2021,26,TEN,15,1,0,0,,0,0,0,,43,34,291,8.6,2,19.4,79.1,6.8,15,55.8,34,0,291,284,0,FB
547,D'Onta Foreman,133,9,142,2021,25,TEN,9,3,133,566,4.3,3,62.9,22,48.9,11,9,123,13.7,0,13.7,81.8,11.2,6,72.7,142,566,689,692,0,RB
548,Leonard Fournette,180,69,249,2021,26,TAM,14,13,180,812,4.5,8,58,45,56.1,84,69,454,6.6,2,32.4,82.1,5.4,30,57.1,249,812,1266,1266,0,RB
549,Devonta Freeman,133,34,167,2021,29,BAL,16,8,133,576,4.3,5,36,31,58.6,42,34,190,5.6,1,11.9,81,4.5,9,42.9,167,576,766,766,0,RB
550,Royce Freeman,56,10,66,2021,25,"CAR,HOU",15,0,56,169,3,0,11.3,8,44.6,16,10,77,7.7,0,5.1,62.5,4.8,4,56.3,66,169,246,246,0,RB
551,Jake Funk,2,0,2,2021,23,LAR,10,0,2,5,2.5,0,0.5,0,50,0,0,0,,0,0,,,0,,2,5,5,93,88,RB
552,Kenneth Gainwell,68,33,101,2021,22,PHI,16,1,68,291,4.3,5,18.2,19,50,50,33,253,7.7,1,15.8,66,5.1,14,44,101,291,544,681,137,RB
553,Wayne Gallman,28,1,29,2021,27,"ATL,MIN",8,0,28,104,3.7,0,13,5,35.7,3,1,21,21,0,2.6,33.3,7,1,33.3,29,104,125,132,7,RB
554,Myles Gaskin,173,49,222,2021,24,MIA,17,10,173,612,3.5,3,36,25,41.6,63,49,234,4.8,4,13.8,77.8,3.7,13,46,222,612,846,891,29,RB
555,Antonio Gibson,258,42,300,2021,23,WAS,16,14,258,1037,4,7,64.8,65,51.2,52,42,294,7,3,18.4,80.8,5.7,12,50,300,1037,1331,1331,0,RB
556,Cullen Gillaspia,0,0,0,2021,26,NYG,15,0,0,0,,0,0,0,,0,0,0,,0,0,,,0,,0,0,0,0,0,RB
557,Reggie Gilliam,3,3,6,2021,24,BUF,16,5,3,3,1,0,0.2,0,0,5,3,23,7.7,0,1.4,60,4.6,0,60,6,3,26,26,0,FB
558,Melvin Gordon,203,28,231,2021,28,DEN,16,16,203,918,4.5,8,57.4,48,55.2,38,28,213,7.6,2,13.3,73.7,5.6,9,36.8,231,918,1131,1131,0,RB
559,Derrick Gore,51,8,59,2021,27,KAN,11,0,51,256,5,2,23.3,12,60.8,9,8,105,13.1,0,9.5,88.9,11.7,3,77.8,59,256,361,361,0,RB
560,C.J. Ham,7,17,24,2021,28,MIN,17,8,7,34,4.9,0,2,3,42.9,18,17,125,7.4,0,7.4,94.4,6.9,6,55.6,24,34,159,159,0,FB
561,JaQuan Hardy,4,0,4,2021,24,DAL,3,0,4,29,7.3,1,9.7,1,50,0,0,0,,0,0,,,0,,4,29,29,44,15,RB
562,Damien Harris,202,18,220,2021,24,NWE,15,15,202,929,4.6,15,61.9,55,54,21,18,132,7.3,0,8.8,85.7,6.3,4,61.9,220,929,1061,1063,0,RB
563,Najee Harris,307,74,381,2021,23,PIT,17,17,307,1200,3.9,7,70.6,62,47.6,94,74,467,6.3,3,27.5,78.7,5,22,48.9,381,1200,1667,1667,0,RB
564,Jamycal Hasty,16,23,39,2021,25,SFO,11,0,16,68,4.3,1,6.2,6,43.8,29,23,157,6.8,0,14.3,79.3,5.4,7,51.7,39,68,225,370,145,RB
565,Darrell Henderson,149,29,178,2021,24,LAR,12,10,149,688,4.6,5,57.3,39,57,40,29,176,6.1,3,14.7,72.5,4.4,8,40,178,688,864,864,0,RB
566,Derrick Henry,219,18,237,2021,27,TEN,8,8,219,937,4.3,10,117.1,49,44.7,20,18,154,8.6,0,19.3,90,7.7,7,80,237,942,1091,1091,0,RB
567,Khalil Herbert,103,14,117,2021,23,CHI,17,2,103,433,4.2,2,25.5,24,50.5,16,14,96,6.9,0,5.6,87.5,6,6,50,117,433,529,1179,650,RB
568,Chris Herndon,0,4,4,2021,25,MIN,16,5,0,0,,0,0,0,,7,4,40,10,1,2.5,57.1,5.7,4,57.1,4,0,40,40,0,FB
569,Brian Hill,0,0,0,2021,26,SFO,3,0,0,0,,0,0,0,,0,0,0,,0,0,,,0,,0,0,0,0,0,RB
570,Dontrell Hilliard,56,19,75,2021,26,TEN,8,5,56,350,6.3,2,43.8,15,46.4,26,19,87,4.6,0,10.9,73.1,3.3,7,34.6,75,350,437,614,177,RB
571,Kylin Hill,10,1,11,2021,23,GNB,8,0,10,24,2.4,0,3,1,20,2,1,5,5,0,0.6,50,2.5,0,50,11,24,29,228,199,RB
572,Nyheim Hines,56,40,96,2021,25,IND,17,4,56,276,4.9,2,16.2,15,48.2,57,40,310,7.8,1,18.2,70.2,5.4,15,42.1,96,276,586,826,240,RB
573,Travis Homer,21,16,37,2021,23,SEA,14,0,21,177,8.4,1,12.6,7,57.1,20,16,161,10.1,0,11.5,80,8.1,8,50,37,177,338,383,44,RB
574,Jordan Howard,86,2,88,2021,27,PHI,7,0,86,406,4.7,3,58,24,62.8,5,2,19,9.5,0,2.7,40,3.8,2,40,88,406,425,422,0,RB
575,Buddy Howell,5,0,5,2021,25,LAR,10,0,5,11,2.2,0,1.1,0,0,0,0,0,,0,0,,,0,,5,11,11,45,34,RB
576,Chuba Hubbard,172,25,197,2021,22,CAR,17,10,172,612,3.6,5,36,36,43,37,25,174,7,1,10.2,67.6,4.7,8,40.5,197,612,786,807,21,RB
577,Jason Huntley,13,0,13,2021,23,PHI,1,0,13,51,3.9,0,51,2,30.8,1,0,0,,0,0,0,0,0,0,13,51,51,135,84,RB
578,Kareem Hunt,78,22,100,2021,26,CLE,8,1,78,386,4.9,5,48.3,22,47.4,27,22,174,7.9,0,21.8,81.5,6.4,10,51.9,100,386,560,560,0,RB
579,Carlos Hyde,72,12,84,2021,31,JAX,12,2,72,253,3.5,1,21.1,14,50,21,12,65,5.4,0,5.4,57.1,3.1,1,38.1,84,253,318,318,0,RB
580,Godwin Igwebuike,18,7,25,2021,27,DET,17,1,18,118,6.6,1,6.9,7,61.1,10,7,60,8.6,0,3.5,70,6,4,40,25,118,178,875,697,RB
581,Alec Ingold,2,10,12,2021,25,LVR,9,3,2,1,0.5,0,0.1,1,50,12,10,85,8.5,1,9.4,83.3,7.1,4,75,12,1,86,87,0,FB
582,Mark Ingram,160,27,187,2021,32,"HOU,NOR",14,10,160,554,3.5,2,39.6,23,38.1,35,27,162,6,0,11.6,77.1,4.6,9,45.7,187,554,716,716,0,RB
583,Deon Jackson,13,0,13,2021,22,IND,9,0,13,31,2.4,1,3.4,2,30.8,0,0,0,,0,0,,,0,,13,31,31,31,0,RB
584,Justin Jackson,68,22,90,2021,25,LAC,14,2,68,364,5.4,2,26,18,50,25,22,178,8.1,0,12.7,88,7.1,8,68,90,364,542,542,0,RB
585,Josh Jacobs,217,54,271,2021,23,LVR,15,14,217,872,4,9,58.1,45,53,64,54,348,6.4,0,23.2,84.4,5.4,14,51.6,271,872,1220,1220,0,RB
586,Andy Janovich,2,3,5,2021,28,CLE,13,3,2,0,0,1,0,1,50,4,3,9,3,0,0.7,75,2.3,1,25,5,0,9,28,19,RB
587,Jermar Jefferson,15,4,19,2021,21,DET,7,0,15,74,4.9,2,10.6,4,53.3,5,4,23,5.8,0,3.3,80,4.6,2,60,19,74,97,97,0,RB
588,David Johnson,67,32,99,2021,30,HOU,13,4,67,228,3.4,0,17.5,7,34.3,42,32,225,7,1,17.3,76.2,5.4,11,42.9,99,228,453,453,0,RB
589,D'Ernest Johnson,100,19,119,2021,25,CLE,17,2,100,534,5.3,3,31.4,24,52,25,19,137,7.2,0,8.1,76,5.5,7,44,119,534,671,810,139,RB
590,Duke Johnson,71,4,75,2021,28,MIA,5,4,71,330,4.6,3,66,18,49.3,5,4,41,10.3,0,8.2,80,8.2,3,80,75,330,371,371,0,RB
591,Jakob Johnson,0,4,4,2021,27,NWE,17,6,0,0,,0,0,0,,5,4,43,10.8,0,2.5,80,8.6,2,60,4,0,43,57,14,FB
592,Josh Johnson,0,0,0,2021,24,SEA,3,0,0,0,,0,0,0,,0,0,0,,0,0,,,0,,0,0,0,0,0,RB
593,Kerryon Johnson,0,0,0,2021,24,SFO,1,0,0,0,,0,0,0,,0,0,0,,0,0,,,0,,0,0,0,0,0,RB
594,Ty Johnson,61,34,95,2021,24,NYJ,16,3,61,238,3.9,2,14.9,13,47.5,55,34,372,10.9,2,23.3,61.8,6.8,20,47.3,95,238,610,667,57,RB
595,Aaron Jones,171,52,223,2021,27,GNB,15,15,171,799,4.7,4,53.3,37,49.7,65,52,391,7.5,6,26.1,80,6,22,50.8,223,799,1190,1209,19,RB
596,Ronald Jones II,101,10,111,2021,24,TAM,16,3,101,428,4.2,4,26.8,25,62.4,13,10,64,6.4,0,4,76.9,4.9,2,61.5,111,428,492,492,0,RB
597,Taiwan Jones,0,0,0,2021,33,BUF,17,0,0,0,,0,0,0,,0,0,0,,0,0,,,0,,0,0,0,14,14,RB
598,Tony Jones,54,5,59,2021,24,NOR,11,4,54,142,2.6,0,12.9,7,37,8,5,29,5.8,0,2.6,62.5,3.6,2,50,59,142,171,176,5,RB
599,Kyle Juszczyk,8,30,38,2021,30,SFO,17,16,8,22,2.8,1,1.3,3,50,38,30,296,9.9,1,17.4,78.9,7.8,16,63.2,38,22,318,318,0,FB
600,Alvin Kamara,240,47,287,2021,26,NOR,13,10,240,898,3.7,4,69.1,42,41.3,67,47,439,9.3,5,33.8,70.1,6.6,20,43.3,287,898,1337,1366,29,RB
601,John Kelly,2,0,2,2021,25,CLE,4,0,2,13,6.5,0,3.3,1,50,0,0,0,,0,0,,,0,,2,13,13,13,0,RB
602,Joshua Kelley,33,5,38,2021,24,LAC,10,0,33,102,3.1,0,10.2,5,30.3,6,5,38,7.6,0,3.8,83.3,6.3,1,50,38,102,140,140,0,RB
603,Patrick Laird,1,3,4,2021,26,MIA,6,0,1,4,4,0,0.7,0,100,3,3,17,5.7,0,2.8,100,5.7,2,66.7,4,4,21,21,0,RB
604,Phillip Lindsay,88,4,92,2021,27,"HOU,MIA",14,1,88,249,2.8,1,17.8,11,37.5,5,4,45,11.3,1,3.2,80,9,1,80,92,249,294,366,72,RB
605,Marlon Mack,28,2,30,2021,25,IND,6,0,28,101,3.6,0,16.8,6,32.1,5,2,8,4,0,1.3,40,1.6,0,20,30,101,109,109,0,RB
606,Alexander Mattison,134,32,166,2021,23,MIN,16,4,134,491,3.7,3,30.7,28,44,39,32,228,7.1,1,14.3,82.1,5.8,10,43.6,166,491,719,738,18,RB
607,Christian McCaffrey,99,37,136,2021,25,CAR,7,7,99,442,4.5,1,63.1,20,50.5,41,37,343,9.3,1,49,90.2,8.4,21,65.9,136,442,785,788,0,RB
608,Nate McCrary,1,0,1,2021,22,BAL,1,0,1,-1,-1,0,-1,0,0,0,0,0,,0,0,,,0,,1,-1,-1,-1,0,RB
609,Anthony McFarland Jr.,3,1,4,2021,23,PIT,2,0,3,3,1,0,1.5,0,0,1,1,11,11,0,5.5,100,11,1,100,4,3,14,87,73,RB
610,J.D. McKissic,48,43,91,2021,28,WAS,11,3,48,212,4.4,2,19.3,14,60.4,53,43,397,9.2,2,36.1,81.1,7.5,15,52.8,91,212,609,609,0,RB
611,Jerick McKinnon,12,13,25,2021,29,KAN,13,0,12,62,5.2,0,4.8,2,58.3,20,13,107,8.2,1,8.2,65,5.4,6,45,25,62,169,168,0,RB
612,Jeremy McNichols,41,28,69,2021,26,TEN,14,0,41,156,3.8,0,11.1,6,41.5,38,28,240,8.6,1,17.1,73.7,6.3,11,39.5,69,156,396,427,31,RB
613,Sony Michel,208,21,229,2021,26,LAR,17,7,208,845,4.1,4,49.7,49,51.4,33,21,128,6.1,1,7.5,63.6,3.9,6,42.4,229,845,973,1063,90,RB
614,Elijah Mitchell,207,19,226,2021,23,SFO,11,10,207,963,4.7,5,87.5,47,49.8,20,19,137,7.2,1,12.5,95,6.9,6,50,226,963,1100,1100,0,RB
615,Joe Mixon,292,42,334,2021,25,CIN,16,16,292,1205,4.1,13,75.3,60,49.7,48,42,314,7.5,3,19.6,87.5,6.5,11,43.8,334,1205,1519,1519,0,RB
616,David Montgomery,225,42,267,2021,24,CHI,13,13,225,849,3.8,7,65.3,55,46.7,51,42,301,7.2,0,23.2,82.4,5.9,18,43.1,267,849,1150,1153,0,RB
617,Zack Moss,96,23,119,2021,24,BUF,13,0,96,345,3.6,4,26.5,22,49,32,23,197,8.6,1,15.2,71.9,6.2,12,53.1,119,345,542,542,0,RB
618,Raheem Mostert,2,0,2,2021,29,SFO,1,1,2,20,10,0,20,1,100,0,0,0,,0,0,,,0,,2,20,20,20,0,RB
619,Latavius Murray,119,10,129,2021,31,BAL,14,6,119,501,4.2,6,35.8,36,58,13,10,75,7.5,0,5.4,76.9,5.8,2,53.8,129,501,576,576,0,RB
620,Gabe Nabers,3,3,6,2021,24,LAC,10,1,3,8,2.7,0,0.8,1,66.7,3,3,17,5.7,0,1.7,100,5.7,0,66.7,6,8,25,25,0,FB
621,Ryan Nall,1,1,2,2021,26,CHI,9,0,1,4,4,0,0.4,0,100,1,1,4,4,0,0.4,100,4,0,100,2,4,8,8,0,RB
622,Kene Nwangwu,13,4,17,2021,23,MIN,11,0,13,61,4.7,0,5.5,3,30.8,5,4,9,2.3,0,0.8,80,1.8,0,20,17,61,70,649,579,RB
623,Dare Ogunbowale,43,13,56,2021,27,JAX,17,2,43,137,3.2,1,8.1,5,37.2,21,13,114,8.8,1,6.7,61.9,5.4,3,33.3,56,137,251,251,0,RB
624,Qadree Ollison,21,4,25,2021,25,ATL,8,0,21,105,5,1,13.1,7,52.4,6,4,12,3,0,1.5,66.7,2,1,33.3,25,105,117,117,0,RB
625,Devine Ozigbo,1,1,2,2021,25,"JAX,NOR",3,0,1,-3,-3,0,-1,0,0,1,1,7,7,0,2.3,100,7,1,100,2,-3,4,4,0,RB
626,Jacques Patrick,2,0,2,2021,24,SFO,2,0,2,12,6,0,6,1,100,0,0,0,,0,0,,,0,,2,12,12,12,0,RB
627,Cordarrelle Patterson,153,52,205,2021,30,ATL,16,13,153,618,4,6,38.6,29,43.1,69,52,548,10.5,5,34.3,75.4,7.9,26,52.2,205,618,1166,1609,434,RB
628,Jaret Patterson,68,10,78,2021,22,WAS,17,1,68,266,3.9,2,15.6,15,50,11,10,73,7.3,0,4.3,90.9,6.6,5,54.5,78,266,339,339,0,RB
629,Elijhaa Penny,24,9,33,2021,28,NYG,17,3,24,99,4.1,1,5.8,9,50,13,9,30,3.3,1,1.8,69.2,2.3,4,30.8,33,99,129,129,0,RB
630,Rashaad Penny,119,6,125,2021,25,SEA,10,6,119,749,6.3,6,74.9,28,46.2,8,6,48,8,0,4.8,75,6,3,37.5,125,749,797,797,0,RB
631,La'Mical Perine,8,0,8,2021,23,NYJ,4,0,8,31,3.9,0,7.8,1,25,0,0,0,,0,0,,,0,,8,31,31,31,0,RB
632,Samaje Perine,55,27,82,2021,26,CIN,16,0,55,246,4.5,1,15.4,11,41.8,31,27,196,7.3,1,12.3,87.1,6.3,9,35.5,82,246,442,442,0,RB
633,Adrian Peterson,38,4,42,2021,36,"TEN,SEA",4,3,38,98,2.6,2,24.5,6,42.1,4,4,8,2,0,2,100,2,0,25,42,98,106,106,0,RB
634,Scottie Phillips,6,2,8,2021,24,HOU,3,0,6,13,2.2,0,4.3,1,33.3,3,2,9,4.5,0,3,66.7,3,0,33.3,8,13,22,22,0,RB
635,Artavis Pierce,0,0,0,2021,25,CHI,1,0,0,0,,0,0,0,,0,0,0,,0,0,,,0,,0,0,0,27,27,RB
636,Tony Pollard,130,39,169,2021,24,DAL,15,0,130,719,5.5,2,47.9,35,53.8,46,39,337,8.6,0,22.5,84.8,7.3,15,58.7,169,719,1056,1545,489,RB
637,Adam Prentice,3,3,6,2021,24,NOR,7,3,3,5,1.7,0,0.7,2,66.7,3,3,16,5.3,0,2.3,100,5.3,1,33.3,6,5,21,21,0,FB
638,Trey Ragas,1,2,3,2021,25,LVR,1,0,1,9,9,0,9,1,100,2,2,6,3,0,6,100,3,0,50,3,9,15,15,0,RB
639,Nick Ralston,0,0,0,2021,25,DAL,4,0,0,0,,0,0,0,,0,0,0,,0,0,,,0,,0,0,0,0,0,FB
640,Craig Reynolds,55,7,62,2021,25,DET,5,2,55,230,4.2,0,46,11,43.6,8,7,52,7.4,0,10.4,87.5,6.5,3,62.5,62,230,282,282,0,RB
641,Patrick Ricard,2,8,10,2021,27,BAL,13,11,2,4,2,0,0.3,2,100,13,8,63,7.9,1,4.8,61.5,4.8,3,38.5,10,4,67,67,0,FB
642,Giovanni Ricci,0,0,0,2021,25,CAR,16,1,0,0,,0,0,0,,2,0,0,,0,0,0,0,0,0,0,0,0,0,0,FB
643,Jalen Richard,9,12,21,2021,28,LVR,10,0,9,40,4.4,0,4,3,44.4,14,12,72,6,0,7.2,85.7,5.1,4,64.3,21,40,112,339,227,RB
644,James Robinson,164,31,195,2021,23,JAX,14,13,164,767,4.7,8,54.8,41,50,46,31,222,7.2,0,15.9,67.4,4.8,9,41.3,195,767,989,989,0,RB
645,Larry Rountree,36,1,37,2021,22,LAC,12,0,36,87,2.4,1,7.3,5,33.3,2,1,-1,-1,0,-0.1,50,-0.5,0,0,37,87,86,203,117,RB
646,Jaylen Samuels,5,3,8,2021,25,HOU,3,0,5,9,1.8,0,3,0,0,4,3,14,4.7,0,4.7,75,3.5,1,50,8,9,23,23,0,RB
647,Miles Sanders,137,26,163,2021,24,PHI,12,12,137,754,5.5,0,62.8,33,59.1,34,26,158,6.1,0,13.2,76.5,4.6,6,38.2,163,754,912,912,0,RB
648,Mekhi Sargent,5,0,5,2021,24,"JAX,TEN,LAR",7,0,5,11,2.2,0,1.6,1,20,1,0,0,,0,0,0,0,0,0,5,11,11,11,0,RB
649,Jordan Scarlett,0,0,0,2021,25,MIA,1,0,0,0,,0,0,0,,0,0,0,,0,0,,,0,,0,0,0,0,0,RB
650,Boston Scott,87,13,100,2021,26,PHI,16,4,87,373,4.3,7,23.3,24,56.3,16,13,83,6.4,0,5.2,81.3,5.2,3,37.5,100,373,456,469,13,RB
651,Trey Sermon,41,3,44,2021,22,SFO,9,2,41,167,4.1,1,18.6,9,56.1,4,3,26,8.7,0,2.9,75,6.5,1,25,44,167,193,193,0,RB
652,Devin Singletary,188,40,228,2021,24,BUF,17,16,188,870,4.6,7,51.2,44,47.3,50,40,228,5.7,1,13.4,80,4.6,11,48,228,870,1098,1103,0,RB
653,Wendell Smallwood,5,4,9,2021,27,WAS,3,0,5,25,5,0,8.3,2,60,5,4,22,5.5,0,7.3,80,4.4,0,40,9,25,47,47,0,RB
654,Ito Smith,1,0,1,2021,26,DAL,1,0,1,4,4,1,4,1,100,0,0,0,,0,0,,,0,,1,4,4,4,0,RB
655,Keith Smith,9,9,18,2021,29,ATL,17,8,9,31,3.4,0,1.8,3,55.6,10,9,56,6.2,0,3.3,90,5.6,3,60,18,31,87,113,26,FB
656,Rodney Smith,0,5,5,2021,25,CAR,2,0,0,0,,0,0,0,,5,5,48,9.6,0,24,100,9.6,2,100,5,0,48,48,0,RB
657,Benny Snell Jr.,36,2,38,2021,23,PIT,17,0,36,98,2.7,0,5.8,3,30.6,4,2,13,6.5,0,0.8,50,3.3,0,25,38,98,111,111,0,RB
658,Johnny Stanton,3,2,5,2021,27,CLE,4,0,3,5,1.7,0,1.3,2,66.7,2,2,7,3.5,1,1.8,100,3.5,1,50,5,5,12,12,0,RB
659,Rhamondre Stevenson,133,14,147,2021,23,NWE,12,2,133,606,4.6,5,50.5,33,57.9,18,14,123,8.8,0,10.3,77.8,6.8,3,50,147,606,729,729,0,RB
660,D'Andre Swift,151,62,213,2021,22,DET,13,4,151,617,4.1,5,47.5,28,36.4,78,62,452,7.3,2,34.8,79.5,5.8,18,48.7,213,617,1069,1069,0,RB
661,J.J. Taylor,19,4,23,2021,23,NWE,5,0,19,37,1.9,2,7.4,3,21.1,4,4,8,2,0,1.6,100,2,0,50,23,37,45,70,25,RB
662,Jonathan Taylor,332,40,372,2021,22,IND,17,17,332,1811,5.5,18,106.5,107,55.4,51,40,360,9,2,21.2,78.4,7.1,12,43.1,372,1811,2171,2171,0,RB
663,Patrick Taylor,23,2,25,2021,23,GNB,9,0,23,89,3.9,1,9.9,5,60.9,2,2,3,1.5,0,0.3,100,1.5,1,50,25,89,92,92,0,RB
664,Ke'Shawn Vaughn,36,4,40,2021,24,TAM,12,1,36,180,5,2,15,9,50,8,4,26,6.5,0,2.2,50,3.3,1,50,40,180,206,221,15,RB
665,Austin Walter,26,2,28,2021,25,NYJ,4,0,26,101,3.9,1,25.3,5,42.3,3,2,9,4.5,0,2.3,66.7,3,1,33.3,28,101,110,110,0,RB
666,Jonathan Ward,9,3,12,2021,24,ARI,13,0,9,33,3.7,0,2.5,3,44.4,4,3,34,11.3,0,2.6,75,8.5,1,50,12,33,67,83,16,RB
667,Dwayne Washington,4,2,6,2021,27,NOR,14,0,4,16,4,0,1.1,0,50,2,2,12,6,0,0.9,100,6,0,50,6,16,28,84,56,RB
668,Derek Watt,1,3,4,2021,29,PIT,17,4,1,1,1,0,0.1,1,100,3,3,15,5,0,0.9,100,5,0,33.3,4,1,16,16,0,FB
669,James White,10,12,22,2021,29,NWE,3,0,10,38,3.8,1,12.7,4,60,14,12,94,7.8,0,31.3,85.7,6.7,5,42.9,22,38,132,132,0,RB
670,Jordan Wilkins,0,0,0,2021,27,"IND,TEN",5,0,0,0,,0,0,0,,0,0,0,,0,0,,,0,,0,0,0,17,17,RB
671,Damien Williams,40,16,56,2021,29,CHI,12,2,40,164,4.1,2,13.7,11,52.5,23,16,103,6.4,1,8.6,69.6,4.5,3,30.4,56,164,267,267,0,RB
672,Darrel Williams,144,47,191,2021,26,KAN,17,7,144,558,3.9,6,32.8,40,56.9,57,47,452,9.6,2,26.6,82.5,7.9,19,64.9,191,558,1010,1010,0,RB
673,Jamaal Williams,153,26,179,2021,26,DET,13,11,153,601,3.9,3,46.2,42,54.2,28,26,157,6,0,12.1,92.9,5.6,6,60.7,179,601,758,758,0,RB
674,Javonte Williams,203,43,246,2021,21,DEN,17,1,203,903,4.4,4,53.1,52,46.3,53,43,316,7.3,3,18.6,81.1,6,12,37.7,246,903,1219,1219,0,RB
675,Jonathan Williams,17,4,21,2021,27,WAS,5,0,17,79,4.6,1,15.8,7,64.7,6,4,28,7,0,5.6,66.7,4.7,2,33.3,21,79,107,107,0,RB
676,Pooka Williams,0,0,0,2021,22,CIN,1,0,0,0,,0,0,0,,0,0,0,,0,0,,,0,,0,0,0,52,52,RB
677,Trayveon Williams,15,1,16,2021,24,CIN,5,0,15,51,3.4,0,10.2,4,53.3,2,1,4,4,0,0.8,50,2,0,0,16,51,55,55,0,RB
678,Ty'Son Williams,35,9,44,2021,25,BAL,13,3,35,185,5.3,1,14.2,7,45.7,12,9,84,9.3,0,6.5,75,7,4,58.3,44,185,269,269,0,RB
679,Brandon Wilson,0,0,0,2021,27,CIN,9,1,0,0,,0,0,0,,0,0,0,,0,0,,,0,,0,0,0,291,291,RB
680,Jeff Wilson,79,7,86,2021,26,SFO,9,4,79,294,3.7,2,32.7,19,50.6,8,7,31,4.4,0,3.4,87.5,3.9,1,37.5,86,294,325,325,0,RB
681,Ameer Abdullah,8,8,16,2020,27,MIN,16,0,8,42,5.3,0,2.6,4,62.5,9,8,58,7.3,2,3.6,88.9,6.4,4,44.4,16,42,100,452,352,RB
682,Josh Adams,29,6,35,2020,24,NYJ,8,0,29,157,5.4,2,19.6,10,69,8,6,29,4.8,0,3.6,75,3.6,2,50,35,157,186,186,0,RB
683,Salvon Ahmed,75,11,86,2020,22,MIA,6,4,75,319,4.3,3,53.2,18,58.7,14,11,61,5.5,0,10.2,78.6,4.4,2,28.6,86,319,380,380,0,RB
684,Cam Akers,145,11,156,2020,21,LAR,13,5,145,625,4.3,2,48.1,26,49,14,11,123,11.2,1,9.5,78.6,8.8,4,42.9,156,625,748,748,0,RB
685,Alex Armah,6,5,11,2020,26,CAR,16,1,6,9,1.5,0,0.6,5,83.3,9,5,18,3.6,0,1.1,55.6,2,1,22.2,11,9,27,27,0,FB
686,Kalen Ballage,91,29,120,2020,25,"NYJ,LAC",11,2,91,303,3.3,3,27.5,25,53.8,37,29,166,5.7,0,15.1,78.4,4.5,5,37.8,120,303,469,469,0,RB
687,Peyton Barber,94,4,98,2020,26,WAS,16,2,94,258,2.7,4,16.1,26,41.5,7,4,12,3,0,0.8,57.1,1.7,1,28.6,98,258,270,270,0,RB
688,Jake Bargas,0,0,0,2020,24,MIN,1,0,0,0,,0,0,0,,0,0,0,,0,0,,,0,,0,0,0,0,0,FB
689,Saquon Barkley,19,6,25,2020,23,NYG,2,2,19,34,1.8,0,17,1,26.3,9,6,60,10,0,30,66.7,6.7,3,44.4,25,34,94,94,0,RB
690,Kenjon Barner,0,0,0,2020,31,TAM,6,0,0,0,,0,0,0,,1,0,0,,0,0,0,0,0,0,0,0,0,242,242,RB
691,Le'Veon Bell,82,16,98,2020,28,"KAN,NYJ",11,4,82,328,4,2,29.8,21,52.4,20,16,138,8.6,0,12.5,80,6.9,7,65,98,328,466,466,0,RB
692,LeVante Bellamy,4,1,5,2020,24,DEN,5,0,4,11,2.8,0,2.2,0,25,1,1,5,5,0,1,100,5,0,100,5,11,16,16,0,RB
693,Giovani Bernard,124,47,171,2020,29,CIN,16,10,124,416,3.4,3,26,23,46,59,47,355,7.6,3,22.2,79.7,6,15,42.4,171,416,771,809,38,RB
694,Khari Blasingame,0,4,4,2020,24,TEN,15,7,0,0,,0,0,0,,5,4,39,9.8,0,2.6,80,7.8,2,60,4,0,39,50,11,FB
695,Reggie Bonnafon,12,2,14,2020,24,CAR,2,0,12,69,5.8,0,34.5,4,33.3,2,2,18,9,1,9,100,9,2,100,14,69,87,87,0,RB
696,Devontae Booker,93,17,110,2020,28,LVR,16,1,93,423,4.5,3,26.4,21,45.2,21,17,84,4.9,0,5.3,81,4,2,33.3,110,423,507,511,4,RB
697,Mike Boone,11,2,13,2020,25,MIN,16,0,11,59,5.4,1,3.7,2,63.6,2,2,10,5,0,0.6,100,5,0,100,13,59,69,86,17,RB
698,Darius Bradwell,0,0,0,2020,23,LAC,2,0,0,0,,0,0,0,,0,0,0,,0,0,,,0,,0,0,0,0,0,FB
699,Matt Breida,59,9,68,2020,25,MIA,12,1,59,254,4.3,0,21.2,11,55.9,10,9,96,10.7,0,8,90,9.6,5,60,68,254,350,350,0,RB
700,Tony Brooks-James,3,0,3,2020,26,ATL,1,0,3,4,1.3,0,4,0,0,0,0,0,,0,0,,,0,,3,4,4,4,0,RB
701,Malcolm Brown,101,23,124,2020,27,LAR,16,0,101,419,4.1,5,26.2,28,47.5,33,23,162,7,0,10.1,69.7,4.9,9,45.5,124,419,581,581,0,RB
702,Rex Burkhead,67,25,92,2020,30,NWE,10,0,67,274,4.1,3,27.4,18,55.2,33,25,192,7.7,3,19.2,75.8,5.8,11,39.4,92,274,466,466,0,RB
703,Michael Burton,7,4,11,2020,28,NOR,15,4,7,18,2.6,0,1.2,6,85.7,4,4,28,7,0,1.9,100,7,1,75,11,18,46,56,10,RB
704,Raymond Calais,0,0,0,2020,22,LAR,4,0,0,0,,0,0,0,,0,0,0,,0,0,,,0,,0,0,0,152,152,RB
705,Trenton Cannon,10,3,13,2020,26,CAR,14,0,10,33,3.3,0,2.4,2,40,3,3,16,5.3,0,1.1,100,5.3,1,33.3,13,33,49,347,298,RB
706,Chris Carson,141,37,178,2020,26,SEA,12,12,141,681,4.8,5,56.8,43,61.7,46,37,287,7.8,4,23.9,80.4,6.2,14,58.7,178,681,968,968,0,RB
707,Nick Chubb,190,16,206,2020,25,CLE,12,12,190,1067,5.6,12,88.9,56,51.6,18,16,150,9.4,0,12.5,88.9,8.3,6,61.1,206,1067,1217,1217,0,RB
708,Corey Clement,21,5,26,2020,26,PHI,15,0,21,75,3.6,1,5,3,42.9,6,5,25,5,0,1.7,83.3,4.2,2,66.7,26,75,100,122,22,RB
709,Tarik Cohen,14,6,20,2020,25,CHI,3,0,14,74,5.3,0,24.7,3,50,9,6,41,6.8,0,13.7,66.7,4.6,1,33.3,20,74,115,115,0,RB
710,Tevin Coleman,28,4,32,2020,27,SFO,8,1,28,53,1.9,0,6.6,3,32.1,5,4,34,8.5,0,4.3,80,6.8,2,60,32,53,87,87,0,RB
711,Alex Collins,18,1,19,2020,26,SEA,3,1,18,77,4.3,2,25.7,5,61.1,2,1,4,4,0,1.3,50,2,0,50,19,77,81,81,0,RB
712,James Conner,169,35,204,2020,25,PIT,13,11,169,721,4.3,6,55.5,42,46.7,43,35,215,6.1,0,16.5,81.4,5,10,41.9,204,721,936,936,0,RB
713,Dalvin Cook,312,44,356,2020,25,MIN,14,14,312,1557,5,16,111.2,91,54.5,54,44,361,8.2,1,25.8,81.5,6.7,17,44.4,356,1557,1918,1918,0,RB
714,Nathan Cottrell,0,0,0,2020,24,JAX,8,0,0,0,,0,0,0,,0,0,0,,0,0,,,0,,0,0,0,123,123,RB
715,Chandler Cox,0,2,2,2020,24,MIA,8,3,0,0,,0,0,0,,2,2,9,4.5,0,1.1,100,4.5,1,100,2,0,9,9,0,RB
716,Jeremy Cox,0,0,0,2020,24,DEN,7,1,0,0,,0,0,0,,0,0,0,,0,0,,,0,,0,0,0,0,0,RB
717,DeeJay Dallas,34,17,51,2020,22,SEA,12,2,34,108,3.2,2,9,9,52.9,20,17,111,6.5,1,9.3,85,5.6,5,55,51,108,219,219,0,RB
718,Mike Davis,165,59,224,2020,27,CAR,15,12,165,642,3.9,6,42.8,38,47.3,70,59,373,6.3,2,24.9,84.3,5.3,17,47.1,224,642,1015,1015,0,RB
719,AJ Dillon,46,2,48,2020,22,GNB,11,0,46,242,5.3,2,22,11,52.2,2,2,21,10.5,0,1.9,100,10.5,1,100,48,242,263,263,0,RB
720,J.K. Dobbins,134,18,152,2020,22,BAL,15,1,134,805,6,9,53.7,38,56.7,24,18,120,6.7,0,8,75,5,4,37.5,152,805,925,925,0,RB
721,Rico Dowdle,7,0,7,2020,22,DAL,15,0,7,24,3.4,0,1.6,1,42.9,0,0,0,,0,0,,,0,,7,24,24,176,152,RB
722,Kenyan Drake,239,25,264,2020,26,ARI,15,13,239,955,4,10,63.7,59,48.5,31,25,137,5.5,0,9.1,80.6,4.4,5,48.4,264,955,1092,1092,0,RB
723,Chase Edmonds,97,53,150,2020,24,ARI,16,2,97,448,4.6,1,28,22,48.5,67,53,402,7.6,4,25.1,79.1,6,21,50.7,150,448,850,1267,417,RB
724,Trey Edmunds,0,0,0,2020,26,PIT,4,0,0,0,,0,0,0,,0,0,0,,0,0,,,0,,0,0,0,0,0,RB
725,Clyde Edwards-Helaire,181,36,217,2020,21,KAN,13,13,181,803,4.4,4,61.8,39,52.5,54,36,297,8.3,1,22.8,66.7,5.5,12,44.4,217,803,1100,1100,0,RB
726,Gus Edwards,144,9,153,2020,25,BAL,16,6,144,723,5,6,45.2,45,61.8,13,9,129,14.3,0,8.1,69.2,9.9,4,53.8,153,723,852,852,0,RB
727,Austin Ekeler,116,54,170,2020,25,LAC,10,10,116,530,4.6,1,53,26,43.1,65,54,403,7.5,2,40.3,83.1,6.2,20,53.8,170,530,933,933,0,RB
728,Ezekiel Elliott,244,52,296,2020,25,DAL,15,15,244,979,4,6,65.3,62,49.6,71,52,338,6.5,2,22.5,73.2,4.8,20,52.1,296,979,1317,1317,0,RB
729,Tyler Ervin,13,11,24,2020,27,GNB,8,0,13,67,5.2,0,8.4,4,61.5,15,11,84,7.6,0,10.5,73.3,5.6,6,53.3,24,67,151,367,216,RB
730,Darrynton Evans,14,2,16,2020,22,TEN,5,0,14,54,3.9,0,10.8,2,57.1,4,2,27,13.5,1,5.4,50,6.8,2,50,16,54,81,287,206,RB
731,Anthony Firkser,0,39,39,2020,25,TEN,16,1,0,0,,0,0,0,,53,39,387,9.9,1,24.2,73.6,7.3,26,58.5,39,0,387,387,0,FB
732,D'Onta Foreman,22,1,23,2020,24,TEN,6,0,22,95,4.3,0,15.8,6,40.9,1,1,5,5,1,0.8,100,5,1,100,23,95,100,100,0,RB
733,Leonard Fournette,97,36,133,2020,25,TAM,13,3,97,367,3.8,6,28.2,21,48.5,47,36,233,6.5,0,17.9,76.6,5,9,48.9,133,367,600,600,0,RB
734,Devonta Freeman,54,7,61,2020,28,NYG,5,4,54,172,3.2,1,34.4,9,42.6,10,7,58,8.3,0,11.6,70,5.8,3,50,61,172,230,230,0,RB
735,Royce Freeman,35,12,47,2020,24,DEN,16,0,35,170,4.9,0,10.6,10,42.9,13,12,81,6.8,0,5.1,92.3,6.2,4,46.2,47,170,251,251,0,RB
736,Wayne Gallman,147,21,168,2020,26,NYG,15,10,147,682,4.6,6,45.5,36,51.7,27,21,114,5.4,0,7.6,77.8,4.2,6,37,168,682,796,796,0,RB
737,Myles Gaskin,142,41,183,2020,23,MIA,10,7,142,584,4.1,3,58.4,27,50.7,47,41,388,9.5,2,38.8,87.2,8.3,12,59.6,183,584,972,972,0,RB
738,Antonio Gibson,170,36,206,2020,22,WAS,14,10,170,795,4.7,11,56.8,40,51.8,44,36,247,6.9,0,17.6,81.8,5.6,8,43.2,206,795,1042,1042,0,RB
739,Cullen Gillaspia,0,1,1,2020,25,HOU,7,0,0,0,,0,0,0,,1,1,6,6,0,0.9,100,6,0,0,1,0,6,6,0,RB
740,Reggie Gilliam,0,2,2,2020,23,BUF,14,0,0,0,,0,0,0,,2,2,16,8,1,1.1,100,8,2,100,2,0,16,16,0,FB
741,Melvin Gordon,215,32,247,2020,27,DEN,15,10,215,986,4.6,9,65.7,46,44.2,44,32,158,4.9,1,10.5,72.7,3.6,7,29.5,247,986,1144,1129,0,RB
742,Frank Gore,187,16,203,2020,37,NYJ,15,14,187,653,3.5,2,43.5,32,44.9,19,16,89,5.6,0,5.9,84.2,4.7,3,68.4,203,653,742,742,0,RB
743,Todd Gurley,195,25,220,2020,26,ATL,15,15,195,678,3.5,9,45.2,45,44.6,35,25,164,6.6,0,10.9,71.4,4.7,7,42.9,220,678,842,842,0,RB
744,C.J. Ham,5,8,13,2020,27,MIN,15,11,5,18,3.6,0,1.2,2,60,13,8,97,12.1,1,6.5,61.5,7.5,6,61.5,13,18,115,146,31,FB
745,Damien Harris,137,5,142,2020,23,NWE,10,10,137,691,5,2,69.1,30,52.6,7,5,52,10.4,0,5.2,71.4,7.4,4,57.1,142,691,743,743,0,RB
746,Jamycal Hasty,39,7,46,2020,24,SFO,8,0,39,148,3.8,1,18.5,7,46.2,8,7,33,4.7,0,4.1,87.5,4.1,0,25,46,148,181,238,57,RB
747,Darrell Henderson,138,16,154,2020,23,LAR,15,11,138,624,4.5,5,41.6,40,53.6,24,16,159,9.9,1,10.6,66.7,6.6,8,41.7,154,624,783,783,0,RB
748,Derrick Henry,378,19,397,2020,26,TEN,16,16,378,2027,5.4,17,126.7,98,56.6,31,19,114,6,0,7.1,61.3,3.7,4,32.3,397,2027,2141,2141,0,RB
749,Brian Hill,100,25,125,2020,25,ATL,16,1,100,465,4.7,1,29.1,18,48,30,25,199,8,0,12.4,83.3,6.6,7,56.7,125,465,664,664,0,RB
750,Dontrell Hilliard,9,1,10,2020,25,"CLE,HOU",7,0,9,48,5.3,0,6.9,3,66.7,1,1,2,2,0,0.3,100,2,0,0,10,48,50,175,125,RB
751,Justice Hill,12,5,17,2020,23,BAL,12,0,12,60,5,0,5,2,33.3,5,5,20,4,0,1.7,100,4,0,20,17,60,80,80,0,RB
752,Nyheim Hines,89,63,152,2020,24,IND,16,2,89,380,4.3,3,23.8,24,42.7,76,63,482,7.7,4,30.1,82.9,6.3,24,53.9,152,380,862,1232,370,RB
753,Elijah Holyfield,0,0,0,2020,23,PHI,1,0,0,0,,0,0,0,,0,0,0,,0,0,,,0,,0,0,0,0,,RB
754,Travis Homer,25,9,34,2020,22,SEA,9,0,25,88,3.5,0,9.8,2,40,10,9,90,10,1,10,90,9,4,40,34,88,178,469,291,RB
755,Jordan Howard,35,1,36,2020,26,"MIA,PHI",7,4,35,60,1.7,4,8.6,7,28.6,1,1,-3,-3,0,-0.4,100,-3,0,0,36,60,57,57,0,RB
756,Buddy Howell,16,1,17,2020,24,HOU,14,0,16,64,4,0,4.6,2,56.3,2,1,3,3,0,0.2,50,1.5,0,0,17,64,67,67,0,RB
757,Jason Huntley,5,1,6,2020,22,PHI,5,0,5,19,3.8,0,3.8,1,20,2,1,0,0,0,0,50,0,0,0,6,19,19,55,36,RB
758,Kareem Hunt,198,38,236,2020,25,CLE,16,5,198,841,4.2,6,52.6,44,48,51,38,304,8,5,19,74.5,6,19,54.9,236,841,1145,1143,0,RB
759,Carlos Hyde,81,16,97,2020,30,SEA,10,1,81,356,4.4,4,35.6,20,43.2,20,16,93,5.8,0,9.3,80,4.7,4,40,97,356,449,449,0,RB
760,Alec Ingold,3,12,15,2020,24,LVR,16,4,3,4,1.3,0,0.3,2,66.7,17,12,110,9.2,1,6.9,70.6,6.5,9,58.8,15,4,114,114,0,FB
761,Mark Ingram,72,6,78,2020,31,BAL,11,9,72,299,4.2,2,27.2,14,47.2,8,6,50,8.3,0,4.5,75,6.3,2,37.5,78,299,349,349,0,RB
762,Justin Jackson,59,19,78,2020,24,LAC,9,4,59,270,4.6,0,30,15,44.1,24,19,173,9.1,0,19.2,79.2,7.2,7,50,78,270,443,443,0,RB
763,Josh Jacobs,273,33,306,2020,22,LVR,15,15,273,1065,3.9,12,71,61,50.2,45,33,238,7.2,0,15.9,73.3,5.3,9,46.7,306,1065,1303,1303,0,RB
764,Andy Janovich,2,2,4,2020,27,CLE,14,3,2,4,2,0,0.3,1,50,5,2,13,6.5,0,0.9,40,2.6,1,20,4,4,17,30,13,RB
765,David Johnson,147,33,180,2020,29,HOU,12,12,147,691,4.7,6,57.6,38,44.9,46,33,314,9.5,2,26.2,71.7,6.8,16,54.3,180,691,1005,1005,0,RB
766,D'Ernest Johnson,33,3,36,2020,24,CLE,16,0,33,166,5,0,10.4,7,42.4,4,3,14,4.7,0,0.9,75,3.5,0,0,36,166,180,544,364,RB
767,Duke Johnson,77,28,105,2020,27,HOU,11,5,77,235,3.1,1,21.4,11,39,35,28,249,8.9,1,22.6,80,7.1,8,54.3,105,235,484,484,0,RB
768,Jakob Johnson,0,8,8,2020,26,NWE,16,11,0,0,,0,0,0,,9,8,35,4.4,1,2.2,88.9,3.9,3,55.6,8,0,35,35,0,FB
769,Kerryon Johnson,52,19,71,2020,23,DET,16,2,52,181,3.5,2,11.3,9,55.8,26,19,187,9.8,1,11.7,73.1,7.2,11,46.2,71,181,368,368,0,RB
770,Ty Johnson,54,16,70,2020,23,"DET,NYJ",13,1,54,254,4.7,1,19.5,11,53.7,21,16,99,6.2,1,7.6,76.2,4.7,6,38.1,70,254,353,447,94,RB
771,Aaron Jones,201,47,248,2020,26,GNB,14,14,201,1104,5.5,9,78.9,52,55.7,63,47,355,7.6,2,25.4,74.6,5.6,15,49.2,248,1104,1459,1459,0,RB
772,Ronald Jones II,192,28,220,2020,23,TAM,14,13,192,978,5.1,7,69.9,48,54.2,42,28,165,5.9,1,11.8,66.7,3.9,2,31,220,978,1143,1143,0,RB
773,Taiwan Jones,0,0,0,2020,32,BUF,13,0,0,0,,0,0,0,,2,0,0,,0,0,0,0,0,0,0,0,0,0,0,RB
774,Tony Jones,3,0,3,2020,23,NOR,1,1,3,13,4.3,0,13,1,66.7,0,0,0,,0,0,,,0,,3,13,13,13,0,RB
775,Xavier Jones,0,0,0,2020,23,LAR,13,0,0,0,,0,0,0,,0,0,0,,0,0,,,0,,0,0,0,4,4,RB
776,Kyle Juszczyk,17,19,36,2020,29,SFO,16,15,17,64,3.8,2,4,12,82.4,29,19,202,10.6,4,12.6,65.5,7,10,58.6,36,64,266,266,0,FB
777,Alvin Kamara,187,83,270,2020,25,NOR,15,10,187,932,5,16,62.1,58,53.5,107,83,756,9.1,5,50.4,77.6,7.1,35,44.9,270,932,1688,1732,44,RB
778,Joshua Kelley,111,23,134,2020,23,LAC,14,0,111,354,3.2,2,25.3,20,43.2,23,23,148,6.4,0,10.6,100,6.4,9,56.5,134,354,502,541,39,RB
779,Adrian Killins,1,1,2,2020,22,PHI,1,0,1,-12,-12,0,-12,0,0,1,1,2,2,0,2,100,2,0,0,2,-12,-10,-10,0,RB
780,Patrick Laird,13,10,23,2020,25,MIA,16,0,13,72,5.5,0,4.5,4,46.2,12,10,68,6.8,0,4.3,83.3,5.7,3,50,23,72,140,140,0,RB
781,Javon Leake,0,0,0,2020,22,WAS,1,0,0,0,,0,0,0,,0,0,0,,0,0,,,0,,0,0,0,0,0,RB
782,Dion Lewis,29,19,48,2020,30,NYG,16,0,29,115,4,2,7.2,8,37.9,30,19,127,6.7,1,7.9,63.3,4.2,8,36.7,48,115,242,780,538,RB
783,Phillip Lindsay,118,7,125,2020,26,DEN,11,8,118,502,4.3,1,45.6,19,39,14,7,28,4,0,2.5,50,2,1,28.6,125,502,530,530,0,RB
784,Marlon Mack,4,3,7,2020,24,IND,1,1,4,26,6.5,0,26,2,75,3,3,30,10,0,30,100,10,1,66.7,7,26,56,56,0,RB
785,Alexander Mattison,96,13,109,2020,22,MIN,13,2,96,434,4.5,2,33.4,24,44.8,15,13,125,9.6,1,9.6,86.7,8.3,5,66.7,109,434,559,559,0,RB
786,Christian McCaffrey,59,17,76,2020,24,CAR,3,3,59,225,3.8,5,75,14,57.6,19,17,149,8.8,1,49.7,89.5,7.8,8,52.6,76,225,374,374,0,RB
787,LeSean McCoy,10,15,25,2020,32,TAM,10,0,10,31,3.1,0,3.1,2,40,19,15,101,6.7,0,10.1,78.9,5.3,3,15.8,25,31,132,132,0,RB
788,Anthony McFarland Jr.,33,6,39,2020,22,PIT,11,0,33,113,3.4,0,10.3,4,36.4,9,6,54,9,0,4.9,66.7,6,1,55.6,39,113,167,167,0,RB
789,J.D. McKissic,85,80,165,2020,27,WAS,16,7,85,365,4.3,1,22.8,25,51.8,110,80,589,7.4,2,36.8,72.7,5.4,32,50,165,365,954,954,0,RB
790,Jerick McKinnon,81,33,114,2020,28,SFO,16,4,81,319,3.9,5,19.9,16,40.7,46,33,253,7.7,1,15.8,71.7,5.5,12,45.7,114,319,572,811,239,RB
791,Jeremy McNichols,47,12,59,2020,25,TEN,16,0,47,204,4.3,1,12.8,8,38.3,17,12,55,4.6,0,3.4,70.6,3.2,0,29.4,59,204,259,259,0,RB
792,Sony Michel,79,7,86,2020,25,NWE,9,6,79,449,5.7,1,49.9,19,50.6,9,7,114,16.3,1,12.7,77.8,12.7,5,77.8,86,449,563,563,0,RB
793,Bruce Miller,0,1,1,2020,33,JAX,8,5,0,0,,0,0,0,,2,1,2,2,0,0.3,50,1,1,50,1,0,2,9,7,FB
794,Lamar Miller,0,2,2,2020,29,CHI,1,0,0,0,,0,0,0,,2,2,6,3,0,6,100,3,1,50,2,0,6,6,0,RB
795,Joe Mixon,119,21,140,2020,24,CIN,6,6,119,428,3.6,3,71.3,20,46.2,26,21,138,6.6,1,23,80.8,5.3,5,46.2,140,428,566,566,0,RB
796,David Montgomery,247,54,301,2020,23,CHI,15,14,247,1070,4.3,8,71.3,59,46.2,68,54,438,8.1,2,29.2,79.4,6.4,25,55.9,301,1070,1508,1508,0,RB
797,Alfred Morris,55,3,58,2020,32,NYG,9,0,55,238,4.3,1,26.4,13,52.7,4,3,19,6.3,1,2.1,75,4.8,2,75,58,238,257,257,0,RB
798,Zack Moss,112,14,126,2020,23,BUF,13,0,112,481,4.3,4,37,30,50.9,18,14,95,6.8,1,7.3,77.8,5.3,5,55.6,126,481,576,576,0,RB
799,Raheem Mostert,104,16,120,2020,28,SFO,8,8,104,521,5,2,65.1,22,49,19,16,156,9.8,1,19.5,84.2,8.2,5,52.6,120,521,677,677,0,RB
800,Latavius Murray,146,23,169,2020,30,NOR,15,7,146,656,4.5,4,43.7,36,59.6,26,23,176,7.7,1,11.7,88.5,6.8,8,50,169,656,832,832,0,RB
801,Gabe Nabers,2,5,7,2020,23,LAC,16,5,2,7,3.5,0,0.4,1,100,7,5,25,5,2,1.6,71.4,3.6,2,57.1,7,7,32,32,0,FB
802,Ryan Nall,3,8,11,2020,25,CHI,16,0,3,0,0,0,0,0,0,9,8,67,8.4,1,4.2,88.9,7.4,5,55.6,11,0,67,102,35,RB
803,Dare Ogunbowale,32,10,42,2020,26,JAX,14,2,32,145,4.5,0,10.4,6,37.5,20,10,54,5.4,0,3.9,50,2.7,4,20,42,145,199,205,6,RB
804,Qadree Ollison,1,0,1,2020,24,ATL,3,0,1,3,3,0,1,1,100,0,0,0,,0,0,,,0,,1,3,3,3,0,RB
805,Sewo Olonilua,0,0,0,2020,23,DAL,2,0,0,0,,0,0,0,,0,0,0,,0,0,,,0,,0,0,0,0,0,RB
806,Devine Ozigbo,1,9,10,2020,24,JAX,8,0,1,1,1,0,0.1,0,0,9,9,42,4.7,0,5.3,100,4.7,3,44.4,10,1,43,43,0,RB
807,Elijhaa Penny,6,2,8,2020,27,NYG,14,0,6,15,2.5,0,1.1,4,66.7,3,2,20,10,0,1.4,66.7,6.7,1,66.7,8,15,35,35,0,RB
808,Rashaad Penny,11,0,11,2020,24,SEA,3,0,11,34,3.1,0,11.3,1,54.5,0,0,0,,0,0,,,0,,11,34,34,34,0,RB
809,La'Mical Perine,64,11,75,2020,22,NYJ,10,0,64,232,3.6,2,23.2,18,43.8,15,11,63,5.7,0,6.3,73.3,4.2,3,46.7,75,232,295,317,22,RB
810,Samaje Perine,63,11,74,2020,25,CIN,16,1,63,301,4.8,3,18.8,16,41.3,12,11,66,6,0,4.1,91.7,5.5,4,50,74,301,367,380,13,RB
811,Senorise Perry,2,0,2,2020,29,TEN,7,0,2,9,4.5,0,1.3,1,100,0,0,0,,0,0,,,0,,2,9,9,9,0,RB
812,Adrian Peterson,156,12,168,2020,35,DET,16,10,156,604,3.9,7,37.8,34,44.2,18,12,101,8.4,0,6.3,66.7,5.6,4,55.6,168,604,705,705,0,RB
813,Scottie Phillips,2,1,3,2020,23,HOU,8,0,2,9,4.5,0,1.1,0,50,1,1,7,7,0,0.9,100,7,0,100,3,9,16,112,96,RB
814,Artavis Pierce,6,0,6,2020,24,CHI,5,0,6,34,5.7,1,6.8,2,66.7,0,0,0,,0,0,,,0,,6,34,34,34,0,RB
815,Tony Pollard,101,28,129,2020,23,DAL,16,2,101,435,4.3,4,27.2,23,45.5,40,28,193,6.9,1,12.1,70,4.8,9,42.5,129,435,628,1394,766,RB
816,Troymaine Pope,15,8,23,2020,27,LAC,6,0,15,76,5.1,0,12.7,3,46.7,10,8,42,5.3,0,7,80,4.2,1,30,23,76,118,132,14,RB
817,C.J. Prosise,10,5,15,2020,26,HOU,10,0,10,19,1.9,0,1.9,0,20,5,5,18,3.6,1,1.8,100,3.6,1,40,15,19,37,186,149,RB
818,Craig Reynolds,1,1,2,2020,24,JAX,2,0,1,4,4,0,2,0,100,1,1,3,3,0,1.5,100,3,0,0,2,4,7,7,0,RB
819,Patrick Ricard,1,9,10,2020,26,BAL,15,10,1,-1,-1,0,-0.1,0,0,12,9,45,5,1,3,75,3.8,3,50,10,-1,44,44,0,FB
820,Jalen Richard,22,19,41,2020,27,LVR,13,0,22,123,5.6,1,9.5,7,54.5,23,19,138,7.3,0,10.6,82.6,6,5,43.5,41,123,261,501,240,RB
821,Theo Riddick,6,5,11,2020,29,LVR,4,0,6,14,2.3,0,3.5,1,16.7,6,5,43,8.6,0,10.8,83.3,7.2,1,50,11,14,57,57,0,RB
822,James Robinson,240,49,289,2020,22,JAX,14,14,240,1070,4.5,7,76.4,54,49.6,60,49,344,7,3,24.6,81.7,5.7,15,48.3,289,1066,1414,1414,0,RB
823,Jaylen Samuels,9,9,18,2020,24,PIT,14,1,9,28,3.1,0,2,1,33.3,14,9,46,5.1,0,3.3,64.3,3.3,2,42.9,18,28,74,74,0,RB
824,Miles Sanders,164,28,192,2020,23,PHI,12,11,164,867,5.3,6,72.3,39,54.9,52,28,197,7,0,16.4,53.8,3.8,8,34.6,192,867,1064,1071,0,RB
825,Bo Scarbrough,6,0,6,2020,26,SEA,1,0,6,31,5.2,0,31,1,66.7,0,0,0,,0,0,,,0,,6,31,31,31,0,RB
826,Boston Scott,80,25,105,2020,25,PHI,16,4,80,374,4.7,1,23.4,16,48.8,36,25,212,8.5,1,13.3,69.4,5.9,8,41.7,105,374,586,1176,590,RB
827,Anthony Sherman,3,1,4,2020,32,KAN,13,1,3,8,2.7,0,0.6,2,66.7,2,1,5,5,1,0.4,50,2.5,1,50,4,8,13,13,0,RB
828,Devin Singletary,156,38,194,2020,23,BUF,16,16,156,687,4.4,2,42.9,40,47.4,50,38,269,7.1,0,16.8,76,5.4,8,56,194,687,956,956,0,RB
829,Wendell Smallwood,0,0,0,2020,26,PIT,1,0,0,0,,0,0,0,,0,0,0,,0,0,,,0,,0,0,0,0,0,RB
830,Ito Smith,63,17,80,2020,25,ATL,14,0,63,268,4.3,1,19.1,8,55.6,26,17,75,4.4,0,5.4,65.4,2.9,3,30.8,80,268,343,343,0,RB
831,Keith Smith,4,11,15,2020,28,ATL,16,7,4,7,1.8,0,0.4,4,100,15,11,59,5.4,0,3.7,73.3,3.9,4,33.3,15,7,66,66,0,FB
832,Rodney Smith,41,9,50,2020,24,CAR,7,1,41,156,3.8,1,22.3,14,61,11,9,59,6.6,0,8.4,81.8,5.4,1,27.3,50,156,215,215,0,RB
833,Benny Snell Jr.,111,10,121,2020,22,PIT,16,3,111,368,3.3,4,23,25,41.4,14,10,61,6.1,0,3.8,71.4,4.4,3,50,121,368,429,429,0,RB
834,Johnny Stanton,0,0,0,2020,26,CLE,1,0,0,0,,0,0,0,,0,0,0,,0,0,,,0,,0,0,0,0,0,RB
835,D'Andre Swift,114,46,160,2020,21,DET,13,4,114,521,4.6,8,40.1,31,54.4,57,46,357,7.8,2,27.5,80.7,6.3,15,47.4,160,521,878,878,0,RB
836,J.J. Taylor,23,1,24,2020,22,NWE,6,0,23,110,4.8,0,18.3,5,52.2,2,1,4,4,0,0.7,50,2,0,50,24,110,114,212,98,RB
837,Jonathan Taylor,232,36,268,2020,21,IND,15,13,232,1169,5,11,77.9,69,52.2,39,36,299,8.3,1,19.9,92.3,7.7,12,51.3,268,1169,1468,1468,0,RB
838,Chris Thompson,7,20,27,2020,30,JAX,8,0,7,20,2.9,0,2.5,1,42.9,23,20,146,7.3,1,18.3,87,6.3,5,47.8,27,20,166,166,0,RB
839,Darwin Thompson,27,7,34,2020,23,KAN,14,1,27,97,3.6,1,6.9,7,44.4,11,7,65,9.3,1,4.6,63.6,5.9,3,27.3,34,97,162,162,0,RB
840,Ke'Shawn Vaughn,26,5,31,2020,23,TAM,10,0,26,109,4.2,0,10.9,5,42.3,10,5,34,6.8,1,3.4,50,3.4,2,30,31,109,143,143,0,RB
841,Austin Walter,1,1,2,2020,24,SFO,4,0,1,3,3,0,0.8,0,0,1,1,27,27,0,6.8,100,27,1,100,2,3,30,123,93,RB
842,Jonathan Ward,0,1,1,2020,23,ARI,14,0,0,0,,0,0,0,,1,1,11,11,1,0.8,100,11,1,100,1,0,11,11,0,RB
843,Michael Warren,0,0,0,2020,22,WAS,1,0,0,0,,0,0,0,,0,0,0,,0,0,,,0,,0,0,0,0,0,RB
844,DeAndre Washington,31,5,36,2020,27,"KAN,MIA",4,1,31,91,2.9,0,22.8,2,35.5,10,5,30,6,0,7.5,50,3,2,40,36,91,121,121,0,RB
845,Dwayne Washington,8,0,8,2020,26,NOR,11,0,8,15,1.9,0,1.4,0,12.5,0,0,0,,0,0,,,0,,8,15,15,46,31,RB
846,Derek Watt,0,0,0,2020,28,PIT,12,0,0,0,,0,0,0,,0,0,0,,0,0,,,0,,0,0,0,0,0,FB
847,James White,35,49,84,2020,28,NWE,14,0,35,121,3.5,2,8.6,6,37.1,62,49,375,7.7,1,26.8,79,6,20,41.9,84,121,496,496,0,RB
848,Jordan Wilkins,84,12,96,2020,26,IND,15,0,84,308,3.7,1,20.5,17,42.9,16,12,105,8.8,0,7,75,6.6,3,37.5,96,308,413,416,3,RB
849,Antonio Williams,12,1,13,2020,23,BUF,1,0,12,63,5.3,2,63,4,58.3,1,1,20,20,0,20,100,20,1,100,13,63,83,83,0,RB
850,Darrel Williams,39,18,57,2020,25,KAN,16,0,39,169,4.3,1,10.6,14,56.4,26,18,116,6.4,0,7.3,69.2,4.5,6,42.3,57,169,285,285,0,RB
851,Dexter Williams,2,0,2,2020,23,GNB,3,0,2,8,4,0,2.7,0,0,0,0,0,,0,0,,,0,,2,8,8,8,0,RB
852,Jamaal Williams,119,31,150,2020,25,GNB,14,3,119,505,4.2,2,36.1,29,55.5,35,31,236,7.6,1,16.9,88.6,6.7,11,51.4,150,505,741,761,20,RB
853,Jonathan Williams,1,4,5,2020,26,DET,5,0,1,5,5,0,1,0,100,4,4,21,5.3,0,4.2,100,5.3,2,75,5,5,26,36,10,RB
854,Trayveon Williams,26,5,31,2020,23,CIN,10,0,26,157,6,0,15.7,5,53.8,5,5,30,6,0,3,100,6,1,60,31,157,187,187,0,RB
855,Brandon Wilson,0,0,0,2020,26,CIN,15,0,0,0,,0,0,0,,0,0,0,,0,0,,,0,,0,0,0,629,629,RB
856,Jeff Wilson,126,13,139,2020,25,SFO,12,3,126,600,4.8,7,50,31,52.4,28,13,133,10.2,3,11.1,46.4,4.8,8,28.6,139,600,733,733,0,RB
857,T.J. Yeldon,10,1,11,2020,27,BUF,3,0,10,70,7,0,23.3,5,60,4,1,22,22,1,7.3,25,5.5,1,25,11,70,92,92,0,RB
858,Ameer Abdullah,23,15,38,2019,26,MIN,16,0,23,115,5,0,7.2,4,26.1,21,15,88,5.9,1,5.5,71.4,4.2,5,47.6,38,115,203,528,325,RB
859,Josh Adams,8,0,8,2019,23,NYJ,3,0,8,12,1.5,0,4,1,12.5,0,0,0,,0,0,,,0,,8,12,12,12,0,RB
860,Jay Ajayi,10,0,10,2019,26,PHI,3,0,10,30,3,0,10,3,40,1,0,0,,0,0,0,0,0,0,10,30,30,30,0,RB
861,Javorius Allen,10,1,11,2019,28,NYG,10,0,10,36,3.6,1,3.6,3,60,2,1,9,9,0,0.9,50,4.5,0,50,11,36,45,45,0,RB
862,C.J. Anderson,16,0,16,2019,28,DET,2,0,16,43,2.7,0,21.5,1,31.3,0,0,0,,0,0,,,0,,16,43,43,43,0,RB
863,Alex Armah,6,2,8,2019,25,CAR,16,1,6,11,1.8,1,0.7,1,16.7,2,2,6,3,0,0.4,100,3,0,50,8,11,17,17,0,FB
864,Ryquell Armstead,35,14,49,2019,23,JAX,16,1,35,108,3.1,0,6.8,5,28.6,24,14,144,10.3,2,9,58.3,6,9,54.2,49,108,252,252,0,RB
865,Kalen Ballage,74,14,88,2019,24,MIA,12,6,74,135,1.8,3,11.3,10,31.1,24,14,63,4.5,0,5.3,58.3,2.6,4,20.8,88,135,198,198,0,RB
866,Peyton Barber,154,16,170,2019,25,TAM,16,7,154,470,3.1,6,29.4,23,38.3,24,16,115,7.2,1,7.2,66.7,4.8,4,41.7,170,470,585,585,0,RB
867,Saquon Barkley,217,52,269,2019,22,NYG,13,13,217,1003,4.6,6,77.2,45,43.3,73,52,438,8.4,2,33.7,71.2,6,14,34.2,269,1003,1441,1441,0,RB
868,Kenjon Barner,4,6,10,2019,30,ATL,14,0,4,28,7,0,2,1,75,8,6,22,3.7,0,1.6,75,2.8,1,12.5,10,31,50,723,673,RB
869,Nick Bawden,0,4,4,2019,23,DET,10,2,0,0,,0,0,0,,6,4,17,4.3,0,1.7,66.7,2.8,1,33.3,4,0,17,17,0,RB
870,Le'Veon Bell,245,66,311,2019,27,NYJ,15,15,245,789,3.2,3,52.6,36,40.4,78,66,461,7,1,30.7,84.6,5.9,20,46.2,311,789,1250,1250,0,RB
871,Giovani Bernard,53,30,83,2019,28,CIN,16,2,53,170,3.2,0,10.6,10,32.1,43,30,234,7.8,0,14.6,69.8,5.4,7,30.2,83,170,404,418,14,RB
872,Khari Blasingame,0,4,4,2019,23,TEN,6,3,0,0,,0,0,0,,5,4,54,13.5,0,9,80,10.8,2,60,4,0,54,54,0,RB
873,Brandon Bolden,15,9,24,2019,29,NWE,15,2,15,68,4.5,3,4.5,5,53.3,11,9,111,12.3,1,7.4,81.8,10.1,6,63.6,24,68,179,694,515,RB
874,Reggie Bonnafon,16,6,22,2019,23,CAR,16,0,16,116,7.3,1,7.3,2,43.8,9,6,57,9.5,0,3.6,66.7,6.3,1,33.3,22,116,173,284,111,RB
875,Devontae Booker,2,6,8,2019,27,DEN,16,0,2,9,4.5,0,0.6,0,0,9,6,57,9.5,0,3.6,66.7,6.3,1,33.3,8,9,66,178,112,RB
876,Mike Boone,49,3,52,2019,24,MIN,16,2,49,273,5.6,3,17.1,9,46.9,4,3,17,5.7,0,1.1,75,4.3,0,50,52,273,290,290,0,RB
877,Matt Breida,123,19,142,2019,24,SFO,13,5,123,623,5.1,1,47.9,23,43.9,22,19,120,6.3,1,9.2,86.4,5.5,6,45.5,142,623,743,743,0,RB
878,Tony Brooks-James,8,0,8,2019,25,PIT,3,0,8,7,0.9,0,2.3,0,12.5,0,0,0,,0,0,,,0,,8,7,7,39,32,RB
879,Malcolm Brown,69,2,71,2019,26,LAR,14,1,69,255,3.7,5,18.2,16,46.4,6,2,16,8,0,1.1,33.3,2.7,0,16.7,71,255,271,271,0,RB
880,Rex Burkhead,65,27,92,2019,29,NWE,13,1,65,302,4.6,3,23.2,18,50.8,38,27,279,10.3,0,21.5,71.1,7.3,10,52.6,92,302,581,581,0,RB
881,Michael Burton,0,0,0,2019,27,WAS,10,2,0,0,,0,0,0,,1,0,0,,0,0,0,0,0,0,0,0,0,0,0,RB
882,Trenton Cannon,0,0,0,2019,25,NYJ,4,0,0,0,,0,0,0,,0,0,0,,0,0,,,0,,0,0,0,97,96,RB
883,Chris Carson,278,37,315,2019,25,SEA,15,15,278,1230,4.4,7,82,75,53.6,47,37,266,7.2,2,17.7,78.7,5.7,10,55.3,315,1230,1496,1496,0,RB
884,Tra Carson,18,4,22,2019,27,"DET,GNB",3,1,18,48,2.7,0,16,3,27.8,4,4,18,4.5,0,6,100,4.5,0,25,22,48,66,66,0,RB
885,Nick Chubb,298,36,334,2019,24,CLE,16,16,298,1494,5,8,93.4,62,43.6,49,36,278,7.7,0,17.4,73.5,5.7,13,42.9,334,1494,1772,1772,0,RB
886,Jordan Chunn,0,0,0,2019,24,DAL,1,0,0,0,,0,0,0,,0,0,0,,0,0,,,0,,0,0,0,0,0,RB
887,Corey Clement,0,0,0,2019,25,PHI,4,0,0,0,,0,0,0,,0,0,0,,0,0,,,0,,0,0,0,73,73,RB
888,Tarik Cohen,64,79,143,2019,24,CHI,16,11,64,213,3.3,0,13.3,15,42.2,104,79,456,5.8,3,28.5,76,4.4,18,40.4,143,213,669,994,325,RB
889,Tevin Coleman,137,21,158,2019,26,SFO,14,11,137,544,4,6,38.9,26,37.2,30,21,180,8.6,1,12.9,70,6,9,43.3,158,544,724,724,0,RB
890,James Conner,116,34,150,2019,24,PIT,10,10,116,464,4,4,46.4,26,43.1,38,34,251,7.4,3,25.1,89.5,6.6,14,55.3,150,464,715,715,0,RB
891,Dalvin Cook,250,53,303,2019,24,MIN,14,14,250,1135,4.5,13,81.1,60,47.6,63,53,519,9.8,0,37.1,84.1,8.2,26,57.1,303,1135,1654,1654,0,RB
892,Chandler Cox,0,0,0,2019,23,MIA,13,3,0,0,,0,0,0,,0,0,0,,0,0,,,0,,0,0,0,0,0,RB
893,Mike Davis,13,7,20,2019,26,"CAR,CHI",12,1,13,27,2.1,0,2.3,0,15.4,8,7,22,3.1,0,1.8,87.5,2.8,1,25,20,27,49,49,0,RB
894,Dalyn Dawkins,11,0,11,2019,25,TEN,2,0,11,26,2.4,0,13,2,36.4,1,0,0,,0,0,0,0,0,0,11,26,26,26,0,RB
895,James Develin,2,0,2,2019,31,NWE,2,2,2,3,1.5,0,1.5,1,100,0,0,0,,0,0,,,0,,2,3,3,3,0,RB
896,Patrick DiMarco,3,5,8,2019,30,BUF,16,4,3,7,2.3,0,0.4,0,33.3,7,5,41,8.2,0,2.6,71.4,5.9,1,42.9,8,7,48,72,24,FB
897,Kenyan Drake,170,50,220,2019,25,"ARI,MIA",14,10,170,817,4.8,8,58.4,48,48.8,68,50,345,6.9,0,24.6,73.5,5.1,15,42.6,220,817,1162,1177,15,RB
898,Chase Edmonds,60,12,72,2019,23,ARI,13,2,60,303,5.1,4,23.3,12,38.3,21,12,105,8.8,1,8.1,57.1,5,5,42.9,72,303,408,408,0,RB
899,Trey Edmunds,22,6,28,2019,25,PIT,11,0,22,92,4.2,0,8.4,2,31.8,7,6,48,8,0,4.4,85.7,6.9,2,42.9,28,92,140,142,0,RB
900,Gus Edwards,133,7,140,2019,24,BAL,16,1,133,711,5.3,2,44.4,46,51.9,7,7,45,6.4,0,2.8,100,6.4,2,71.4,140,711,756,756,0,RB
901,Austin Ekeler,132,92,224,2019,24,LAC,16,8,132,557,4.2,3,34.8,32,44.7,108,92,993,10.8,8,62.1,85.2,9.2,42,56.5,224,557,1550,1550,0,RB
902,Ezekiel Elliott,301,54,355,2019,24,DAL,16,16,301,1357,4.5,12,84.8,78,54.8,71,54,420,7.8,2,26.3,76.1,5.9,21,45.1,355,1357,1777,1777,0,RB
903,Rhett Ellison,0,18,18,2019,31,NYG,10,7,0,0,,0,0,0,,28,18,167,9.3,1,16.7,64.3,6,4,28.6,18,0,167,167,0,FB
904,Tyler Ervin,1,2,3,2019,26,"GNB,JAX",10,0,1,10,10,0,1,1,100,4,2,11,5.5,0,1.1,50,2.8,1,50,3,10,21,403,382,RB
905,Josh Ferguson,3,0,3,2019,26,WAS,2,0,3,9,3,0,4.5,1,66.7,0,0,0,,0,0,,,0,,3,9,9,9,0,RB
906,Anthony Firkser,0,14,14,2019,24,TEN,15,1,0,0,,0,0,0,,24,14,204,14.6,1,13.6,58.3,8.5,9,41.7,14,0,204,204,0,FB
907,David Fluellen,0,0,0,2019,27,TEN,2,0,0,0,,0,0,0,,0,0,0,,0,0,,,0,,0,0,0,0,0,RB
908,Leonard Fournette,265,76,341,2019,24,JAX,15,15,265,1152,4.3,3,76.8,55,41.1,100,76,522,6.9,0,34.8,76,5.2,23,40,341,1152,1674,1674,0,RB
909,Devonta Freeman,184,59,243,2019,27,ATL,14,14,184,656,3.6,2,46.9,31,41.8,70,59,410,6.9,4,29.3,84.3,5.9,17,48.6,243,656,1066,1066,0,RB
910,Royce Freeman,132,43,175,2019,23,DEN,16,0,132,496,3.8,3,31,22,40.9,50,43,256,6,1,16,86,5.1,10,42,175,496,752,752,0,RB
911,Wayne Gallman,29,11,40,2019,25,NYG,10,2,29,110,3.8,2,11,6,41.4,15,11,102,9.3,1,10.2,73.3,6.8,4,46.7,40,110,212,212,0,RB
912,Myles Gaskin,36,7,43,2019,22,MIA,7,0,36,133,3.7,1,19,7,38.9,12,7,51,7.3,0,7.3,58.3,4.3,2,41.7,43,133,184,184,0,RB
913,Cullen Gillaspia,0,0,0,2019,24,HOU,16,0,0,0,,0,0,0,,0,0,0,,0,0,,,0,,0,0,0,0,0,RB
914,Melvin Gordon,162,42,204,2019,26,LAC,12,11,162,612,3.8,8,51,39,49.4,55,42,296,7,1,24.7,76.4,5.4,11,47.3,204,612,908,908,0,RB
915,Frank Gore,166,13,179,2019,36,BUF,16,8,166,599,3.6,2,37.4,30,41.6,16,13,100,7.7,0,6.3,81.3,6.3,5,50,179,599,699,699,0,RB
916,Derrius Guice,42,7,49,2019,22,WAS,5,1,42,245,5.8,2,49,9,50,9,7,79,11.3,1,15.8,77.8,8.8,2,55.6,49,245,324,324,0,RB
917,Todd Gurley,223,31,254,2019,25,LAR,15,15,223,857,3.8,12,57.1,51,46.6,49,31,207,6.7,2,13.8,63.3,4.2,8,36.7,254,857,1064,1064,0,RB
918,C.J. Ham,7,17,24,2019,26,MIN,16,7,7,17,2.4,0,1.1,2,42.9,26,17,149,8.8,1,9.3,65.4,5.7,6,46.2,24,17,166,199,33,FB
919,Damien Harris,4,0,4,2019,22,NWE,2,0,4,12,3,0,6,0,0,0,0,0,,0,0,,,0,,4,12,12,12,0,RB
920,Darrell Henderson,39,4,43,2019,22,LAR,13,0,39,147,3.8,0,11.3,10,41,6,4,37,9.3,0,2.8,66.7,6.2,1,66.7,43,147,184,242,58,RB
921,Derrick Henry,303,18,321,2019,25,TEN,15,15,303,1540,5.1,16,102.7,73,49.2,24,18,206,11.4,2,13.7,75,8.6,4,50,321,1540,1746,1746,0,RB
922,Brian Hill,78,10,88,2019,24,ATL,12,2,78,323,4.1,2,26.9,19,39.7,14,10,69,6.9,1,5.8,71.4,4.9,4,35.7,88,323,392,392,0,RB
923,Dontrell Hilliard,13,12,25,2019,24,CLE,14,0,13,49,3.8,2,3.5,3,46.2,15,12,92,7.7,0,6.6,80,6.1,4,40,25,49,141,669,528,RB
924,Jon Hilliman,30,3,33,2019,24,NYG,3,1,30,91,3,0,30.3,6,40,4,3,1,0.3,0,0.3,75,0.3,0,25,33,91,92,92,0,RB
925,Justice Hill,58,8,66,2019,22,BAL,16,0,58,225,3.9,2,14.1,10,36.2,15,8,70,8.8,0,4.4,53.3,4.7,5,53.3,66,225,295,522,227,RB
926,Wes Hills,10,2,12,2019,24,DET,1,1,10,21,2.1,2,21,3,50,2,2,1,0.5,0,1,100,0.5,0,0,12,21,22,22,0,RB
927,Nyheim Hines,52,44,96,2019,23,IND,16,2,52,199,3.8,2,12.4,16,51.9,58,44,320,7.3,0,20,75.9,5.5,15,43.1,96,199,519,923,404,RB
928,Travis Homer,18,11,29,2019,21,SEA,16,1,18,114,6.3,0,7.1,6,50,13,11,56,5.1,0,3.5,84.6,4.3,3,46.2,29,114,170,279,109,RB
929,Jordan Howard,119,10,129,2019,25,PHI,10,4,119,525,4.4,6,52.5,28,47.9,14,10,69,6.9,1,6.9,71.4,4.9,3,50,129,525,594,594,0,RB
930,Buddy Howell,5,0,5,2019,23,HOU,16,0,5,10,2,0,0.6,1,40,0,0,0,,0,0,,,0,,5,10,10,10,0,RB
931,Kareem Hunt,43,37,80,2019,24,CLE,8,3,43,179,4.2,2,22.4,8,53.5,44,37,285,7.7,1,35.6,84.1,6.5,17,52.3,80,171,464,458,0,RB
932,Carlos Hyde,245,10,255,2019,29,HOU,16,14,245,1070,4.4,6,66.9,55,51.4,16,10,42,4.2,0,2.6,62.5,2.6,2,25,255,1070,1112,1112,0,RB
933,Alec Ingold,10,6,16,2019,23,OAK,16,4,10,17,1.7,0,1.1,7,70,6,6,44,7.3,1,2.8,100,7.3,4,66.7,16,17,61,61,0,FB
934,Mark Ingram,202,26,228,2019,30,BAL,15,15,202,1018,5,10,67.9,53,58.4,29,26,247,9.5,5,16.5,89.7,8.5,16,62.1,228,1018,1265,1265,0,RB
935,Justin Jackson,29,9,38,2019,23,LAC,7,0,29,200,6.9,0,28.6,9,62.1,11,9,22,2.4,0,3.1,81.8,2,0,36.4,38,200,222,329,107,RB
936,Josh Jacobs,242,20,262,2019,21,OAK,13,13,242,1150,4.8,7,88.5,53,49.6,27,20,166,8.3,0,12.8,74.1,6.1,8,51.9,262,1150,1316,1316,0,RB
937,Andy Janovich,1,5,6,2019,26,DEN,7,3,1,1,1,1,0.1,1,100,5,5,42,8.4,0,6,100,8.4,1,60,6,1,43,43,0,RB
938,David Johnson,94,36,130,2019,28,ARI,13,9,94,345,3.7,2,26.5,20,43.6,47,36,370,10.3,4,28.5,76.6,7.9,17,51.1,130,345,715,739,24,RB
939,D'Ernest Johnson,4,6,10,2019,23,CLE,16,0,4,21,5.3,0,1.3,0,0,7,6,71,11.8,0,4.4,85.7,10.1,1,28.6,10,21,92,230,138,RB
940,Duke Johnson,83,44,127,2019,26,HOU,16,2,83,410,4.9,2,25.6,17,45.8,62,44,410,9.3,3,25.6,71,6.6,18,50,127,410,820,820,0,RB
941,Jakob Johnson,0,1,1,2019,25,NWE,4,3,0,0,,0,0,0,,2,1,5,5,0,1.3,50,2.5,0,50,1,0,5,5,0,FB
942,Kerryon Johnson,113,10,123,2019,22,DET,8,7,113,403,3.6,3,50.4,22,48.7,15,10,127,12.7,1,15.9,66.7,8.5,7,53.3,123,403,530,530,0,RB
943,Ty Johnson,63,24,87,2019,22,DET,16,1,63,273,4.3,0,17.1,11,44.4,31,24,109,4.5,0,6.8,77.4,3.5,4,32.3,87,273,382,440,58,RB
944,Aaron Jones,236,49,285,2019,25,GNB,16,16,236,1084,4.6,16,67.8,55,54.2,68,49,474,9.7,3,29.6,72.1,7,18,47.1,285,1084,1558,1558,0,RB
945,Ronald Jones II,172,31,203,2019,22,TAM,16,9,172,724,4.2,6,45.3,34,43,40,31,309,10,0,19.3,77.5,7.7,12,52.5,203,724,1033,1033,0,RB
946,Taiwan Jones,9,1,10,2019,31,HOU,11,0,9,40,4.4,0,3.6,3,66.7,1,1,9,9,0,0.8,100,9,0,100,10,40,49,49,0,RB
947,Kyle Juszczyk,3,20,23,2019,28,SFO,12,12,3,7,2.3,0,0.6,1,33.3,24,20,239,12,1,19.9,83.3,10,11,70.8,23,7,246,260,0,FB
948,Alvin Kamara,171,81,252,2019,24,NOR,14,9,171,797,4.7,5,56.9,32,50.9,97,81,533,6.6,1,38.1,83.5,5.5,28,44.3,252,810,1330,1360,30,RB
949,John Kelly,3,0,3,2019,23,LAR,4,0,3,9,3,0,2.3,0,33.3,0,0,0,,0,0,,,0,,3,9,9,9,0,RB
950,Patrick Laird,62,23,85,2019,24,MIA,15,4,62,168,2.7,1,11.2,9,30.6,30,23,204,8.9,0,13.6,76.7,6.8,13,50,85,168,372,372,0,RB
951,Dion Lewis,54,25,79,2019,29,TEN,16,1,54,209,3.9,0,13.1,6,46.3,32,25,164,6.6,1,10.3,78.1,5.1,7,31.3,79,209,373,373,0,RB
952,Phillip Lindsay,224,35,259,2019,25,DEN,16,16,224,1011,4.5,7,63.2,38,48.7,48,35,196,5.6,0,12.3,72.9,4.1,9,37.5,259,1011,1207,1207,0,RB
953,Zach Line,7,6,13,2019,29,NOR,12,2,7,20,2.9,0,1.7,5,71.4,10,6,36,6,0,3,60,3.6,1,20,13,20,56,56,0,RB
954,T.J. Logan,3,2,5,2019,25,TAM,12,0,3,10,3.3,0,0.8,0,33.3,3,2,13,6.5,0,1.1,66.7,4.3,1,33.3,5,10,23,418,395,FB
955,Marshawn Lynch,12,0,12,2019,33,SEA,1,0,12,34,2.8,1,34,2,33.3,0,0,0,,0,0,,,0,,12,34,34,34,0,RB
956,Marlon Mack,247,14,261,2019,23,IND,14,12,247,1091,4.4,8,77.9,67,51,17,14,82,5.9,0,5.9,82.4,4.8,2,47.1,261,1091,1173,1173,0,RB
957,Alexander Mattison,100,10,110,2019,21,MIN,13,0,100,462,4.6,1,35.5,19,37,12,10,82,8.2,0,6.3,83.3,6.8,3,50,110,462,544,544,0,RB
958,Christian McCaffrey,287,116,403,2019,23,CAR,16,16,287,1387,4.8,15,86.7,57,46.3,142,116,1005,8.7,4,62.8,81.7,7.1,58,59.9,403,1387,2392,2392,0,RB
959,LeSean McCoy,101,28,129,2019,31,KAN,13,9,101,465,4.6,4,35.8,24,46.5,34,28,181,6.5,1,13.9,82.4,5.3,6,44.1,129,465,646,646,0,RB
960,J.D. McKissic,38,34,72,2019,26,DET,16,3,38,205,5.4,0,12.8,8,47.4,42,34,233,6.9,1,14.6,81,5.5,7,35.7,72,205,438,455,17,RB
961,Jeremy McNichols,0,0,0,2019,24,JAX,1,0,0,0,,0,0,0,,0,0,0,,0,0,,,0,,0,0,0,0,0,RB
962,Sony Michel,247,12,259,2019,24,NWE,16,14,247,912,3.7,7,57,55,47,20,12,94,7.8,0,5.9,60,4.7,7,40,259,912,1006,1006,0,RB
963,Joe Mixon,278,35,313,2019,23,CIN,16,15,278,1137,4.1,5,71.1,56,45.3,45,35,287,8.2,3,17.9,77.8,6.4,14,51.1,313,1137,1424,1424,0,RB
964,David Montgomery,242,25,267,2019,22,CHI,16,8,242,889,3.7,6,55.6,50,43.4,35,25,185,7.4,1,11.6,71.4,5.3,7,42.9,267,889,1074,1074,0,RB
965,Alfred Morris,1,0,1,2019,31,ARI,1,0,1,4,4,0,4,1,100,0,0,0,,0,0,,,0,,1,4,4,4,0,RB
966,Raheem Mostert,137,14,151,2019,27,SFO,16,0,137,772,5.6,8,48.3,31,48.9,22,14,180,12.9,2,11.3,63.6,8.2,6,40.9,151,772,952,933,-19,RB
967,Latavius Murray,146,34,180,2019,29,NOR,16,8,146,637,4.4,5,39.8,38,57.5,43,34,235,6.9,1,14.7,79.1,5.5,9,48.8,180,637,872,872,0,RB
968,Ryan Nall,2,0,2,2019,24,CHI,8,0,2,8,4,0,1,1,50,0,0,0,,0,0,,,0,,2,8,8,8,0,RB
969,Roosevelt Nix,0,2,2,2019,27,PIT,3,0,0,0,,0,0,0,,3,2,4,2,0,1.3,66.7,1.3,0,33.3,2,0,4,4,0,RB
970,Dare Ogunbowale,11,35,46,2019,25,TAM,16,0,11,17,1.5,2,1.1,3,36.4,46,35,286,8.2,0,17.9,76.1,6.2,14,45.7,46,17,303,526,223,RB
971,Jamize Olawale,0,0,0,2019,30,DAL,16,5,0,0,,0,0,0,,2,0,0,,0,0,0,0,0,0,0,0,0,0,0,FB
972,Qadree Ollison,22,1,23,2019,23,ATL,8,0,22,50,2.3,4,6.3,6,45.5,2,1,7,7,0,0.9,50,3.5,1,50,23,50,57,57,0,RB
973,Donovan Olumba,0,0,0,2019,24,DAL,1,0,0,0,,0,0,0,,0,0,0,,0,0,,,0,,0,0,0,0,0,RB
974,Ricky Ortiz,0,1,1,2019,25,NOR,1,0,0,0,,0,0,0,,1,1,8,8,0,8,100,8,0,100,1,0,8,8,0,FB
975,Devine Ozigbo,9,3,12,2019,23,JAX,10,0,9,27,3,0,2.7,1,44.4,5,3,23,7.7,0,2.3,60,4.6,1,60,12,27,50,50,0,RB
976,Elijhaa Penny,15,2,17,2019,26,NYG,16,1,15,39,2.6,0,2.4,2,40,4,2,9,4.5,0,0.6,50,2.3,0,25,17,39,48,48,0,RB
977,Rashaad Penny,65,8,73,2019,23,SEA,10,0,65,370,5.7,3,37,16,52.3,11,8,83,10.4,1,8.3,72.7,7.5,3,54.5,73,370,453,497,44,RB
978,Samaje Perine,5,0,5,2019,24,"CIN,MIA",7,0,5,16,3.2,0,2.3,1,40,0,0,0,,0,0,,,0,,5,16,16,16,0,RB
979,Paul Perkins,12,1,13,2019,25,DET,4,0,12,29,2.4,0,7.3,3,25,1,1,9,9,0,2.3,100,9,0,100,13,29,38,38,0,RB
980,Senorise Perry,3,1,4,2019,28,BUF,11,0,3,3,1,0,0.3,0,0,1,1,1,1,0,0.1,100,1,0,0,4,3,4,6,2,RB
981,Adrian Peterson,211,17,228,2019,34,WAS,15,15,211,898,4.3,5,59.9,41,46,23,17,142,8.4,0,9.5,73.9,6.2,7,47.8,228,898,1040,1040,0,RB
982,Tony Pollard,86,15,101,2019,22,DAL,15,0,86,455,5.3,2,30.3,21,50,20,15,107,7.1,1,7.1,75,5.4,4,40,101,455,562,807,245,RB
983,Troymaine Pope,10,2,12,2019,26,LAC,14,0,10,20,2,0,1.4,0,30,3,2,14,7,1,1,66.7,4.7,1,33.3,12,20,34,322,288,RB
984,Bilal Powell,59,7,66,2019,31,NYJ,13,1,59,229,3.9,0,17.6,12,39,12,7,33,4.7,0,2.5,58.3,2.8,0,16.7,66,229,262,262,0,RB
985,C.J. Prosise,23,10,33,2019,25,SEA,9,0,23,72,3.1,1,8,4,39.1,12,10,76,7.6,0,8.4,83.3,6.3,3,58.3,33,72,148,148,0,RB
986,Craig Reynolds,0,0,0,2019,23,WAS,3,0,0,0,,0,0,0,,0,0,0,,0,0,,,0,,0,0,0,0,0,RB
987,Patrick Ricard,0,8,8,2019,25,BAL,16,7,0,0,,0,0,0,,11,8,47,5.9,1,2.9,72.7,4.3,3,54.5,8,0,47,47,0,FB
988,Jalen Richard,39,36,75,2019,26,OAK,16,0,39,145,3.7,0,9.1,10,48.7,43,36,323,9,0,20.2,83.7,7.5,15,48.8,75,145,468,677,209,RB
989,Jaylen Samuels,66,47,113,2019,23,PIT,14,4,66,175,2.7,1,12.5,9,37.9,57,47,305,6.5,1,21.8,82.5,5.4,19,49.1,113,210,480,480,0,RB
990,Miles Sanders,179,50,229,2019,22,PHI,16,11,179,818,4.6,3,51.1,30,44.7,63,50,509,10.2,3,31.8,79.4,8.1,19,49.2,229,818,1327,1641,314,RB
991,Bo Scarbrough,89,1,90,2019,25,DET,6,5,89,377,4.2,1,62.8,15,56.2,4,1,5,5,0,0.8,25,1.3,0,25,90,377,382,382,0,RB
992,Jordan Scarlett,4,0,4,2019,23,CAR,9,0,4,9,2.3,0,1,0,50,0,0,0,,0,0,,,0,,4,9,9,9,0,RB
993,Boston Scott,61,24,85,2019,24,PHI,11,2,61,245,4,5,22.3,17,52.5,26,24,204,8.5,0,18.5,92.3,7.8,10,61.5,85,245,449,721,272,RB
994,Anthony Sherman,4,2,6,2019,31,KAN,16,0,4,9,2.3,0,0.6,3,75,3,2,22,11,0,1.4,66.7,7.3,2,66.7,6,9,31,31,0,RB
995,Devin Singletary,151,29,180,2019,22,BUF,12,8,151,775,5.1,2,64.6,37,49,41,29,194,6.7,2,16.2,70.7,4.7,5,29.3,180,775,969,969,0,RB
996,Wendell Smallwood,22,9,31,2019,25,WAS,15,0,22,81,3.7,0,5.4,4,22.7,13,9,64,7.1,0,4.3,69.2,4.9,4,53.8,31,81,145,159,14,RB
997,Ito Smith,22,11,33,2019,24,ATL,7,0,22,106,4.8,1,15.1,10,54.5,14,11,87,7.9,0,12.4,78.6,6.2,2,35.7,33,106,193,252,59,RB
998,Keith Smith,5,1,6,2019,27,ATL,16,5,5,8,1.6,0,0.5,4,80,3,1,13,13,0,0.8,33.3,4.3,1,33.3,6,8,21,21,0,FB
999,Rod Smith,0,0,0,2019,27,"TEN,OAK",6,0,0,0,,0,0,0,,0,0,0,,0,0,,,0,,0,0,0,0,0,RB
1000,Benny Snell Jr.,108,3,111,2019,21,PIT,13,2,108,426,3.9,2,32.8,19,45.4,4,3,23,7.7,0,1.8,75,5.8,0,25,111,426,449,457,8,RB
1001,Darren Sproles,17,6,23,2019,36,PHI,6,1,17,66,3.9,0,11,3,41.2,10,6,24,4,0,4,60,2.4,1,20,23,66,90,176,86,RB
1002,Chris Thompson,37,42,79,2019,29,WAS,11,0,37,138,3.7,0,12.5,7,37.8,58,42,378,9,0,34.4,72.4,6.5,16,37.9,79,138,516,516,0,RB
1003,Darwin Thompson,37,9,46,2019,22,KAN,12,0,37,128,3.5,1,10.7,9,54.1,10,9,43,4.8,0,3.6,90,4.3,2,50,46,128,171,198,27,RB
1004,De'Anthony Thomas,2,1,3,2019,26,"KAN,BAL",14,0,2,5,2.5,0,0.4,1,50,2,1,6,6,0,0.4,50,3,0,50,3,5,11,480,469,RB
1005,Robert Turbin,0,0,0,2019,30,SEA,1,0,0,0,,0,0,0,,0,0,0,,0,0,,,0,,0,0,0,0,0,RB
1006,De'Lance Turner,4,0,4,2019,24,MIA,8,0,4,6,1.5,0,0.8,0,25,0,0,0,,0,0,,,0,,4,6,6,6,0,RB
1007,Danny Vitale,1,7,8,2019,26,GNB,15,4,1,3,3,0,0.2,0,0,12,7,97,13.9,0,6.5,58.3,8.1,3,41.7,8,3,100,100,0,RB
1008,Austin Walter,0,0,0,2019,23,NYG,1,0,0,0,,0,0,0,,0,0,0,,0,0,,,0,,0,0,0,0,0,RB
1009,Mark Walton,53,15,68,2019,22,MIA,7,4,53,201,3.8,0,28.7,11,43.4,21,15,89,5.9,0,12.7,71.4,4.2,3,33.3,68,201,290,290,0,RB
1010,Spencer Ware,17,5,22,2019,28,KAN,3,1,17,51,3,0,17,3,64.7,7,5,22,4.4,0,7.3,71.4,3.1,1,28.6,22,51,73,73,0,RB
1011,DeAndre Washington,108,36,144,2019,26,OAK,16,3,108,387,3.6,3,24.2,23,50.9,41,36,292,8.1,0,18.3,87.8,7.1,10,58.5,144,387,679,679,0,RB
1012,Dwayne Washington,8,1,9,2019,25,NOR,16,0,8,60,7.5,0,3.8,2,50,1,1,6,6,0,0.4,100,6,0,100,9,60,66,78,12,RB
1013,Derek Watt,7,3,10,2019,27,LAC,16,2,7,10,1.4,1,0.6,6,85.7,5,3,32,10.7,0,2,60,6.4,1,40,10,10,42,42,0,FB
1014,Trevon Wesco,1,2,3,2019,24,NYJ,16,1,1,2,2,0,0.1,1,100,3,2,47,23.5,0,2.9,66.7,15.7,2,66.7,3,2,49,49,0,FB
1015,James White,67,72,139,2019,27,NWE,15,1,67,263,3.9,1,17.5,15,41.8,95,72,645,9,5,43,75.8,6.8,31,45.3,139,298,908,949,41,RB
1016,Kerrith Whyte Jr,24,1,25,2019,23,PIT,6,0,24,122,5.1,0,20.3,5,41.7,1,1,9,9,0,1.5,100,9,1,100,25,122,131,395,264,RB
1017,Jordan Wilkins,51,7,58,2019,25,IND,14,1,51,307,6,2,21.9,12,56.9,11,7,43,6.1,0,3.1,63.6,3.9,1,36.4,58,307,350,365,15,RB
1018,Damien Williams,111,30,141,2019,27,KAN,11,6,111,498,4.5,5,45.3,22,46.8,37,30,213,7.1,2,19.4,81.1,5.8,10,43.2,141,498,711,711,0,RB
1019,Darrel Williams,41,15,56,2019,24,KAN,12,0,41,141,3.4,3,11.8,12,48.8,19,15,167,11.1,1,13.9,78.9,8.8,7,52.6,56,141,308,308,0,RB
1020,Dexter Williams,5,0,5,2019,22,GNB,4,0,5,11,2.2,0,2.8,0,20,0,0,0,,0,0,,,0,,5,11,11,11,0,RB
1021,Jamaal Williams,107,39,146,2019,24,GNB,14,2,107,460,4.3,1,32.9,23,49.5,45,39,253,6.5,5,18.1,86.7,5.6,16,53.3,146,460,713,722,9,RB
1022,Jonathan Williams,49,5,54,2019,25,IND,9,1,49,235,4.8,1,26.1,13,51,5,5,59,11.8,0,6.6,100,11.8,3,80,54,235,294,294,0,RB
1023,Trayveon Williams,0,0,0,2019,22,CIN,11,0,0,0,,0,0,0,,0,0,0,,0,0,,,0,,0,0,0,0,0,RB
1024,Brandon Wilson,0,0,0,2019,25,CIN,12,2,0,0,,0,0,0,,0,0,0,,0,0,,,0,,0,0,0,625,625,RB
1025,Jeff Wilson,27,3,30,2019,24,SFO,10,0,27,105,3.9,4,10.5,9,48.1,5,3,34,11.3,1,3.4,60,6.8,1,40,30,105,139,139,0,RB
1026,T.J. Yeldon,17,13,30,2019,26,BUF,6,0,17,63,3.7,0,10.5,5,52.9,15,13,124,9.5,0,20.7,86.7,8.3,6,53.3,30,63,187,187,0,RB
1027,Zach Zenner,3,2,5,2019,28,"ARI,MIA,NOR",5,0,3,-2,-0.7,0,-0.4,0,0,3,2,19,9.5,0,3.8,66.7,6.3,2,66.7,5,-2,17,17,0,RB
1028,Ameer Abdullah,1,3,4,2018,25,"DET,MIN",10,0,1,1,1,0,0.1,0,0,4,3,28,9.3,0,2.8,75,7,1,75,4,1,29,394,365,RB
1029,Josh Adams,120,7,127,2018,22,PHI,14,5,120,511,4.3,3,36.5,23,46.7,13,7,58,8.3,0,4.1,53.8,4.5,3,38.5,127,511,569,569,0,RB
1030,Jay Ajayi,45,5,50,2018,25,PHI,4,3,45,184,4.1,3,46,11,48.9,6,5,20,4,0,5,83.3,3.3,1,50,50,184,204,204,0,RB
1031,Javorius Allen,41,35,76,2018,27,BAL,14,0,41,110,2.7,3,7.9,10,36.6,43,35,196,5.6,2,14,81.4,4.6,11,44.2,76,110,306,306,0,RB
1032,C.J. Anderson,67,5,72,2018,27,"CAR,LAR",11,3,67,403,6,2,36.6,21,67.2,9,5,41,8.2,1,3.7,55.6,4.6,2,33.3,72,403,444,444,0,RB
1033,Alex Armah,9,1,10,2018,24,CAR,16,2,9,15,1.7,2,0.9,3,44.4,1,1,5,5,0,0.3,100,5,0,0,10,15,20,20,0,FB
1034,Cameron Artis-Payne,19,3,22,2018,28,CAR,9,0,19,69,3.6,1,7.7,8,57.9,4,3,15,5,0,1.7,75,3.8,1,25,22,69,84,84,0,RB
1035,Kalen Ballage,36,9,45,2018,23,MIA,12,0,36,191,5.3,1,15.9,10,44.4,11,9,56,6.2,0,4.7,81.8,5.1,2,45.5,45,191,247,267,26,RB
1036,Peyton Barber,234,20,254,2018,24,TAM,16,16,234,871,3.7,5,54.4,41,42.3,29,20,92,4.6,1,5.8,69,3.2,4,34.5,254,871,963,963,0,RB
1037,Saquon Barkley,261,91,352,2018,21,NYG,16,16,261,1307,5,11,81.7,50,39.8,121,91,721,7.9,4,45.1,75.2,6,30,38,352,1307,2028,2028,0,RB
1038,Kenjon Barner,19,1,20,2018,29,"CAR,NWE",9,0,19,71,3.7,0,7.9,3,57.9,1,1,3,3,0,0.3,100,3,0,0,20,71,74,323,249,RB
1039,Nick Bellore,1,4,5,2018,29,DET,14,4,1,0,0,0,0,0,0,4,4,15,3.8,0,1.1,100,3.8,2,75,5,0,15,15,0,FB
1040,Giovani Bernard,56,35,91,2018,27,CIN,12,4,56,211,3.8,3,17.6,14,37.5,48,35,218,6.2,0,18.2,72.9,4.5,8,41.7,91,211,429,454,25,RB
1041,Kapri Bibbs,21,16,37,2018,25,"GNB,WAS",12,0,21,103,4.9,3,8.6,8,57.1,23,16,115,7.2,1,9.6,69.6,5,4,43.5,37,103,218,275,57,RB
1042,LeGarrette Blount,154,10,164,2018,32,DET,16,8,154,418,2.7,5,26.1,25,35.1,15,10,67,6.7,0,4.2,66.7,4.5,4,40,164,418,485,485,0,RB
1043,Alfred Blue,150,20,170,2018,27,HOU,16,2,150,499,3.3,2,31.2,25,37.3,27,20,154,7.7,0,9.6,74.1,5.7,4,48.1,170,499,653,666,13,RB
1044,Tommy Bohanon,1,6,7,2018,28,JAX,16,6,1,0,0,0,0,0,0,9,6,41,6.8,0,2.6,66.7,4.6,1,66.7,7,0,41,66,25,FB
1045,Brandon Bolden,8,3,11,2018,28,MIA,16,0,8,91,11.4,2,5.7,4,62.5,3,3,13,4.3,1,0.8,100,4.3,1,66.7,11,91,104,104,0,RB
1046,Devontae Booker,34,38,72,2018,26,DEN,16,0,34,183,5.4,1,11.4,11,52.9,51,38,275,7.2,0,17.2,74.5,5.4,9,51,72,183,458,692,234,RB
1047,Mike Boone,11,2,13,2018,23,MIN,8,0,11,47,4.3,0,5.9,2,36.4,3,2,1,0.5,0,0.1,66.7,0.3,0,0,13,47,48,48,0,RB
1048,Matt Breida,153,27,180,2018,23,SFO,14,13,153,814,5.3,3,58.1,36,45.1,31,27,261,9.7,2,18.6,87.1,8.4,12,67.7,180,814,1075,1075,0,RB
1049,Malcolm Brown,43,5,48,2018,25,LAR,12,0,43,212,4.9,0,17.7,10,67.4,7,5,52,10.4,1,4.3,71.4,7.4,2,57.1,48,212,264,264,0,RB
1050,Rex Burkhead,57,14,71,2018,28,NWE,8,4,57,186,3.3,0,23.3,11,38.6,20,14,131,9.4,1,16.4,70,6.6,4,55,71,186,317,317,0,RB
1051,Michael Burton,0,1,1,2018,26,CHI,8,1,0,0,,0,0,0,,1,1,6,6,0,0.8,100,6,1,100,1,0,6,6,0,RB
1052,Travaris Cadet,11,1,12,2018,29,CAR,1,0,11,17,1.5,0,17,0,36.4,1,1,5,5,0,5,100,5,0,0,12,17,22,22,0,RB
1053,Trenton Cannon,38,17,55,2018,24,NYJ,16,0,38,113,3,1,7.1,7,36.8,25,17,144,8.5,0,9,68,5.8,4,40,55,113,257,277,20,RB
1054,Chris Carson,247,20,267,2018,24,SEA,14,14,247,1151,4.7,9,82.2,61,50.6,24,20,163,8.2,0,11.6,83.3,6.8,7,50,267,1151,1314,1314,0,RB
1055,Tra Carson,0,0,0,2018,26,"CIN,GNB",6,0,0,0,,0,0,0,,0,0,0,,0,0,,,0,,0,0,0,0,0,RB
1056,Jamaal Charles,6,2,8,2018,32,JAX,2,0,6,7,1.2,0,3.5,0,0,3,2,7,3.5,0,3.5,66.7,2.3,0,33.3,8,7,14,14,0,RB
1057,Nick Chubb,192,20,212,2018,23,CLE,16,9,192,996,5.2,8,62.3,47,47.9,29,20,149,7.5,2,9.3,69,5.1,5,41.4,212,996,1145,1145,0,RB
1058,Corey Clement,68,22,90,2018,24,PHI,11,0,68,259,3.8,2,23.5,15,42.6,25,22,192,8.7,0,17.5,88,7.7,10,56,90,259,451,801,350,RB
1059,Tarik Cohen,99,71,170,2018,23,CHI,16,7,99,444,4.5,3,27.8,20,44.4,91,71,725,10.2,5,45.3,78,8,29,56,170,445,1169,1599,433,RB
1060,Derrick Coleman,2,2,4,2018,28,ARI,16,4,2,3,1.5,0,0.2,0,0,3,2,17,8.5,0,1.1,66.7,5.7,1,66.7,4,3,20,20,0,RB
1061,Lavon Coleman,0,0,0,2018,24,GNB,1,0,0,0,,0,0,0,,0,0,0,,0,0,,,0,,0,0,0,0,0,RB
1062,Tevin Coleman,167,32,199,2018,25,ATL,16,14,167,800,4.8,4,50,36,42.5,44,32,276,8.6,5,17.3,72.7,6.3,15,52.3,199,800,1076,1076,0,RB
1063,Alex Collins,114,15,129,2018,24,BAL,10,10,114,411,3.6,7,41.1,22,46.5,21,15,105,7,1,10.5,71.4,5,6,52.4,129,411,516,516,0,RB
1064,James Conner,215,55,270,2018,23,PIT,13,12,215,973,4.5,12,74.8,56,48.4,71,55,497,9,1,38.2,77.5,7,20,52.1,270,973,1470,1470,0,RB
1065,Dalvin Cook,133,40,173,2018,23,MIN,11,10,133,615,4.6,2,55.9,22,41.4,49,40,305,7.6,2,27.7,81.6,6.2,15,51,173,615,920,920,0,RB
1066,Isaiah Crowell,143,21,164,2018,25,NYJ,13,6,143,685,4.8,6,52.7,26,35,28,21,152,7.2,0,11.7,75,5.4,7,46.4,164,685,837,837,0,RB
1067,Benny Cunningham,11,1,12,2018,28,CHI,15,0,11,20,1.8,0,1.3,0,18.2,2,1,9,9,0,0.6,50,4.5,1,50,12,20,29,202,173,RB
1068,Justin Davis,2,0,2,2018,23,LAR,11,0,2,19,9.5,0,1.7,1,50,0,0,0,,0,0,,,0,,2,19,19,19,0,RB
1069,Mike Davis,112,34,146,2018,25,SEA,15,2,112,514,4.6,4,34.3,25,51.8,42,34,214,6.3,1,14.3,81,5.1,10,47.6,146,514,728,728,0,RB
1070,Dalyn Dawkins,0,0,0,2018,24,TEN,2,0,0,0,,0,0,0,,0,0,0,,0,0,,,0,,0,0,0,0,0,RB
1071,Matthew Dayes,0,0,0,2018,24,SFO,7,0,0,0,,0,0,0,,0,0,0,,0,0,,,0,,0,0,0,17,17,RB
1072,James Develin,6,12,18,2018,30,NWE,16,8,6,8,1.3,4,0.5,5,83.3,17,12,61,5.1,0,3.8,70.6,3.6,3,35.3,18,8,69,84,15,FB
1073,Patrick DiMarco,1,3,4,2018,29,BUF,16,5,1,9,9,0,0.6,1,100,4,3,62,20.7,0,3.9,75,15.5,2,50,4,9,71,71,0,FB
1074,Kenneth Dixon,60,6,66,2018,24,BAL,6,0,60,333,5.6,2,55.5,20,51.7,7,6,51,8.5,0,8.5,85.7,7.3,2,57.1,66,333,384,384,0,RB
1075,Kenyan Drake,120,53,173,2018,24,MIA,16,7,120,535,4.5,4,33.4,23,45,73,53,477,9,5,29.8,72.6,6.5,23,45.2,173,535,1012,1225,213,RB
1076,Chase Edmonds,60,20,80,2018,22,ARI,16,0,60,208,3.5,2,13,14,43.3,23,20,103,5.2,0,6.4,87,4.5,5,39.1,80,208,311,359,48,RB
1077,Trey Edmunds,0,0,0,2018,24,PIT,4,0,0,0,,0,0,0,,0,0,0,,0,0,,,0,,0,0,0,0,0,RB
1078,Gus Edwards,137,2,139,2018,23,BAL,11,6,137,718,5.2,2,65.3,37,61.3,2,2,20,10,0,1.8,100,10,1,100,139,718,738,738,0,RB
1079,Austin Ekeler,106,39,145,2018,23,LAC,14,3,106,554,5.2,3,39.6,25,50,53,39,404,10.4,3,28.9,73.6,7.6,18,52.8,145,554,958,958,0,RB
1080,Ezekiel Elliott,304,77,381,2018,23,DAL,15,15,304,1434,4.7,6,95.6,74,49,95,77,567,7.4,3,37.8,81.1,6,22,41.1,381,1434,2001,2001,0,RB
1081,Donnie Ernsberger,0,0,0,2018,22,TAM,2,0,0,0,,0,0,0,,0,0,0,,0,0,,,0,,0,0,0,0,0,RB
1082,Tyler Ervin,0,3,3,2018,25,HOU,9,0,0,0,,0,0,0,,3,3,35,11.7,0,3.9,100,11.7,1,33.3,3,0,35,463,428,RB
1083,Anthony Firkser,0,19,19,2018,23,TEN,12,0,0,0,,0,0,0,,20,19,225,11.8,1,18.8,95,11.3,11,75,19,0,225,225,0,FB
1084,David Fluellen,4,0,4,2018,26,TEN,7,0,4,16,4,0,2.3,1,25,0,0,0,,0,0,,,0,,4,16,16,16,0,RB
1085,Keith Ford,21,3,24,2018,24,BUF,2,1,21,79,3.8,0,39.5,4,42.9,5,3,21,7,0,10.5,60,4.2,1,60,24,79,100,100,0,RB
1086,D'Onta Foreman,7,2,9,2018,22,HOU,1,0,7,-1,-0.1,0,-1,0,0,2,2,28,14,1,28,100,14,1,100,9,-1,27,27,0,RB
1087,Leonard Fournette,133,22,155,2018,23,JAX,8,8,133,439,3.3,5,54.9,23,47.4,26,22,185,8.4,1,23.1,84.6,7.1,10,50,155,439,624,624,0,RB
1088,Devonta Freeman,14,5,19,2018,26,ATL,2,2,14,68,4.9,0,34,2,50,7,5,23,4.6,0,11.5,71.4,3.3,0,14.3,19,68,91,91,0,RB
1089,Royce Freeman,130,14,144,2018,22,DEN,14,8,130,521,4,5,37.2,30,46.2,20,14,72,5.1,0,5.1,70,3.6,2,45,144,521,593,593,0,RB
1090,Wayne Gallman,51,14,65,2018,24,NYG,15,1,51,176,3.5,1,11.7,7,41.2,22,14,89,6.4,0,5.9,63.6,4,5,31.8,65,176,265,265,0,RB
1091,Mike Gillislee,16,1,17,2018,28,NOR,4,0,16,43,2.7,0,10.8,2,56.3,1,1,9,9,0,2.3,100,9,0,100,17,43,52,52,0,RB
1092,Melvin Gordon,175,50,225,2018,25,LAC,12,12,175,885,5.1,10,73.8,47,51.4,66,50,490,9.8,4,40.8,75.8,7.4,21,48.5,225,885,1375,1375,0,RB
1093,Frank Gore,156,12,168,2018,35,MIA,14,14,156,722,4.6,0,51.6,25,51.3,16,12,124,10.3,1,8.9,75,7.8,8,68.8,168,722,846,846,0,RB
1094,Corey Grant,13,9,22,2018,27,JAX,5,1,13,40,3.1,0,8,1,30.8,12,9,67,7.4,0,13.4,75,5.6,5,50,22,40,107,113,6,RB
1095,Todd Gurley,256,59,315,2018,24,LAR,14,14,256,1251,4.9,17,89.4,70,55.9,81,59,580,9.8,4,41.4,72.8,7.2,26,53.1,315,1251,1831,1831,0,RB
1096,C.J. Ham,6,11,17,2018,25,MIN,15,2,6,8,1.3,0,0.5,1,16.7,15,11,85,7.7,0,5.7,73.3,5.7,4,53.3,17,8,93,93,0,RB
1097,De'Angelo Henderson,2,0,2,2018,26,NYJ,3,0,2,19,9.5,0,6.3,0,100,0,0,0,,0,0,,,0,,2,19,19,19,0,RB
1098,Derrick Henry,215,15,230,2018,24,TEN,16,12,215,1059,4.9,12,66.2,50,50.2,18,15,99,6.6,0,6.2,83.3,5.5,4,44.4,230,1073,1158,1158,0,RB
1099,Brian Hill,20,1,21,2018,23,ATL,10,0,20,157,7.9,0,15.7,5,45,2,1,9,9,0,0.9,50,4.5,0,0,21,157,166,182,16,RB
1100,Dontrell Hilliard,0,9,9,2018,23,CLE,11,0,0,0,,0,0,0,,10,9,105,11.7,0,9.5,90,10.5,4,60,9,0,105,369,264,RB
1101,Jeremy Hill,4,1,5,2018,26,NWE,1,0,4,25,6.3,0,25,1,75,1,1,6,6,0,6,100,6,0,100,5,25,31,31,0,RB
1102,Nyheim Hines,85,63,148,2018,22,IND,16,4,85,314,3.7,2,19.6,17,45.9,81,63,425,6.7,2,26.6,77.8,5.2,29,46.9,148,314,739,739,0,RB
1103,Jordan Howard,250,20,270,2018,24,CHI,16,15,250,935,3.7,9,58.4,53,47.2,26,20,145,7.3,0,9.1,76.9,5.6,7,42.3,270,935,1080,1080,0,RB
1104,Buddy Howell,0,0,0,2018,22,HOU,15,0,0,0,,0,0,0,,0,0,0,,0,0,,,0,,0,0,0,0,0,RB
1105,Kareem Hunt,181,26,207,2018,23,KAN,11,11,181,824,4.6,7,74.9,46,51.9,35,26,378,14.5,7,34.4,74.3,10.8,16,62.9,207,824,1202,1202,0,RB
1106,Carlos Hyde,172,10,182,2018,28,"CLE,JAX",14,7,172,571,3.3,5,40.8,27,38.4,16,10,33,3.3,0,2.4,62.5,2.1,0,25,182,571,604,604,0,RB
1107,Mark Ingram,138,21,159,2018,29,NOR,12,6,138,645,4.7,6,53.8,34,53.6,27,21,170,8.1,1,14.2,77.8,6.3,5,37,159,645,815,815,0,RB
1108,Chris Ivory,115,13,128,2018,30,BUF,13,1,115,385,3.3,1,29.6,25,45.2,21,13,205,15.8,0,15.8,61.9,9.8,7,47.6,128,385,590,590,0,RB
1109,Darius Jackson,6,0,6,2018,25,"DAL,GNB",4,0,6,16,2.7,0,4,0,16.7,1,0,0,,0,0,0,0,0,0,6,16,16,106,90,RB
1110,Justin Jackson,50,15,65,2018,22,LAC,13,1,50,206,4.1,2,15.8,13,50,19,15,135,9,0,10.4,78.9,7.1,5,47.4,65,206,341,341,0,RB
1111,Andy Janovich,2,8,10,2018,25,DEN,16,7,2,5,2.5,0,0.3,2,100,10,8,112,14,1,7,80,11.2,5,60,10,5,117,125,8,FB
1112,David Johnson,258,50,308,2018,27,ARI,16,16,258,940,3.6,7,58.8,51,38,76,50,446,8.9,3,27.9,65.8,5.9,22,34.2,308,940,1386,1386,0,RB
1113,Duke Johnson,40,47,87,2018,25,CLE,16,2,40,201,5,0,12.6,9,50,62,47,429,9.1,3,26.8,75.8,6.9,25,46.8,87,201,630,630,0,RB
1114,Kerryon Johnson,118,32,150,2018,21,DET,10,7,118,641,5.4,3,64.1,32,52.5,39,32,213,6.7,1,21.3,82.1,5.5,11,53.8,150,641,854,854,0,RB
1115,Aaron Jones,133,26,159,2018,24,GNB,12,8,133,728,5.5,8,60.7,41,54.9,35,26,206,7.9,1,17.2,74.3,5.9,12,51.4,159,728,934,934,0,RB
1116,Ronald Jones II,23,7,30,2018,21,TAM,9,0,23,44,1.9,1,4.9,2,39.1,9,7,33,4.7,0,3.7,77.8,3.7,2,22.2,30,44,77,77,0,RB
1117,Taiwan Jones,0,0,0,2018,30,BUF,6,0,0,0,,0,0,0,,2,0,0,,0,0,0,0,0,0,0,0,0,89,89,RB
1118,Kyle Juszczyk,8,30,38,2018,27,SFO,16,14,8,30,3.8,0,1.9,2,37.5,41,30,324,10.8,1,20.3,73.2,7.9,15,51.2,38,30,354,354,0,FB
1119,Alvin Kamara,194,81,275,2018,23,NOR,15,13,194,883,4.6,14,58.9,57,58.2,105,81,709,8.8,4,47.3,77.1,6.8,31,52.4,275,883,1592,1800,208,RB
1120,John Kelly,27,2,29,2018,22,LAR,4,0,27,74,2.7,0,18.5,6,40.7,3,2,27,13.5,0,6.8,66.7,9,1,66.7,29,74,101,101,0,RB
1121,Robert Kelley,4,0,4,2018,26,WAS,2,0,4,8,2,0,4,1,50,0,0,0,,0,0,,,0,,4,8,8,8,0,RB
1122,Jeremy Langford,9,0,9,2018,27,ATL,1,0,9,25,2.8,0,25,1,44.4,0,0,0,,0,0,,,0,,9,25,25,25,0,RB
1123,Dion Lewis,155,59,214,2018,28,TEN,16,7,155,517,3.3,1,32.3,22,32.9,67,59,400,6.8,1,25,88.1,6,13,41.8,214,517,917,917,0,RB
1124,Phillip Lindsay,192,35,227,2018,24,DEN,15,8,192,1037,5.4,9,69.1,49,49.5,47,35,241,6.9,1,16.1,74.5,5.1,12,44.7,227,1037,1278,1471,186,RB
1125,Zach Line,9,5,14,2018,28,NOR,16,6,9,41,4.6,0,2.6,6,88.9,10,5,14,2.8,2,0.9,50,1.4,2,40,14,41,55,71,16,RB
1126,T.J. Logan,2,7,9,2018,24,ARI,10,0,2,2,1,0,0.2,0,0,7,7,37,5.3,0,3.7,100,5.3,1,14.3,9,2,39,335,296,FB
1127,Marshawn Lynch,90,15,105,2018,32,OAK,6,6,90,376,4.2,3,62.7,20,53.3,20,15,84,5.6,0,14,75,4.2,6,40,105,376,460,460,0,RB
1128,Marlon Mack,195,17,212,2018,22,IND,12,10,195,908,4.7,9,75.7,50,52.8,26,17,103,6.1,1,8.6,65.4,4,3,50,212,908,1011,1011,0,RB
1129,Tre Madden,3,2,5,2018,25,SEA,14,3,3,3,1,0,0.2,1,33.3,3,2,35,17.5,0,2.5,66.7,11.7,1,66.7,5,3,38,38,0,RB
1130,Byron Marshall,3,4,7,2018,24,WAS,6,0,3,9,3,0,1.5,0,66.7,6,4,30,7.5,0,5,66.7,5,1,50,7,9,39,153,114,RB
1131,Doug Martin,172,18,190,2018,29,OAK,16,9,172,723,4.2,4,45.2,37,52.3,24,18,116,6.4,0,7.3,75,4.8,6,41.7,190,723,839,839,0,RB
1132,Christian McCaffrey,219,107,326,2018,22,CAR,16,16,219,1098,5,7,68.6,53,54.3,124,107,867,8.1,6,54.2,86.3,7,41,55.6,326,1148,1965,1965,0,RB
1133,LeSean McCoy,161,34,195,2018,30,BUF,14,13,161,514,3.2,3,36.7,22,36,46,34,238,7,0,17,73.9,5.2,10,37,195,514,752,752,0,RB
1134,Elijah McGuire,92,19,111,2018,24,NYJ,8,3,92,276,3,3,34.5,15,35.9,31,19,193,10.2,1,24.1,61.3,6.2,10,51.6,111,276,469,469,0,RB
1135,J.D. McKissic,3,0,3,2018,25,SEA,5,0,3,8,2.7,0,1.6,0,33.3,1,0,0,,0,0,0,0,0,0,3,8,8,26,18,RB
1136,Jeremy McNichols,2,0,2,2018,23,IND,1,0,2,4,2,0,4,1,50,0,0,0,,0,0,,,0,,2,4,4,4,0,RB
1137,Christine Michael,2,0,2,2018,28,IND,1,0,2,9,4.5,0,9,0,50,0,0,0,,0,0,,,0,,2,9,9,9,0,RB
1138,Sony Michel,209,7,216,2018,23,NWE,13,8,209,931,4.5,6,71.6,54,51.2,11,7,50,7.1,0,3.8,63.6,4.5,3,45.5,216,931,981,1058,77,RB
1139,Lamar Miller,210,25,235,2018,27,HOU,14,14,210,973,4.6,5,69.5,36,42.4,35,25,163,6.5,1,11.6,71.4,4.7,8,34.3,235,973,1136,1136,0,RB
1140,Joe Mixon,237,43,280,2018,22,CIN,14,13,237,1168,4.9,8,83.4,60,48.5,55,43,296,6.9,1,21.1,78.2,5.4,14,50.9,280,1168,1464,1464,0,RB
1141,Taquan Mizzell,9,8,17,2018,25,CHI,9,1,9,16,1.8,0,1.8,0,22.2,10,8,78,9.8,1,8.7,80,7.8,4,50,17,16,94,200,106,RB
1142,Alfred Morris,111,8,119,2018,30,SFO,12,1,111,428,3.9,2,35.7,24,41.4,13,8,73,9.1,0,6.1,61.5,5.6,5,53.8,119,428,501,501,0,RB
1143,Raheem Mostert,34,6,40,2018,26,SFO,9,0,34,261,7.7,1,29,13,64.7,7,6,25,4.2,0,2.8,85.7,3.6,1,28.6,40,261,286,286,0,RB
1144,Marcus Murphy,52,11,63,2018,27,BUF,11,1,52,250,4.8,0,22.7,7,42.3,19,11,26,2.4,0,2.4,57.9,1.4,2,21.1,63,250,276,615,339,RB
1145,Latavius Murray,140,22,162,2018,28,MIN,16,6,140,578,4.1,6,36.1,23,42.1,26,22,141,6.4,0,8.8,84.6,5.4,7,42.3,162,578,719,719,0,RB
1146,Detrez Newsome,11,2,13,2018,24,LAC,9,0,11,49,4.5,0,5.4,3,45.5,2,2,19,9.5,0,2.1,100,9.5,2,100,13,49,68,68,0,RB
1147,Roosevelt Nix,1,4,5,2018,26,PIT,16,0,1,4,4,0,0.3,0,0,6,4,38,9.5,0,2.4,66.7,6.3,2,50,5,4,42,54,12,RB
1148,Dare Ogunbowale,0,0,0,2018,24,TAM,2,0,0,0,,0,0,0,,0,0,0,,0,0,,,0,,0,0,0,137,137,RB
1149,Jamize Olawale,0,2,2,2018,29,DAL,16,4,0,0,,0,0,0,,4,2,13,6.5,0,0.8,50,3.3,1,25,2,0,13,13,0,FB
1150,Ricky Ortiz,0,3,3,2018,24,ATL,12,9,0,0,,0,0,0,,4,3,11,3.7,0,0.9,75,2.8,0,50,3,0,11,11,0,FB
1151,Elijhaa Penny,7,8,15,2018,25,NYG,14,3,7,25,3.6,0,1.8,2,28.6,9,8,50,6.3,0,3.6,88.9,5.6,1,55.6,15,25,75,72,-3,RB
1152,Rashaad Penny,85,9,94,2018,22,SEA,14,0,85,419,4.9,2,29.9,18,38.8,12,9,75,8.3,0,5.4,75,6.3,3,25,94,419,494,634,140,RB
1153,Samaje Perine,8,3,11,2018,23,WAS,5,0,8,32,4,0,6.4,2,62.5,4,3,5,1.7,0,1,75,1.3,0,25,11,32,37,37,0,RB
1154,Senorise Perry,0,0,0,2018,27,MIA,16,0,0,0,,0,0,0,,0,0,0,,0,0,,,0,,0,0,0,164,164,RB
1155,Adrian Peterson,251,20,271,2018,33,WAS,16,16,251,1042,4.2,7,65.1,47,45.8,26,20,208,10.4,1,13,76.9,8,9,50,271,1042,1250,1250,0,RB
1156,Bilal Powell,80,11,91,2018,30,NYJ,7,7,80,343,4.3,0,49,16,40,18,11,110,10,1,15.7,61.1,6.1,3,33.3,91,343,453,453,0,RB
1157,C.J. Prosise,1,3,4,2018,24,SEA,5,0,1,-3,-3,0,-0.6,0,0,3,3,22,7.3,0,4.4,100,7.3,0,100,4,-3,19,19,0,RB
1158,Thomas Rawls,0,0,0,2018,25,CIN,1,0,0,0,,0,0,0,,0,0,0,,0,0,,,0,,0,0,0,0,0,RB
1159,Keenan Reynolds,0,0,0,2018,25,SEA,2,0,0,0,,0,0,0,,0,0,0,,0,0,,,0,,0,0,0,0,0,RB
1160,Patrick Ricard,0,0,0,2018,24,BAL,10,2,0,0,,0,0,0,,0,0,0,,0,0,,,0,,0,0,0,0,0,DT/FB
1161,Jalen Richard,55,68,123,2018,25,OAK,16,1,55,259,4.7,1,16.2,11,45.5,81,68,607,8.9,0,37.9,84,7.5,23,53.1,123,259,866,869,3,RB
1162,Theo Riddick,40,61,101,2018,27,DET,14,3,40,171,4.3,0,12.2,8,42.5,74,61,384,6.3,0,27.4,82.4,5.2,16,39.2,101,171,555,555,0,RB
1163,Stevan Ridley,29,3,32,2018,29,PIT,10,0,29,80,2.8,1,8,3,27.6,4,3,18,6,0,1.8,75,4.5,1,50,32,80,98,98,0,RB
1164,Jacquizz Rodgers,33,38,71,2018,28,TAM,16,0,33,106,3.2,1,6.6,7,33.3,45,38,304,8,0,19,84.4,6.8,13,55.6,71,106,410,464,52,RB
1165,Jaylen Samuels,56,26,82,2018,22,PIT,14,3,56,256,4.6,0,18.3,13,51.8,29,26,199,7.7,3,14.2,89.7,6.9,10,62.1,82,256,455,455,0,RB
1166,Boston Scott,0,0,0,2018,23,PHI,2,0,0,0,,0,0,0,,0,0,0,,0,0,,,0,,0,0,0,96,96,RB
1167,Anthony Sherman,1,8,9,2018,30,KAN,16,1,1,2,2,0,0.1,1,100,9,8,96,12,1,6,88.9,10.7,5,55.6,9,2,98,103,5,RB
1168,Wendell Smallwood,87,28,115,2018,24,PHI,16,6,87,364,4.2,3,22.8,22,49.4,35,28,230,8.2,2,14.4,80,6.6,9,42.9,115,364,594,627,33,RB
1169,Ito Smith,90,27,117,2018,23,ATL,14,0,90,315,3.5,4,22.5,18,47.8,32,27,152,5.6,0,10.9,84.4,4.8,9,46.9,117,315,467,467,0,RB
1170,Rod Smith,44,9,53,2018,26,DAL,16,1,44,127,2.9,1,7.9,10,38.6,12,9,60,6.7,0,3.8,75,5,1,41.7,53,127,187,187,0,RB
1171,Shane Smith,0,0,0,2018,25,NYG,2,0,0,0,,0,0,0,,0,0,0,,0,0,,,0,,0,0,0,0,0,FB
1172,Darren Sproles,29,15,44,2018,35,PHI,6,2,29,120,4.1,1,20,6,41.4,23,15,160,10.7,2,26.7,65.2,7,6,34.8,44,120,280,365,85,RB
1173,Jonathan Stewart,6,0,6,2018,31,NYG,3,0,6,17,2.8,0,5.7,0,50,0,0,0,,0,0,,,0,,6,17,17,17,0,RB
1174,Chris Thompson,43,41,84,2018,28,WAS,10,0,43,178,4.1,0,17.8,9,30.2,55,41,268,6.5,1,26.8,74.5,4.9,12,40,84,178,446,451,0,RB
1175,De'Anthony Thomas,1,3,4,2018,25,KAN,5,0,1,6,6,0,1.2,0,100,5,3,29,9.7,1,5.8,60,5.8,3,60,4,6,35,141,106,RB
1176,Roc Thomas,8,2,10,2018,23,MIN,5,0,8,30,3.8,0,6,2,50,4,2,21,10.5,0,4.2,50,5.3,0,0,10,30,51,71,20,RB
1177,Robert Turbin,4,1,5,2018,29,IND,2,0,4,10,2.5,0,5,0,50,2,1,3,3,0,1.5,50,1.5,0,0,5,10,13,13,0,RB
1178,De'Lance Turner,1,2,3,2018,23,BAL,4,0,1,4,4,0,1,0,100,2,2,17,8.5,0,4.3,100,8.5,0,100,3,4,21,21,0,RB
1179,Danny Vitale,0,1,1,2018,25,GNB,5,0,0,0,,0,0,0,,2,1,2,2,0,0.4,50,1,1,50,1,0,2,2,0,RB
1180,Mark Walton,14,5,19,2018,21,CIN,14,0,14,34,2.4,0,2.4,5,35.7,8,5,41,8.2,0,2.9,62.5,5.1,1,12.5,19,34,75,75,0,RB
1181,Spencer Ware,51,20,71,2018,27,KAN,13,2,51,246,4.8,2,18.9,14,43.1,23,20,224,11.2,0,17.2,87,9.7,9,56.5,71,246,470,480,10,RB
1182,DeAndre Washington,30,1,31,2018,25,OAK,10,0,30,115,3.8,0,11.5,8,56.7,1,1,9,9,0,0.9,100,9,0,100,31,115,124,124,0,RB
1183,Dwayne Washington,27,0,27,2018,24,NOR,13,0,27,154,5.7,0,11.8,7,44.4,0,0,0,,0,0,,,0,,27,154,154,154,0,RB
1184,Derek Watt,4,1,5,2018,26,LAC,16,5,4,11,2.8,0,0.7,1,50,1,1,2,2,0,0.1,100,2,0,0,5,11,13,13,0,FB
1185,Charcandrick West,2,2,4,2018,27,KAN,3,0,2,-1,-0.5,0,-0.3,1,50,3,2,37,18.5,1,12.3,66.7,12.3,2,66.7,4,-1,36,36,0,RB
1186,James White,94,87,181,2018,26,NWE,16,3,94,425,4.5,5,26.6,22,44.7,123,87,751,8.6,7,46.9,70.7,6.1,38,52.8,181,425,1176,1176,0,RB
1187,Brandon Wilds,6,0,6,2018,25,JAX,3,0,6,15,2.5,0,5,0,33.3,0,0,0,,0,0,,,0,,6,15,15,15,0,RB
1188,Jordan Wilkins,60,16,76,2018,24,IND,16,3,60,336,5.6,1,21,15,56.7,17,16,85,5.3,0,5.3,94.1,5,2,64.7,76,336,421,428,7,RB
1189,David Williams,8,0,8,2018,24,JAX,6,0,8,36,4.5,0,6,3,37.5,0,0,0,,0,0,,,0,,8,36,36,36,0,RB
1190,Damien Williams,50,23,73,2018,26,KAN,16,3,50,256,5.1,4,16,15,62,24,23,160,7,2,10,95.8,6.7,9,66.7,73,256,416,416,0,RB
1191,Darrel Williams,13,3,16,2018,23,KAN,6,0,13,44,3.4,0,7.3,3,53.8,3,3,27,9,1,4.5,100,9,1,66.7,16,44,71,71,0,RB
1192,Jamaal Williams,121,27,148,2018,23,GNB,16,8,121,464,3.8,3,29,25,47.9,41,27,210,7.8,0,13.1,65.9,5.1,11,48.8,148,464,674,769,95,RB
1193,Jonathan Williams,3,1,4,2018,24,NOR,3,0,3,0,0,0,0,0,0,1,1,1,1,0,0.3,100,1,0,0,4,0,1,1,0,RB
1194,Brandon Wilson,0,0,0,2018,24,CIN,16,0,0,0,,0,0,0,,0,0,0,,0,0,,,0,,0,0,0,-3,-3,RB
1195,Jeff Wilson,66,12,78,2018,23,SFO,6,2,66,266,4,0,44.3,13,50,15,12,98,8.2,0,16.3,80,6.5,5,53.3,78,266,364,364,0,RB
1196,Shaun Wilson,6,3,9,2018,23,TAM,5,0,6,29,4.8,0,5.8,0,50,5,3,5,1.7,0,1,60,1,0,0,9,29,34,156,122,RB
1197,T.J. Yeldon,104,55,159,2018,25,JAX,14,5,104,414,4,1,29.6,16,44.2,78,55,487,8.9,4,34.8,70.5,6.2,20,46.2,159,414,901,901,0,RB
1198,Zach Zenner,55,7,62,2018,27,DET,8,1,55,265,4.8,3,33.1,14,54.5,10,7,56,8,0,7,70,5.6,3,50,62,265,321,321,0,RB
1199,Ameer Abdullah,165,25,190,2017,24,DET,14,11,165,552,3.3,4,39.4,26,32.7,35,25,162,6.5,1,11.6,71.4,4.6,13,42.9,190,552,714,893,179,RB
1200,Jay Ajayi,208,24,232,2017,24,"MIA,PHI",14,8,208,873,4.2,1,62.4,45,41.8,34,24,158,6.6,1,11.3,70.6,4.6,8,32.4,232,873,1031,1031,0,RB
1201,Javorius Allen,153,46,199,2017,26,BAL,16,0,153,591,3.9,4,36.9,39,43.8,60,46,250,5.4,2,15.6,76.7,4.2,16,38.3,199,591,841,841,0,RB
1202,C.J. Anderson,245,28,273,2017,26,DEN,16,16,245,1007,4.1,3,62.9,47,40.4,40,28,224,8,1,14,70,5.6,7,30,273,1007,1231,1231,0,RB
1203,Alex Armah,0,0,0,2017,23,CAR,9,0,0,0,,0,0,0,,0,0,0,,0,0,,,0,,0,0,0,0,0,FB
1204,Cameron Artis-Payne,18,1,19,2017,27,CAR,13,0,18,95,5.3,1,7.3,5,38.9,1,1,2,2,0,0.2,100,2,0,0,19,95,97,97,0,RB
1205,Joe Banyard,0,0,0,2017,29,BUF,3,0,0,0,,0,0,0,,0,0,0,,0,0,,,0,,0,0,0,0,0,RB
1206,Peyton Barber,108,16,124,2017,23,TAM,16,4,108,423,3.9,3,26.4,25,56.5,19,16,114,7.1,0,7.1,84.2,6,4,42.1,124,423,537,537,0,RB
1207,Kenjon Barner,16,5,21,2017,28,PHI,13,1,16,57,3.6,1,4.4,3,31.3,8,5,56,11.2,0,4.3,62.5,7,1,25,21,57,113,547,434,RB
1208,Le'Veon Bell,321,85,406,2017,25,PIT,15,15,321,1291,4,9,86.1,71,45.5,106,85,655,7.7,2,43.7,80.2,6.2,32,56.6,406,1291,1946,1946,0,RB
1209,Giovani Bernard,105,43,148,2017,26,CIN,16,2,105,458,4.4,2,28.6,21,41.9,60,43,389,9,2,24.3,71.7,6.5,17,35,148,458,847,854,7,RB
1210,Kapri Bibbs,21,14,35,2017,24,WAS,3,0,21,79,3.8,0,26.3,4,38.1,17,14,128,9.1,1,42.7,82.4,7.5,4,41.2,35,79,207,224,17,RB
1211,LeGarrette Blount,173,8,181,2017,31,PHI,16,11,173,766,4.4,2,47.9,33,39.3,8,8,50,6.3,1,3.1,100,6.3,3,50,181,766,816,816,0,RB
1212,Alfred Blue,71,7,78,2017,26,HOU,11,0,71,262,3.7,1,23.8,10,45.1,9,7,54,7.7,0,4.9,77.8,6,4,55.6,78,262,316,316,0,RB
1213,Tommy Bohanon,5,6,11,2017,27,JAX,16,10,5,5,1,2,0.3,2,40,11,6,43,7.2,1,2.7,54.5,3.9,3,45.5,11,5,48,62,14,FB
1214,Brandon Bolden,13,1,14,2017,27,NWE,16,0,13,67,5.2,0,4.2,3,46.2,4,1,7,7,0,0.4,25,1.8,1,25,14,67,74,74,0,RB
1215,Devontae Booker,79,30,109,2017,25,DEN,13,0,79,299,3.8,1,23,13,48.1,38,30,275,9.2,0,21.2,78.9,7.2,13,44.7,109,299,574,850,276,RB
1216,Matt Breida,105,21,126,2017,22,SFO,16,0,105,465,4.4,2,29.1,23,45.7,36,21,180,8.6,1,11.3,58.3,5,9,38.9,126,465,645,728,83,RB
1217,Malcolm Brown,63,9,72,2017,24,LAR,11,1,63,246,3.9,1,22.4,10,31.7,11,9,53,5.9,0,4.8,81.8,4.8,3,45.5,72,246,299,299,0,RB
1218,Rex Burkhead,64,30,94,2017,27,NWE,10,3,64,264,4.1,5,26.4,14,51.6,36,30,254,8.5,3,25.4,83.3,7.1,13,58.3,94,264,518,535,17,RB
1219,Michael Burton,4,2,6,2017,25,CHI,16,3,4,9,2.3,0,0.6,2,50,4,2,8,4,0,0.5,50,2,0,25,6,9,17,17,0,RB
1220,Travaris Cadet,23,16,39,2017,28,"BUF,NYJ",9,0,23,96,4.2,0,10.7,6,43.5,19,16,119,7.4,0,13.2,84.2,6.3,3,47.4,39,96,215,215,0,RB
1221,Chris Carson,49,7,56,2017,23,SEA,4,3,49,208,4.2,0,52,13,40.8,8,7,59,8.4,1,14.8,87.5,7.4,3,75,56,208,267,267,0,RB
1222,Jamaal Charles,69,23,92,2017,31,DEN,14,0,69,296,4.3,1,21.1,17,50.7,28,23,129,5.6,0,9.2,82.1,4.6,6,28.6,92,296,425,425,0,RB
1223,Corey Clement,74,10,84,2017,23,PHI,16,0,74,321,4.3,4,20.1,19,48.6,15,10,123,12.3,2,7.7,66.7,8.2,6,53.3,84,321,444,493,49,RB
1224,Tarik Cohen,87,53,140,2017,22,CHI,16,4,87,370,4.3,2,23.1,19,47.1,71,53,353,6.7,1,22.1,74.6,5,9,29.6,140,391,723,1578,855,RB
1225,Derrick Coleman,2,2,4,2017,27,ATL,16,7,2,8,4,0,0.5,0,0,7,2,20,10,0,1.3,28.6,2.9,1,28.6,4,8,28,28,0,FB
1226,Tevin Coleman,156,27,183,2017,24,ATL,15,3,156,628,4,5,41.9,27,39.1,39,27,299,11.1,3,19.9,69.2,7.7,13,48.7,183,628,927,927,0,RB
1227,Alex Collins,212,23,235,2017,23,BAL,15,12,212,973,4.6,6,64.9,53,50.5,36,23,187,8.1,0,12.5,63.9,5.2,8,30.6,235,973,1160,1210,50,RB
1228,James Conner,32,0,32,2017,22,PIT,14,0,32,144,4.5,0,10.3,4,50,1,0,0,,0,0,0,0,0,0,32,144,144,144,0,RB
1229,Dalvin Cook,74,11,85,2017,22,MIN,4,4,74,354,4.8,2,88.5,16,51.4,16,11,90,8.2,0,22.5,68.8,5.6,3,43.8,85,354,444,444,0,RB
1230,Isaiah Crowell,206,28,234,2017,24,CLE,16,16,206,853,4.1,2,53.3,39,40.3,42,28,182,6.5,0,11.4,66.7,4.3,9,28.6,234,853,1035,1035,0,RB
1231,Benny Cunningham,9,20,29,2017,27,CHI,14,0,9,29,3.2,0,2.1,1,22.2,26,20,240,12,2,17.1,76.9,9.2,9,50,29,29,269,416,147,RB
1232,LeShun Daniels,3,0,3,2017,22,WAS,4,0,3,14,4.7,0,3.5,0,66.7,0,0,0,,0,0,,,0,,3,14,14,14,0,RB
1233,Orleans Darkwa,171,19,190,2017,25,NYG,15,11,171,751,4.4,5,50.1,35,42.7,28,19,116,6.1,0,7.7,67.9,4.1,7,46.4,190,751,867,867,0,RB
1234,Justin Davis,1,0,1,2017,22,LAR,4,0,1,1,1,0,0.3,0,0,0,0,0,,0,0,,,0,,1,1,1,1,0,RB
1235,Mike Davis,68,15,83,2017,24,SEA,6,6,68,240,3.5,0,40,11,27.9,18,15,131,8.7,0,21.8,83.3,7.3,6,50,83,240,371,371,0,RB
1236,Matthew Dayes,5,4,9,2017,23,CLE,16,0,5,13,2.6,0,0.8,1,20,5,4,29,7.3,0,1.8,80,5.8,1,40,9,13,42,479,437,RB
1237,James Develin,0,6,6,2017,29,NWE,16,7,0,0,,0,0,0,,10,6,38,6.3,0,2.4,60,3.8,3,50,6,0,38,38,0,FB
1238,Patrick DiMarco,2,7,9,2017,28,BUF,16,9,2,-2,-1,0,-0.1,0,0,10,7,28,4,0,1.8,70,2.8,1,60,9,-2,26,50,24,FB
1239,Kenyan Drake,133,32,165,2017,23,MIA,16,6,133,644,4.8,3,40.3,26,45.1,48,32,239,7.5,1,14.9,66.7,5,7,33.3,165,644,883,1030,147,RB
1240,Lance Dunbar,11,1,12,2017,27,LAR,4,0,11,51,4.6,1,12.8,4,54.5,3,1,1,1,0,0.3,33.3,0.3,0,0,12,51,52,52,0,RB
1241,Trey Edmunds,9,0,9,2017,23,NOR,16,0,9,48,5.3,1,3,1,22.2,0,0,0,,0,0,,,0,,9,48,48,113,65,RB
1242,Austin Ekeler,47,27,74,2017,22,LAC,16,0,47,260,5.5,2,16.3,13,55.3,35,27,279,10.3,3,17.4,77.1,8,12,48.6,74,260,539,624,85,RB
1243,Andre Ellington,20,39,59,2017,28,"ARI,HOU",12,2,20,55,2.8,1,4.6,3,40,59,39,369,9.5,0,30.8,66.1,6.3,16,47.5,59,55,424,424,0,RB
1244,Ezekiel Elliott,242,26,268,2017,22,DAL,10,10,242,983,4.1,7,98.3,57,54.1,38,26,269,10.3,2,26.9,68.4,7.1,6,23.7,268,983,1252,1252,0,RB
1245,Tyler Ervin,4,8,12,2017,24,HOU,4,0,4,12,3,0,3,1,75,11,8,38,4.8,0,9.5,72.7,3.5,1,36.4,12,12,50,203,153,RB
1246,Josh Ferguson,1,3,4,2017,24,IND,10,0,1,5,5,0,0.5,0,100,4,3,16,5.3,0,1.6,75,4,0,50,4,5,21,107,86,RB
1247,David Fluellen,4,0,4,2017,25,TEN,16,0,4,21,5.3,0,1.3,1,75,1,0,0,,0,0,0,0,0,0,4,21,21,21,0,RB
1248,D'Onta Foreman,78,6,84,2017,21,HOU,10,1,78,327,4.2,2,32.7,13,39.7,8,6,83,13.8,0,8.3,75,10.4,4,62.5,84,327,410,422,12,RB
1249,Matt Forte,103,37,140,2017,32,NYJ,12,4,103,381,3.7,2,31.8,13,40.8,45,37,293,7.9,1,24.4,82.2,6.5,14,46.7,140,381,674,674,0,RB
1250,Leonard Fournette,268,36,304,2017,22,JAX,13,13,268,1040,3.9,9,80,51,43.3,48,36,302,8.4,1,23.2,75,6.3,18,56.3,304,1040,1342,1342,0,RB
1251,Jalston Fowler,2,0,2,2017,27,TEN,10,1,2,4,2,1,0.4,1,50,1,0,0,,0,0,0,0,0,0,2,4,4,4,0,RB
1252,Devonta Freeman,196,36,232,2017,25,ATL,14,14,196,865,4.4,7,61.8,55,49.5,47,36,317,8.8,1,22.6,76.6,6.7,18,57.4,232,865,1182,1182,0,RB
1253,Wayne Gallman,111,34,145,2017,23,NYG,13,1,111,476,4.3,0,36.6,24,51.4,48,34,193,5.7,1,14.8,70.8,4,8,43.8,145,476,669,669,0,RB
1254,Mike Gillislee,104,1,105,2017,27,NWE,9,2,104,383,3.7,5,42.6,25,54.8,1,1,15,15,0,1.7,100,15,1,100,105,383,398,398,0,RB
1255,Melvin Gordon,284,58,342,2017,24,LAC,16,16,284,1105,3.9,8,69.1,61,39.8,83,58,476,8.2,4,29.8,69.9,5.7,22,39.8,342,1105,1581,1581,0,RB
1256,Frank Gore,261,29,290,2017,34,IND,16,16,261,961,3.7,3,60.1,49,42.9,38,29,245,8.4,1,15.3,76.3,6.4,9,42.1,290,961,1206,1198,0,RB
1257,Corey Grant,30,3,33,2017,26,JAX,16,0,30,248,8.3,2,15.5,10,60,4,3,41,13.7,0,2.6,75,10.3,2,50,33,248,289,768,479,RB
1258,Tion Green,42,2,44,2017,24,DET,5,0,42,165,3.9,2,33,9,42.9,2,2,14,7,0,2.8,100,7,0,100,44,165,179,179,0,RB
1259,Todd Gurley,279,64,343,2017,23,LAR,15,15,279,1305,4.7,13,87,69,50.5,87,64,788,12.3,6,52.5,73.6,9.1,32,51.7,343,1305,2093,2093,0,RB
1260,C.J. Ham,7,7,14,2017,24,MIN,16,1,7,13,1.9,1,0.8,5,71.4,8,7,68,9.7,0,4.3,87.5,8.5,3,62.5,14,13,81,81,0,RB
1261,De'Angelo Henderson,7,2,9,2017,25,DEN,5,0,7,13,1.9,0,2.6,2,28.6,2,2,36,18,1,7.2,100,18,1,50,9,13,49,108,59,RB
1262,Derrick Henry,176,11,187,2017,23,TEN,16,2,176,744,4.2,5,46.5,40,45.5,17,11,136,12.4,1,8.5,64.7,8,4,41.2,187,744,880,880,0,RB
1263,Bronson Hill,1,0,1,2017,24,ARI,2,0,1,-2,-2,0,-1,0,0,0,0,0,,0,0,,,0,,1,-2,-2,-2,0,RB
1264,Brian Hill,11,2,13,2017,22,"ATL,CIN",7,0,11,37,3.4,0,5.3,2,45.5,2,2,36,18,0,5.1,100,18,1,50,13,37,73,73,0,RB
1265,Jeremy Hill,37,4,41,2017,25,CIN,7,7,37,116,3.1,0,16.6,6,37.8,4,4,16,4,0,2.3,100,4,1,50,41,116,132,132,0,RB
1266,Elijah Hood,0,0,0,2017,21,OAK,1,0,0,0,,0,0,0,,0,0,0,,0,0,,,0,,0,0,0,0,0,RB
1267,Jordan Howard,276,23,299,2017,23,CHI,16,16,276,1122,4.1,9,70.1,65,42.4,32,23,125,5.4,0,7.8,71.9,3.9,4,21.9,299,1122,1247,1247,0,RB
1268,Akeem Hunt,8,4,12,2017,24,KAN,15,0,8,23,2.9,0,1.5,1,25,7,4,31,7.8,0,2.1,57.1,4.4,1,14.3,12,23,54,665,611,RB
1269,Kareem Hunt,272,53,325,2017,22,KAN,16,16,272,1327,4.9,8,82.9,63,43.8,63,53,455,8.6,3,28.4,84.1,7.2,17,49.2,325,1327,1782,1782,0,RB
1270,Carlos Hyde,240,59,299,2017,27,SFO,16,16,240,938,3.9,8,58.6,48,43.8,88,59,350,5.9,0,21.9,67,4,18,38.6,299,938,1288,1288,0,RB
1271,Mark Ingram,230,58,288,2017,28,NOR,16,12,230,1124,4.9,12,70.3,52,47.4,71,58,416,7.2,0,26,81.7,5.9,19,45.1,288,1124,1540,1540,0,RB
1272,Chris Ivory,112,21,133,2017,29,JAX,14,3,112,382,3.4,1,27.3,18,36.6,28,21,175,8.3,1,12.5,75,6.3,8,32.1,133,382,557,557,0,RB
1273,Andy Janovich,6,4,10,2017,24,DEN,16,4,6,12,2,1,0.8,3,66.7,6,4,35,8.8,0,2.2,66.7,5.8,2,66.7,10,12,47,57,10,RB
1274,Chris Johnson,45,5,50,2017,32,ARI,4,3,45,114,2.5,0,28.5,5,31.1,6,5,43,8.6,0,10.8,83.3,7.2,3,83.3,50,114,157,157,0,RB
1275,David Johnson,11,6,17,2017,26,ARI,1,1,11,23,2.1,0,23,0,18.2,9,6,67,11.2,0,67,66.7,7.4,3,55.6,17,23,90,90,0,RB
1276,Duke Johnson,82,74,156,2017,24,CLE,16,0,82,348,4.2,4,21.8,27,53.7,93,74,693,9.4,3,43.3,79.6,7.5,32,49.5,156,348,1041,1058,17,RB
1277,Aaron Jones,81,9,90,2017,23,GNB,12,4,81,448,5.5,4,37.3,23,53.1,18,9,22,2.4,0,1.8,50,1.2,2,11.1,90,448,470,470,0,RB
1278,Matt Jones,5,0,5,2017,24,IND,5,0,5,14,2.8,0,2.8,1,40,0,0,0,,0,0,,,0,,5,14,14,14,0,RB
1279,Taiwan Jones,0,1,1,2017,29,BUF,8,0,0,0,,0,0,0,,2,1,11,11,0,1.4,50,5.5,1,50,1,0,11,61,50,RB
1280,Kyle Juszczyk,7,33,40,2017,26,SFO,14,10,7,31,4.4,0,2.2,4,57.1,42,33,315,9.5,1,22.5,78.6,7.5,13,57.1,40,31,346,346,0,FB
1281,Alvin Kamara,120,81,201,2017,22,NOR,16,3,120,728,6.1,8,45.5,42,50.8,100,81,826,10.2,5,51.6,81,8.3,38,56,201,728,1554,1901,347,RB
1282,Robert Kelley,62,4,66,2017,25,WAS,7,7,62,194,3.1,3,27.7,7,48.4,7,4,18,4.5,0,2.6,57.1,2.6,3,42.9,66,194,212,228,16,RB
1283,Joe Kerridge,0,1,1,2017,25,GNB,4,0,0,0,,0,0,0,,1,1,3,3,0,0.8,100,3,0,0,1,0,3,3,0,RB
1284,John Kuhn,1,0,1,2017,35,NOR,2,1,1,2,2,0,1,1,100,0,0,0,,0,0,,,0,,1,2,2,11,9,FB
1285,Eddie Lacy,69,6,75,2017,27,SEA,9,3,69,179,2.6,0,19.9,7,29,6,6,47,7.8,0,5.2,100,7.8,2,50,75,179,226,226,0,RB
1286,Daniel Lasco,0,0,0,2017,25,NOR,3,0,0,0,,0,0,0,,0,0,0,,0,0,,,0,,0,0,0,0,0,RB
1287,Dion Lewis,180,32,212,2017,27,NWE,16,8,180,896,5,6,56,49,54.4,35,32,214,6.7,3,13.4,91.4,6.1,11,60,212,896,1110,1680,570,RB
1288,Zach Line,7,2,9,2017,27,NOR,12,4,7,28,4,0,2.3,5,100,5,2,8,4,1,0.7,40,1.6,1,20,9,28,36,36,0,RB
1289,Marshawn Lynch,207,20,227,2017,31,OAK,15,15,207,891,4.3,7,59.4,45,47.8,31,20,151,7.6,0,10.1,64.5,4.9,6,35.5,227,891,1042,1042,0,RB
1290,Marlon Mack,93,21,114,2017,21,IND,14,0,93,358,3.8,3,25.6,20,40.9,33,21,225,10.7,1,16.1,63.6,6.8,10,45.5,114,358,583,652,69,RB
1291,Tre Madden,0,2,2,2017,24,SEA,8,3,0,0,,0,0,0,,2,2,65,32.5,0,8.1,100,32.5,1,50,2,0,65,65,0,RB
1292,Terrence Magee,0,0,0,2017,24,ATL,2,0,0,0,,0,0,0,,0,0,0,,0,0,,,0,,0,0,0,0,0,RB
1293,Byron Marshall,9,6,15,2017,23,WAS,4,0,9,32,3.6,0,8,1,44.4,8,6,36,6,0,9,75,4.5,1,0,15,32,68,157,89,RB
1294,Doug Martin,138,9,147,2017,28,TAM,11,8,138,406,2.9,3,36.9,22,34.8,18,9,84,9.3,0,7.6,50,4.7,6,38.9,147,406,490,490,0,RB
1295,Devante Mays,4,3,7,2017,23,GNB,8,0,4,1,0.3,0,0.1,0,0,3,3,0,0,0,0,100,0,0,0,7,1,1,1,0,RB
1296,Christian McCaffrey,117,80,197,2017,21,CAR,16,10,117,435,3.7,2,27.2,22,45.3,113,80,651,8.1,5,40.7,70.8,5.8,37,50.4,197,435,1086,1306,220,RB
1297,LeSean McCoy,287,59,346,2017,29,BUF,16,16,287,1138,4,6,71.1,57,42.2,77,59,448,7.6,2,28,76.6,5.8,23,42.9,346,1138,1586,1586,0,RB
1298,Darren McFadden,1,0,1,2017,30,DAL,1,0,1,-2,-2,0,-2,0,0,0,0,0,,0,0,,,0,,1,-2,-2,-2,0,RB
1299,Elijah McGuire,88,17,105,2017,23,NYJ,16,2,88,315,3.6,1,19.7,14,30.7,26,17,177,10.4,1,11.1,65.4,6.8,10,42.3,105,315,492,585,93,RB
1300,J.D. McKissic,46,34,80,2017,24,SEA,13,1,46,187,4.1,1,14.4,7,52.2,46,34,266,7.8,2,20.5,73.9,5.8,14,52.2,80,187,453,453,0,RB
1301,Jerick McKinnon,150,51,201,2017,25,MIN,16,1,150,570,3.8,3,35.6,24,40,68,51,421,8.3,2,26.3,75,6.2,20,44.1,201,570,991,1303,312,RB
1302,Jeremy McNichols,0,0,0,2017,22,SFO,2,0,0,0,,0,0,0,,0,0,0,,0,0,,,0,,0,0,0,0,0,RB
1303,Lamar Miller,238,36,274,2017,26,HOU,16,13,238,888,3.7,3,55.5,45,43.7,45,36,327,9.1,3,20.4,80,7.3,18,55.6,274,888,1215,1215,0,RB
1304,Joe Mixon,178,30,208,2017,21,CIN,14,7,178,626,3.5,4,44.7,39,41,34,30,287,9.6,0,20.5,88.2,8.4,10,55.9,208,626,913,913,0,RB
1305,Taquan Mizzell,0,0,0,2017,24,CHI,3,0,0,0,,0,0,0,,0,0,0,,0,0,,,0,,0,0,0,0,0,RB
1306,Ty Montgomery,71,23,94,2017,24,GNB,8,5,71,273,3.8,3,34.1,13,50.7,31,23,173,7.5,1,21.6,74.2,5.6,8,45.2,94,273,446,446,0,RB
1307,Alfred Morris,115,7,122,2017,29,DAL,14,5,115,547,4.8,1,39.1,25,50.4,9,7,45,6.4,0,3.2,77.8,5,1,44.4,122,547,592,592,0,RB
1308,Raheem Mostert,6,0,6,2017,25,SFO,11,0,6,30,5,0,2.7,1,50,0,0,0,,0,0,,,0,,6,30,30,113,83,RB
1309,Marcus Murphy,7,2,9,2017,26,BUF,1,0,7,41,5.9,0,41,2,42.9,2,2,7,3.5,0,7,100,3.5,1,50,9,41,48,66,18,RB
1310,DeMarco Murray,184,39,223,2017,29,TEN,15,15,184,659,3.6,6,43.9,33,37,47,39,266,6.8,1,17.7,83,5.7,11,44.7,223,659,925,925,0,RB
1311,Latavius Murray,216,15,231,2017,27,MIN,16,11,216,842,3.9,8,52.6,43,43.1,17,15,103,6.9,0,6.4,88.2,6.1,4,52.9,231,842,945,945,0,RB
1312,Roosevelt Nix,3,2,5,2017,25,PIT,16,4,3,0,0,1,0,1,33.3,3,2,6,3,1,0.4,66.7,2,1,33.3,5,0,6,6,0,RB
1313,Dare Ogunbowale,0,0,0,2017,23,WAS,2,0,0,0,,0,0,0,,0,0,0,,0,0,,,0,,0,0,0,0,0,RB
1314,Jamize Olawale,9,6,15,2017,28,OAK,12,0,9,43,4.8,1,3.6,5,77.8,7,6,33,5.5,0,2.8,85.7,4.7,1,85.7,15,43,76,85,9,FB
1315,Branden Oliver,35,6,41,2017,26,LAC,8,0,35,83,2.4,0,10.4,6,31.4,11,6,26,4.3,0,3.3,54.5,2.4,2,18.2,41,83,109,109,0,RB
1316,Elijhaa Penny,31,4,35,2017,24,ARI,16,0,31,124,4,2,7.8,7,61.3,6,4,38,9.5,0,2.4,66.7,6.3,2,33.3,35,124,162,162,0,RB
1317,Samaje Perine,175,22,197,2017,22,WAS,16,8,175,603,3.4,1,37.7,23,41.1,24,22,182,8.3,1,11.4,91.7,7.6,9,75,197,603,785,833,48,RB
1318,Paul Perkins,41,8,49,2017,23,NYG,11,4,41,90,2.2,0,8.2,3,19.5,10,8,46,5.8,0,4.2,80,4.6,1,40,49,90,136,136,0,RB
1319,Senorise Perry,8,1,9,2017,26,MIA,16,0,8,30,3.8,0,1.9,2,50,1,1,3,3,0,0.2,100,3,0,0,9,30,33,237,202,RB
1320,Adrian Peterson,156,11,167,2017,32,"ARI,NOR",10,7,156,529,3.4,2,52.9,21,39.1,19,11,70,6.4,0,7,57.9,3.7,3,31.6,167,529,599,599,0,RB
1321,Bilal Powell,178,23,201,2017,29,NYJ,15,10,178,772,4.3,5,51.5,32,33.7,33,23,170,7.4,0,11.3,69.7,5.2,9,33.3,201,772,942,942,0,RB
1322,C.J. Prosise,11,6,17,2017,23,SEA,5,0,11,23,2.1,0,4.6,1,36.4,11,6,87,14.5,0,17.4,54.5,7.9,3,36.4,17,23,110,110,0,RB
1323,Jay Prosch,0,4,4,2017,25,HOU,16,5,0,0,,0,0,0,,4,4,31,7.8,0,1.9,100,7.8,1,50,4,0,31,31,0,FB
1324,Bobby Rainey,1,5,6,2017,30,BAL,4,0,1,2,2,0,0.5,0,0,7,5,18,3.6,0,4.5,71.4,2.6,2,14.3,6,2,20,380,360,RB
1325,Thomas Rawls,58,9,67,2017,24,SEA,12,3,58,157,2.7,0,13.1,6,32.8,13,9,94,10.4,0,7.8,69.2,7.2,4,53.8,67,157,251,251,0,RB
1326,Patrick Ricard,0,4,4,2017,23,BAL,16,0,0,0,,0,0,0,,4,4,12,3,2,0.8,100,3,2,50,4,0,12,12,0,DT/FB
1327,Jalen Richard,56,27,83,2017,24,OAK,16,1,56,275,4.9,1,17.2,10,35.7,36,27,256,9.5,1,16,75,7.1,13,52.8,83,275,531,776,245,RB
1328,Theo Riddick,84,53,137,2017,26,DET,16,5,84,286,3.4,3,17.9,12,39.3,71,53,444,8.4,2,27.8,74.6,6.3,20,42.3,137,286,730,730,0,RB
1329,Stevan Ridley,26,0,26,2017,28,PIT,2,1,26,108,4.2,1,54,6,38.5,0,0,0,,0,0,,,0,,26,108,108,108,0,RB
1330,Aaron Ripkowski,5,7,12,2017,25,GNB,16,2,5,13,2.6,0,0.8,0,0,10,7,39,5.6,0,2.4,70,3.9,1,50,12,13,52,52,0,RB
1331,Jacquizz Rodgers,64,9,73,2017,27,TAM,16,4,64,244,3.8,1,15.3,11,40.6,11,9,74,8.2,0,4.6,81.8,6.7,4,54.5,73,244,318,573,255,RB
1332,Adam Shaheen,0,12,12,2017,23,CHI,13,7,0,0,,0,0,0,,14,12,127,10.6,3,9.8,85.7,9.1,8,71.4,12,0,127,127,0,FB
1333,Anthony Sherman,14,6,20,2017,29,KAN,16,3,14,40,2.9,1,2.5,5,42.9,8,6,47,7.8,0,2.9,75,5.9,4,50,20,40,87,94,7,RB
1334,Charles Sims,21,35,56,2017,27,TAM,16,0,21,95,4.5,0,5.9,6,33.3,47,35,249,7.1,1,15.6,74.5,5.3,13,42.6,56,95,344,376,32,RB
1335,Wendell Smallwood,47,13,60,2017,23,PHI,8,3,47,174,3.7,1,21.8,10,31.9,18,13,103,7.9,0,12.9,72.2,5.7,6,50,60,174,277,370,93,RB
1336,De'Veon Smith,0,3,3,2017,23,MIA,5,0,0,0,,0,0,0,,3,3,27,9,0,5.4,100,9,1,66.7,3,0,27,27,0,RB
1337,Rod Smith,55,19,74,2017,25,DAL,15,1,55,232,4.2,4,15.5,16,56.4,23,19,202,10.6,1,13.5,82.6,8.8,9,47.8,74,232,434,454,20,RB
1338,Shane Smith,0,0,0,2017,24,NYG,11,4,0,0,,0,0,0,,0,0,0,,0,0,,,0,,0,0,0,0,0,FB
1339,C.J. Spiller,2,0,2,2017,30,KAN,1,0,2,0,0,0,0,0,0,2,0,0,,0,0,0,0,0,0,2,0,0,0,0,RB
1340,Darren Sproles,15,7,22,2017,34,PHI,3,0,15,61,4.1,0,20.3,4,40,12,7,73,10.4,0,24.3,58.3,6.1,4,41.7,22,61,134,144,10,RB
1341,Jonathan Stewart,198,8,206,2017,30,CAR,15,10,198,680,3.4,6,45.3,42,42.4,15,8,52,6.5,1,3.5,53.3,3.5,2,33.3,206,680,732,732,0,RB
1342,Chris Thompson,64,39,103,2017,27,WAS,10,1,64,294,4.6,2,29.4,11,40.6,54,39,510,13.1,4,51,72.2,9.4,22,55.6,103,294,804,967,165,RB
1343,De'Anthony Thomas,1,14,15,2017,24,KAN,16,2,1,4,4,0,0.3,0,0,16,14,143,10.2,2,8.9,87.5,8.9,4,37.5,15,4,147,468,321,RB
1344,Jordan Todman,0,0,0,2017,27,HOU,14,0,0,0,,0,0,0,,0,0,0,,0,0,,,0,,0,0,0,84,84,RB
1345,Mike Tolbert,66,14,80,2017,32,BUF,12,0,66,247,3.7,1,20.6,9,36.4,17,14,78,5.6,0,6.5,82.4,4.6,2,29.4,80,247,325,325,0,RB
1346,Fitzgerald Toussaint,6,2,8,2017,27,PIT,6,0,6,25,4.2,0,4.2,2,66.7,3,2,9,4.5,0,1.5,66.7,3,1,33.3,8,25,34,128,94,RB
1347,Robert Turbin,23,9,32,2017,28,IND,6,1,23,53,2.3,1,8.8,9,56.5,11,9,56,6.2,0,9.3,81.8,5.1,3,36.4,32,53,109,109,0,RB
1348,Shane Vereen,45,44,89,2017,28,NYG,16,0,45,164,3.6,0,10.3,3,42.2,53,44,253,5.8,0,15.8,83,4.8,9,45.3,89,164,417,613,196,RB
1349,Danny Vitale,0,3,3,2017,24,CLE,15,6,0,0,,0,0,0,,5,3,19,6.3,0,1.3,60,3.8,1,20,3,0,19,37,18,FB
1350,Terron Ward,30,3,33,2017,25,ATL,14,0,30,129,4.3,0,9.2,7,40,3,3,14,4.7,0,1,100,4.7,1,33.3,33,129,143,143,0,RB
1351,DeAndre Washington,57,34,91,2017,24,OAK,15,0,57,153,2.7,2,10.2,10,40.4,45,34,197,5.8,1,13.1,75.6,4.4,15,42.2,91,153,350,436,86,RB
1352,Dwayne Washington,20,2,22,2017,23,DET,5,0,20,44,2.2,0,8.8,1,35,2,2,14,7,0,2.8,100,7,1,50,22,44,58,89,31,RB
1353,Terrell Watson,5,0,5,2017,24,PIT,10,0,5,8,1.6,0,0.8,3,60,0,0,0,,0,0,,,0,,5,8,8,148,140,RB
1354,Derek Watt,6,2,8,2017,25,LAC,16,4,6,24,4,0,1.5,2,33.3,3,2,35,17.5,0,2.2,66.7,11.7,2,66.7,8,24,59,59,0,FB
1355,Charcandrick West,18,27,45,2017,26,KAN,13,0,18,72,4,2,5.5,4,27.8,34,27,150,5.6,2,11.5,79.4,4.4,7,32.4,45,72,222,259,37,RB
1356,Terrance West,39,2,41,2017,26,BAL,5,4,39,138,3.5,2,27.6,12,51.3,4,2,23,11.5,0,4.6,50,5.8,2,50,41,138,161,161,0,RB
1357,Fozzy Whittaker,7,5,12,2017,28,CAR,12,0,7,18,2.6,0,1.5,2,57.1,6,5,47,9.4,1,3.9,83.3,7.8,1,66.7,12,18,65,175,110,RB
1358,James White,43,56,99,2017,25,NWE,14,4,43,171,4,0,12.2,6,48.8,72,56,429,7.7,3,30.6,77.8,6,25,48.6,99,171,600,600,0,RB
1359,Andre Williams,9,0,9,2017,25,LAC,8,0,9,25,2.8,0,3.1,0,33.3,0,0,0,,0,0,,,0,,9,25,25,25,0,RB
1360,Damien Williams,46,20,66,2017,25,MIA,11,4,46,181,3.9,0,16.5,7,28.3,28,20,155,7.8,1,14.1,71.4,5.5,13,57.1,66,181,336,329,-7,RB
1361,Jamaal Williams,153,25,178,2017,22,GNB,16,7,153,556,3.6,4,34.8,32,48.4,34,25,262,10.5,2,16.4,73.5,7.7,12,52.9,178,556,818,818,0,RB
1362,Jarveon Williams,0,0,0,2017,22,CIN,1,0,0,0,,0,0,0,,0,0,0,,0,0,,,0,,0,0,0,0,0,RB
1363,Kerwynn Williams,120,10,130,2017,26,ARI,16,6,120,426,3.6,1,26.6,21,43.3,15,10,93,9.3,0,5.8,66.7,6.2,6,46.7,130,426,519,982,463,RB
1364,Marquez Williams,0,0,0,2017,23,CLE,1,0,0,0,,0,0,0,,1,0,0,,0,0,0,0,0,0,0,0,0,0,0,FB
1365,Brandon Wilson,0,0,0,2017,23,CIN,8,0,0,0,,0,0,0,,0,0,0,,0,0,,,0,,0,0,0,0,0,RB
1366,Danny Woodhead,14,33,47,2017,32,BAL,8,0,14,56,4,0,7,2,28.6,39,33,200,6.1,0,25,84.6,5.1,9,51.3,47,56,256,256,0,RB
1367,T.J. Yeldon,49,30,79,2017,24,JAX,10,0,49,253,5.2,2,25.3,7,42.9,41,30,224,7.5,0,22.4,73.2,5.5,14,43.9,79,253,477,477,0,RB
1368,Zach Zenner,14,0,14,2017,26,DET,8,0,14,26,1.9,1,3.3,3,21.4,1,0,0,,0,0,0,0,0,0,14,26,26,88,62,RB
1369,Ameer Abdullah,18,5,23,2016,23,DET,2,2,18,101,5.6,0,50.5,6,61.1,5,5,57,11.4,1,28.5,100,11.4,4,80,23,101,158,158,0,RB
1370,Jay Ajayi,260,27,287,2016,23,MIA,15,12,260,1272,4.9,8,84.8,63,42.7,35,27,151,5.6,0,10.1,77.1,4.3,8,45.7,287,1272,1423,1423,0,RB
1371,Javorius Allen,9,3,12,2016,25,BAL,8,0,9,34,3.8,0,4.3,0,55.6,4,3,15,5,0,1.9,75,3.8,2,50,12,34,49,49,0,RB
1372,C.J. Anderson,110,16,126,2016,25,DEN,7,7,110,437,4,4,62.4,23,37.3,24,16,128,8,1,18.3,66.7,5.3,6,41.7,126,437,565,565,0,RB
1373,Antonio Andrews,2,0,2,2016,24,TEN,16,0,2,15,7.5,0,0.9,0,50,0,0,0,,0,0,,,0,,2,15,15,52,37,RB
1374,Cameron Artis-Payne,36,1,37,2016,26,CAR,3,3,36,144,4,2,48,5,50,1,1,11,11,0,3.7,100,11,1,100,37,144,155,155,0,RB
1375,Matt Asiata,121,32,153,2016,29,MIN,16,6,121,402,3.3,6,25.1,28,46.3,38,32,263,8.2,0,16.4,84.2,6.9,9,44.7,153,402,665,676,11,RB
1376,George Atkinson,7,0,7,2016,24,CLE,16,0,7,34,4.9,1,2.1,3,57.1,0,0,0,,0,0,,,0,,7,34,34,171,137,RB
1377,Joe Banyard,2,0,2,2016,28,JAX,1,0,2,7,3.5,0,7,0,0,0,0,0,,0,0,,,0,,2,7,7,7,0,RB
1378,Peyton Barber,55,5,60,2016,22,TAM,15,1,55,223,4.1,1,14.9,10,41.8,6,5,28,5.6,0,1.9,83.3,4.7,1,66.7,60,223,251,251,0,RB
1379,Kenjon Barner,27,5,32,2016,27,PHI,13,0,27,129,4.8,2,9.9,9,51.9,11,5,42,8.4,0,3.2,45.5,3.8,3,27.3,32,129,171,470,299,RB
1380,Joique Bell,3,1,4,2016,30,"CHI,DET",7,0,3,6,2,0,0.9,0,33.3,1,1,-2,-2,0,-0.3,100,-2,0,0,4,6,4,4,0,RB
1381,Le'Veon Bell,261,75,336,2016,24,PIT,12,12,261,1268,4.9,7,105.7,70,53.3,94,75,616,8.2,2,51.3,79.8,6.6,32,58.5,336,1268,1884,1888,0,RB
1382,Giovani Bernard,91,39,130,2016,25,CIN,10,2,91,337,3.7,2,33.7,16,48.4,51,39,336,8.6,1,33.6,76.5,6.6,16,49,130,337,673,673,0,RB
1383,Kapri Bibbs,29,2,31,2016,23,DEN,12,0,29,129,4.4,0,10.8,7,51.7,4,2,75,37.5,1,6.3,50,18.8,1,50,31,129,204,283,79,RB
1384,LeGarrette Blount,299,7,306,2016,30,NWE,16,8,299,1161,3.9,18,72.6,68,42.5,8,7,38,5.4,0,2.4,87.5,4.8,1,50,306,1161,1199,1199,0,RB
1385,Alfred Blue,100,12,112,2016,25,HOU,14,2,100,420,4.2,1,30,23,46,16,12,40,3.3,0,2.9,75,2.5,1,37.5,112,420,460,460,0,RB
1386,Brandon Bolden,1,2,3,2016,26,NWE,14,0,1,4,4,0,0.3,0,100,4,2,15,7.5,0,1.1,50,3.8,1,25,3,4,19,19,0,RB
1387,Devontae Booker,174,31,205,2016,24,DEN,16,6,174,612,3.5,4,38.3,31,43.1,45,31,265,8.5,1,16.6,68.9,5.9,8,40,205,612,877,877,0,RB
1388,Malcolm Brown,18,3,21,2016,23,LAR,16,0,18,39,2.2,0,2.4,1,22.2,3,3,46,15.3,0,2.9,100,15.3,2,100,21,39,85,85,0,RB
1389,Brandon Burks,2,0,2,2016,23,NYJ,1,0,2,-4,-2,0,-4,0,0,0,0,0,,0,0,,,0,,2,-4,-4,-4,0,RB
1390,Rex Burkhead,74,17,91,2016,26,CIN,16,1,74,344,4.6,2,21.5,24,63.5,20,17,145,8.5,0,9.1,85,7.3,9,55,91,344,489,603,114,RB
1391,Michael Burton,0,0,0,2016,24,DET,15,0,0,0,,0,0,0,,1,0,0,,0,0,0,0,0,0,0,0,0,0,0,RB
1392,Reggie Bush,12,7,19,2016,31,BUF,13,0,12,-3,-0.3,1,-0.2,3,41.7,10,7,90,12.9,0,6.9,70,9,6,70,19,-3,87,203,116,RB
1393,Travaris Cadet,4,40,44,2016,27,NOR,15,1,4,19,4.8,0,1.3,1,50,54,40,281,7,4,18.7,74.1,5.2,18,53.7,44,19,300,444,144,RB
1394,Ka'Deem Carey,32,5,37,2016,24,CHI,12,0,32,126,3.9,0,10.5,4,37.5,7,5,55,11,0,4.6,71.4,7.9,4,57.1,37,126,181,219,38,RB
1395,Jamaal Charles,12,2,14,2016,30,KAN,3,0,12,40,3.3,1,13.3,3,41.7,3,2,14,7,0,4.7,66.7,4.7,1,33.3,14,40,54,54,0,RB
1396,Tevin Coleman,118,31,149,2016,23,ATL,13,0,118,520,4.4,8,40,25,43.2,40,31,421,13.6,3,32.4,77.5,10.5,16,45,149,520,941,941,0,RB
1397,Alex Collins,31,11,42,2016,22,SEA,11,0,31,125,4,1,11.4,8,38.7,11,11,84,7.6,0,7.6,100,7.6,6,81.8,42,125,209,209,0,RB
1398,Isaiah Crowell,198,40,238,2016,23,CLE,16,16,198,952,4.8,7,59.5,45,40.4,53,40,319,8,0,19.9,75.5,6,14,49.1,238,952,1271,1271,0,RB
1399,Benny Cunningham,21,16,37,2016,26,LAR,11,0,21,101,4.8,0,9.2,4,42.9,21,16,91,5.7,0,8.3,76.2,4.3,5,42.9,37,101,192,791,599,RB
1400,Orleans Darkwa,30,2,32,2016,24,NYG,10,2,30,111,3.7,2,11.1,7,40,4,2,12,6,0,1.2,50,3,0,25,32,111,123,123,0,RB
1401,Knile Davis,18,5,23,2016,25,"GNB,KAN",11,0,18,28,1.6,0,2.5,0,16.7,7,5,25,5,0,2.3,71.4,3.6,2,28.6,23,28,53,260,207,RB
1402,Mike Davis,19,3,22,2016,23,SFO,8,1,19,50,2.6,1,6.3,4,47.4,5,3,25,8.3,0,3.1,60,5,0,60,22,50,75,93,18,RB
1403,James Develin,0,3,3,2016,28,NWE,16,4,0,0,,0,0,0,,6,3,18,6,0,1.1,50,3,2,33.3,3,0,18,53,35,RB
1404,Patrick DiMarco,0,7,7,2016,27,ATL,16,8,0,0,,0,0,0,,10,7,52,7.4,1,3.3,70,5.2,3,30,7,0,52,66,14,RB
1405,Kenneth Dixon,88,30,118,2016,22,BAL,12,0,88,382,4.3,2,31.8,30,53.4,41,30,162,5.4,1,13.5,73.2,4,7,34.1,118,382,544,544,0,RB
1406,Kenyan Drake,33,9,42,2016,22,MIA,16,1,33,179,5.4,2,11.2,9,45.5,10,9,46,5.1,0,2.9,90,4.6,2,60,42,179,225,622,397,RB
1407,Shaun Draughn,74,29,103,2016,29,SFO,16,1,74,196,2.6,4,12.3,15,33.8,39,29,263,9.1,2,16.4,74.4,6.7,10,43.6,103,196,459,459,0,RB
1408,Lance Dunbar,9,16,25,2016,26,DAL,13,0,9,31,3.4,1,2.4,3,55.6,24,16,122,7.6,0,9.4,66.7,5.1,5,41.7,25,31,153,185,32,RB
1409,Andre Ellington,34,12,46,2016,27,ARI,16,0,34,96,2.8,0,6,4,32.4,19,12,85,7.1,0,5.3,63.2,4.5,5,26.3,46,96,181,344,163,RB
1410,Ezekiel Elliott,322,32,354,2016,21,DAL,15,15,322,1631,5.1,15,108.7,95,55.3,39,32,363,11.3,1,24.2,82.1,9.3,11,48.7,354,1631,1994,1987,0,RB
1411,Tyler Ervin,1,3,4,2016,23,HOU,12,0,1,3,3,0,0.3,0,0,5,3,18,6,0,1.5,60,3.6,0,40,4,3,21,545,524,RB
1412,Kenneth Farrow,60,13,73,2016,23,SDG,13,2,60,192,3.2,0,14.8,11,45,16,13,70,5.4,0,5.4,81.3,4.4,2,43.8,73,192,262,262,0,RB
1413,Jerome Felton,8,6,14,2016,30,BUF,15,4,8,13,1.6,0,0.9,5,62.5,9,6,57,9.5,0,3.8,66.7,6.3,4,55.6,14,13,70,88,18,RB
1414,Josh Ferguson,15,20,35,2016,23,IND,16,0,15,20,1.3,0,1.3,0,13.3,26,20,136,6.8,0,8.5,76.9,5.2,5,42.3,35,20,156,236,80,RB
1415,Justin Forsett,87,20,107,2016,31,"DEN,DET,BAL",9,6,87,291,3.3,1,32.3,10,32.2,27,20,85,4.3,0,9.4,74.1,3.1,4,48.1,107,291,376,376,0,RB
1416,Matt Forte,218,30,248,2016,31,NYJ,14,13,218,813,3.7,7,58.1,36,40.4,43,30,263,8.8,1,18.8,69.8,6.1,10,48.8,248,813,1076,1076,0,RB
1417,Arian Foster,22,6,28,2016,30,MIA,4,2,22,55,2.5,0,13.8,3,27.3,10,6,78,13,0,19.5,60,7.8,2,20,28,55,133,133,0,RB
1418,Jalston Fowler,1,1,2,2016,26,TEN,16,6,1,3,3,0,0.2,0,0,2,1,14,14,0,0.9,50,7,1,50,2,3,17,17,0,RB
1419,Devonta Freeman,227,54,281,2016,24,ATL,16,16,227,1079,4.8,11,67.4,66,49.3,65,54,462,8.6,2,28.9,83.1,7.1,22,56.9,281,1079,1541,1541,0,RB
1420,Mike Gillislee,101,9,110,2016,26,BUF,15,1,101,577,5.7,8,38.5,41,67.3,11,9,50,5.6,1,3.3,81.8,4.5,1,27.3,110,577,627,646,19,RB
1421,Melvin Gordon,254,41,295,2016,23,SDG,13,11,254,997,3.9,10,76.7,62,42.9,57,41,419,10.2,2,32.2,71.9,7.4,21,57.9,295,997,1416,1416,0,RB
1422,Frank Gore,263,38,301,2016,33,IND,16,16,263,1025,3.9,4,64.1,50,47.9,47,38,277,7.3,4,17.3,80.9,5.9,14,53.2,301,1025,1302,1302,0,RB
1423,Corey Grant,32,4,36,2016,25,JAX,11,1,32,164,5.1,1,14.9,7,43.8,7,4,35,8.8,1,3.2,57.1,5,2,42.9,36,164,199,467,268,RB
1424,Aaron Green,0,0,0,2016,24,LAR,2,0,0,0,,0,0,0,,0,0,0,,0,0,,,0,,0,0,0,0,0,RB
1425,Jonathan Grimes,23,13,36,2016,27,HOU,10,0,23,105,4.6,0,10.5,6,30.4,18,13,94,7.2,0,9.4,72.2,5.2,4,55.6,36,105,199,199,0,RB
1426,Glenn Gronkowski,0,0,0,2016,23,BUF,1,0,0,0,,0,0,0,,0,0,0,,0,0,,,0,,0,0,0,0,0,RB
1427,Todd Gurley,278,43,321,2016,22,LAR,16,16,278,885,3.2,6,55.3,49,40.3,58,43,327,7.6,0,20.4,74.1,5.6,16,39.7,321,885,1212,1212,0,RB
1428,Russell Hansbrough,0,0,0,2016,23,TAM,2,0,0,0,,0,0,0,,0,0,0,,0,0,,,0,,0,0,0,0,0,RB
1429,DuJuan Harris,38,8,46,2016,28,SFO,10,1,38,138,3.6,0,13.8,6,39.5,9,8,115,14.4,1,11.5,88.9,12.8,4,88.9,46,138,253,271,18,RB
1430,Derrick Henry,110,13,123,2016,22,TEN,15,2,110,490,4.5,5,32.7,29,54.5,15,13,137,10.5,0,9.1,86.7,9.1,5,46.7,123,490,627,627,0,RB
1431,Tim Hightower,133,22,155,2016,30,NOR,16,1,133,548,4.1,4,34.3,32,53.4,26,22,200,9.1,1,12.5,84.6,7.7,11,57.7,155,548,748,809,61,RB
1432,Bronson Hill,2,0,2,2016,23,JAX,3,0,2,11,5.5,0,3.7,0,100,1,0,0,,0,0,0,0,0,0,2,11,11,11,0,RB
1433,Jeremy Hill,222,21,243,2016,24,CIN,15,13,222,839,3.8,9,55.9,46,43.7,27,21,174,8.3,0,11.6,77.8,6.4,6,59.3,243,839,1013,1013,0,RB
1434,Ronnie Hillman,41,7,48,2016,25,"MIN,SDG",8,1,41,131,3.2,0,16.4,7,34.1,15,7,93,13.3,0,11.6,46.7,6.2,3,33.3,48,131,224,224,0,RB
1435,Jordan Howard,252,29,281,2016,22,CHI,15,13,252,1313,5.2,6,87.5,73,48.8,50,29,298,10.3,1,19.9,58,6,12,44,281,1313,1611,1611,0,RB
1436,Akeem Hunt,20,3,23,2016,23,HOU,8,0,20,109,5.5,0,13.6,5,50,4,3,29,9.7,0,3.6,75,7.3,1,25,23,109,138,332,194,RB
1437,Carlos Hyde,217,27,244,2016,26,SFO,13,13,217,988,4.6,6,76,48,47.5,33,27,163,6,3,12.5,81.8,4.9,7,48.5,244,988,1151,1151,0,RB
1438,Mark Ingram,205,46,251,2016,27,NOR,16,14,205,1043,5.1,6,65.2,50,57.1,58,46,319,6.9,4,19.9,79.3,5.5,18,53.4,251,1043,1362,1362,0,RB
1439,Chris Ivory,117,20,137,2016,28,JAX,11,1,117,439,3.8,3,39.9,21,45.3,28,20,186,9.3,0,16.9,71.4,6.6,10,42.9,137,439,625,625,0,RB
1440,Don Jackson,10,0,10,2016,23,GNB,3,1,10,32,3.2,0,10.7,1,50,1,0,0,,0,0,0,0,0,0,10,32,32,32,0,RB
1441,Mike James,4,4,8,2016,25,TAM,4,0,4,19,4.8,0,4.8,1,50,4,4,22,5.5,0,5.5,100,5.5,0,75,8,19,41,41,0,RB
1442,Andy Janovich,4,5,9,2016,23,DEN,11,5,4,33,8.3,1,3,2,100,7,5,44,8.8,0,4,71.4,6.3,4,57.1,9,33,77,77,0,RB
1443,Rashad Jennings,181,35,216,2016,31,NYG,13,12,181,593,3.3,3,45.6,29,36.5,42,35,201,5.7,1,15.5,83.3,4.8,8,35.7,216,593,794,798,0,RB
1444,Austin Johnson,0,0,0,2016,27,TAM,1,0,0,0,,0,0,0,,0,0,0,,0,0,,,0,,0,0,0,0,0,RB
1445,Chris Johnson,25,0,25,2016,31,ARI,4,0,25,95,3.8,1,23.8,5,44,1,0,0,,0,0,0,0,0,0,25,95,95,95,0,RB
1446,David Johnson,293,80,373,2016,25,ARI,16,16,293,1239,4.2,16,77.4,73,48.8,120,80,879,11,4,54.9,66.7,7.3,42,48.3,373,1239,2118,2118,0,RB
1447,Duke Johnson,73,53,126,2016,23,CLE,16,1,73,358,4.9,1,22.4,18,45.2,74,53,514,9.7,0,32.1,71.6,6.9,24,47.3,126,358,872,1003,131,RB
1448,Matt Jones,99,8,107,2016,23,WAS,7,7,99,460,4.6,3,65.7,28,50.5,8,8,73,9.1,0,10.4,100,9.1,4,100,107,460,533,533,0,RB
1449,Taiwan Jones,1,4,5,2016,28,OAK,13,0,1,-8,-8,0,-0.6,0,0,4,4,43,10.8,0,3.3,100,10.8,3,75,5,-8,35,147,112,RB
1450,Kyle Juszczyk,5,37,42,2016,25,BAL,16,7,5,22,4.4,1,1.4,3,60,49,37,266,7.2,0,16.6,75.5,5.4,12,38.8,42,22,288,288,0,RB
1451,Robert Kelley,168,12,180,2016,24,WAS,15,9,168,704,4.2,6,46.9,30,46.4,18,12,82,6.8,1,5.5,66.7,4.6,6,44.4,180,704,786,786,0,RB
1452,Joe Kerridge,1,0,1,2016,24,GNB,8,0,1,0,0,0,0,0,0,0,0,0,,0,0,,,0,,1,0,0,0,0,RB
1453,John Kuhn,18,16,34,2016,34,NOR,16,3,18,37,2.1,4,2.3,12,66.7,20,16,70,4.4,1,4.4,80,3.5,5,40,34,37,107,107,0,FB
1454,Eddie Lacy,71,4,75,2016,26,GNB,5,5,71,360,5.1,0,72,15,49.3,7,4,28,7,0,5.6,57.1,4,1,14.3,75,360,388,388,0,RB
1455,Jeremy Langford,62,19,81,2016,25,CHI,12,3,62,200,3.2,4,16.7,12,56.5,27,19,142,7.5,0,11.8,70.4,5.3,7,44.4,81,200,342,342,0,RB
1456,Daniel Lasco,11,2,13,2016,24,NOR,7,0,11,32,2.9,0,4.6,1,45.5,4,2,11,5.5,0,1.6,50,2.8,0,50,13,32,43,43,0,RB
1457,Paul Lasike,3,1,4,2016,26,CHI,10,3,3,8,2.7,0,0.8,3,100,1,1,3,3,0,0.3,100,3,0,0,4,8,11,16,5,RB
1458,Dion Lewis,64,17,81,2016,26,NWE,7,5,64,283,4.4,0,40.4,14,57.8,24,17,94,5.5,0,13.4,70.8,3.9,4,41.7,81,283,377,412,35,RB
1459,Zach Line,7,0,7,2016,26,MIN,15,4,7,15,2.1,0,1,3,57.1,3,0,0,,0,0,0,0,0,0,7,15,15,15,0,RB
1460,Terrence Magee,3,0,3,2016,23,SEA,2,0,3,12,4,0,6,0,66.7,0,0,0,,0,0,,,0,,3,12,12,12,0,RB
1461,Byron Marshall,19,3,22,2016,22,PHI,3,0,19,64,3.4,0,21.3,6,42.1,5,3,10,3.3,0,3.3,60,2,1,20,22,64,74,110,36,RB
1462,Doug Martin,144,14,158,2016,27,TAM,8,8,144,421,2.9,3,52.6,24,41,16,14,134,9.6,0,16.8,87.5,8.4,4,43.8,158,421,555,553,0,RB
1463,Ryan Mathews,155,13,168,2016,29,PHI,13,8,155,661,4.3,8,50.8,40,51,14,13,115,8.8,1,8.8,92.9,8.2,7,57.1,168,661,776,776,0,RB
1464,LeSean McCoy,234,50,284,2016,28,BUF,15,15,234,1267,5.4,13,84.5,56,49.6,57,50,356,7.1,1,23.7,87.7,6.2,17,54.4,284,1267,1623,1618,0,RB
1465,Darren McFadden,24,3,27,2016,29,DAL,3,1,24,87,3.6,0,29,5,45.8,5,3,17,5.7,0,5.7,60,3.4,1,40,27,87,104,134,30,RB
1466,J.D. McKissic,1,2,3,2016,23,SEA,1,0,1,2,2,0,2,0,0,2,2,16,8,0,16,100,8,0,50,3,2,18,40,22,RB
1467,Jerick McKinnon,159,43,202,2016,24,MIN,15,7,159,539,3.4,2,35.9,21,37.1,53,43,255,5.9,2,17,81.1,4.8,17,43.4,202,539,794,794,0,RB
1468,Christine Michael,148,22,170,2016,26,"GNB,SEA",15,7,148,583,3.9,7,38.9,34,48,29,22,107,4.9,1,7.1,75.9,3.7,4,44.8,170,583,690,754,64,RB
1469,Lamar Miller,268,31,299,2016,25,HOU,14,14,268,1073,4,5,76.6,55,42.9,39,31,188,6.1,1,13.4,79.5,4.8,9,56.4,299,1073,1261,1261,0,RB
1470,Ty Montgomery,77,44,121,2016,23,GNB,15,6,77,457,5.9,3,30.5,20,53.2,56,44,348,7.9,0,23.2,78.6,6.2,20,51.8,121,457,805,1171,366,RB
1471,Alfred Morris,69,3,72,2016,28,DAL,14,0,69,243,3.5,2,17.4,15,47.8,6,3,11,3.7,0,0.8,50,1.8,0,16.7,72,243,254,266,12,RB
1472,Raheem Mostert,1,0,1,2016,24,"CHI,SFO",3,0,1,6,6,0,2,0,100,0,0,0,,0,0,,,0,,1,6,6,74,68,RB
1473,Marcus Murphy,0,1,1,2016,25,NOR,3,0,0,0,,0,0,0,,1,1,3,3,0,1,100,3,0,0,1,0,3,165,162,RB
1474,DeMarco Murray,293,53,346,2016,28,TEN,16,16,293,1287,4.4,9,80.4,67,50.2,67,53,377,7.1,3,23.6,79.1,5.6,20,34.3,346,1297,1664,1664,0,RB
1475,Latavius Murray,195,33,228,2016,26,OAK,14,12,195,788,4,12,56.3,52,47.7,43,33,264,8,0,18.9,76.7,6.1,11,48.8,228,788,1052,1052,0,RB
1476,Roosevelt Nix,0,2,2,2016,24,PIT,10,2,0,0,,0,0,0,,2,2,5,2.5,0,0.5,100,2.5,0,0,2,0,5,5,0,RB
1477,Jamize Olawale,17,12,29,2016,27,OAK,16,7,17,47,2.8,2,2.9,5,35.3,14,12,227,18.9,1,14.2,85.7,16.2,5,64.3,29,47,274,274,0,RB
1478,Nick O'Leary,0,9,9,2016,24,BUF,16,7,0,0,,0,0,0,,14,9,114,12.7,0,7.1,64.3,8.1,5,50,9,0,114,141,27,RB
1479,Isaiah Pead,8,1,9,2016,27,MIA,3,0,8,22,2.8,0,7.3,0,37.5,1,1,6,6,0,2,100,6,0,100,9,22,28,28,0,RB
1480,Cedric Peerman,6,0,6,2016,30,CIN,6,0,6,15,2.5,0,2.5,0,33.3,1,0,0,,0,0,0,0,0,0,6,15,15,15,0,RB
1481,Paul Perkins,112,15,127,2016,22,NYG,14,1,112,456,4.1,0,32.6,24,43.8,24,15,162,10.8,0,11.6,62.5,6.8,6,33.3,127,456,618,618,0,RB
1482,Adrian Peterson,37,3,40,2016,31,MIN,3,3,37,72,1.9,0,24,3,35.1,6,3,8,2.7,0,2.7,50,1.3,0,0,40,72,80,80,0,RB
1483,Troymaine Pope,12,1,13,2016,23,"NYJ,SEA",4,0,12,44,3.7,0,11,3,33.3,2,1,5,5,0,1.3,50,2.5,0,50,13,44,49,49,0,RB
1484,Bilal Powell,131,58,189,2016,28,NYJ,16,4,131,722,5.5,3,45.1,44,55,74,58,388,6.7,2,24.3,78.4,5.2,21,43.2,189,722,1110,1110,0,RB
1485,C.J. Prosise,30,17,47,2016,22,SEA,6,2,30,172,5.7,1,28.7,4,53.3,19,17,208,12.2,0,34.7,89.5,10.9,8,52.6,47,172,380,380,0,RB
1486,Jay Prosch,4,1,5,2016,24,HOU,15,1,4,9,2.3,0,0.6,3,75,1,1,6,6,0,0.4,100,6,1,100,5,9,15,25,10,RB
1487,Bobby Rainey,17,20,37,2016,29,NYG,15,0,17,63,3.7,0,4.2,4,52.9,25,20,153,7.7,0,10.2,80,6.1,7,44,37,63,216,459,243,RB
1488,Thomas Rawls,109,13,122,2016,23,SEA,9,7,109,349,3.2,3,38.8,22,39.4,17,13,96,7.4,0,10.7,76.5,5.6,4,47.1,122,349,445,445,0,RB
1489,Marcel Reece,2,5,7,2016,31,SEA,4,0,2,0,0,0,0,0,0,5,5,73,14.6,0,18.3,100,14.6,2,100,7,0,73,73,0,RB
1490,Chase Reynolds,0,1,1,2016,29,LAR,16,0,0,0,,0,0,0,,1,1,4,4,0,0.3,100,4,1,100,1,0,4,4,0,RB
1491,Daryl Richardson,2,0,2,2016,26,PIT,3,0,2,7,3.5,0,2.3,0,50,0,0,0,,0,0,,,0,,2,7,7,7,0,RB
1492,Jalen Richard,83,29,112,2016,23,OAK,16,0,83,491,5.9,1,30.7,15,48.2,39,29,194,6.7,2,12.1,74.4,5,8,30.8,112,491,685,1391,708,RB
1493,Theo Riddick,92,53,145,2016,25,DET,10,8,92,357,3.9,1,35.7,21,41.3,67,53,371,7,5,37.1,79.1,5.5,20,47.8,145,357,728,728,0,RB
1494,Stevan Ridley,3,0,3,2016,27,ATL,1,0,3,7,2.3,0,7,1,33.3,0,0,0,,0,0,,,0,,3,7,7,7,0,RB
1495,Aaron Ripkowski,34,9,43,2016,24,GNB,16,8,34,150,4.4,2,9.4,12,58.8,10,9,46,5.1,1,2.9,90,4.6,2,60,43,150,196,196,0,RB
1496,Khiry Robinson,8,0,8,2016,27,NYJ,1,0,8,22,2.8,0,22,1,50,0,0,0,,0,0,,,0,,8,22,22,22,0,RB
1497,Jacquizz Rodgers,129,13,142,2016,26,TAM,10,5,129,560,4.3,2,56,31,48.8,16,13,98,7.5,0,9.8,81.3,6.1,3,56.3,142,560,658,658,0,RB
1498,Anthony Sherman,0,4,4,2016,28,KAN,16,3,0,0,,0,0,0,,6,4,11,2.8,0,0.7,66.7,1.8,0,0,4,0,11,11,0,RB
1499,Charles Sims,51,24,75,2016,26,TAM,7,2,51,149,2.9,1,21.3,6,39.2,32,24,190,7.9,1,27.1,75,5.9,10,43.8,75,149,339,339,0,RB
1500,Wendell Smallwood,77,6,83,2016,22,PHI,13,3,77,312,4.1,1,24,20,46.8,13,6,55,9.2,0,4.2,46.2,4.2,1,38.5,83,312,367,628,261,RB
1501,Antone Smith,10,6,16,2016,31,TAM,3,0,10,47,4.7,0,15.7,2,60,9,6,77,12.8,0,25.7,66.7,8.6,2,44.4,16,47,124,124,0,RB
1502,Rod Smith,0,1,1,2016,24,DAL,7,0,0,0,,0,0,0,,1,1,4,4,0,0.6,100,4,0,0,1,0,4,23,19,RB
1503,C.J. Spiller,6,6,12,2016,29,"NYJ,SEA",6,0,6,18,3,0,3,2,50,13,6,50,8.3,1,8.3,46.2,3.8,2,30.8,12,18,68,210,142,RB
1504,Darren Sproles,94,52,146,2016,33,PHI,15,5,94,438,4.7,2,29.2,22,52.1,71,52,427,8.2,2,28.5,73.2,6,19,45.1,146,438,865,1108,243,RB
1505,James Starks,63,19,82,2016,30,GNB,9,4,63,145,2.3,0,16.1,9,30.2,25,19,134,7.1,2,14.9,76,5.4,5,36,82,145,279,279,0,RB
1506,Jonathan Stewart,218,8,226,2016,29,CAR,13,13,218,824,3.8,9,63.4,49,42.7,21,8,60,7.5,0,4.6,38.1,2.9,1,19,226,824,884,884,0,RB
1507,Lorenzo Taliaferro,1,3,4,2016,25,BAL,3,0,1,0,0,0,0,0,0,3,3,10,3.3,0,3.3,100,3.3,0,33.3,4,0,10,10,0,RB
1508,Stepfan Taylor,4,0,4,2016,25,ARI,15,0,4,12,3,0,0.8,1,50,0,0,0,,0,0,,,0,,4,12,12,12,0,RB
1509,Chris Thompson,68,49,117,2016,26,WAS,16,0,68,356,5.2,3,22.3,16,52.9,62,49,349,7.1,2,21.8,79,5.6,19,46.8,117,356,705,1065,360,RB
1510,De'Anthony Thomas,4,7,11,2016,23,KAN,12,0,4,29,7.3,0,2.4,1,50,9,7,35,5,0,2.9,77.8,3.9,2,33.3,11,29,64,402,338,RB
1511,Juwan Thompson,8,0,8,2016,24,DEN,8,1,8,26,3.3,1,3.3,2,37.5,1,0,0,,0,0,0,0,0,0,8,26,26,26,0,RB
1512,Jordan Todman,9,0,9,2016,26,IND,16,0,9,59,6.6,0,3.7,3,55.6,1,0,0,,0,0,0,0,0,0,9,59,59,537,478,RB
1513,Mike Tolbert,35,10,45,2016,31,CAR,16,2,35,114,3.3,0,7.1,5,37.1,15,10,72,7.2,1,4.5,66.7,4.8,4,33.3,45,114,186,186,0,RB
1514,Fitzgerald Toussaint,14,3,17,2016,26,PIT,16,0,14,58,4.1,0,3.6,2,35.7,3,3,33,11,0,2.1,100,11,2,100,17,58,91,369,278,RB
1515,Will Tukuafu,2,0,2,2016,32,SEA,7,1,2,2,1,0,0.3,0,0,1,0,0,,0,0,0,0,0,0,2,2,2,2,0,FB
1516,Robert Turbin,47,26,73,2016,27,IND,15,0,47,164,3.5,7,10.9,20,59.6,35,26,179,6.9,1,11.9,74.3,5.1,9,37.1,73,164,343,343,0,RB
1517,Shane Vereen,33,11,44,2016,27,NYG,5,1,33,158,4.8,1,31.6,9,45.5,19,11,94,8.5,0,18.8,57.9,4.9,4,31.6,44,158,252,252,0,RB
1518,Danny Vitale,0,4,4,2016,23,CLE,9,3,0,0,,0,0,0,,5,4,27,6.8,0,3,80,5.4,2,40,4,0,27,27,0,RB
1519,Terron Ward,31,1,32,2016,24,ATL,5,0,31,151,4.9,0,30.2,7,45.2,2,1,11,11,0,2.2,50,5.5,1,50,32,151,162,162,0,RB
1520,Spencer Ware,214,33,247,2016,25,KAN,14,14,214,921,4.3,3,65.8,50,50.5,42,33,447,13.5,2,31.9,78.6,10.6,17,57.1,247,921,1368,1368,0,RB
1521,DeAndre Washington,87,17,104,2016,23,OAK,14,2,87,467,5.4,2,33.4,19,47.1,23,17,115,6.8,0,8.2,73.9,5,4,43.5,104,467,582,602,20,RB
1522,Dwayne Washington,90,10,100,2016,22,DET,12,2,90,265,2.9,1,22.1,11,33.3,15,10,62,6.2,0,5.2,66.7,4.1,5,33.3,100,265,327,373,46,RB
1523,Terrell Watson,9,1,10,2016,23,PHI,1,0,9,28,3.1,1,28,2,55.6,1,1,5,5,0,5,100,5,0,0,10,28,33,33,0,RB
1524,Derek Watt,2,4,6,2016,24,SDG,16,2,2,4,2,0,0.3,2,100,4,4,83,20.8,0,5.2,100,20.8,2,100,6,4,87,87,0,FB
1525,Charcandrick West,88,28,116,2016,25,KAN,15,2,88,293,3.3,1,19.5,15,35.2,34,28,188,6.7,2,12.5,82.4,5.5,11,41.2,116,293,481,481,0,RB
1526,Terrance West,193,34,227,2016,25,BAL,16,13,193,774,4,5,48.4,38,41.5,45,34,236,6.9,1,14.8,75.6,5.2,11,53.3,227,774,1010,1010,0,RB
1527,Fozzy Whittaker,57,25,82,2016,27,CAR,16,0,57,265,4.6,0,16.6,10,36.8,33,25,226,9,0,14.1,75.8,6.8,11,48.5,82,265,491,766,275,RB
1528,James White,39,60,99,2016,24,NWE,16,4,39,166,4.3,0,10.4,8,48.7,86,60,551,9.2,5,34.4,69.8,6.4,26,45.3,99,166,717,745,28,RB
1529,Brandon Wilds,10,2,12,2016,23,NYJ,4,0,10,27,2.7,0,6.8,1,30,2,2,20,10,0,5,100,10,1,50,12,27,47,47,0,RB
1530,Andre Williams,18,0,18,2016,24,SDG,1,0,18,87,4.8,0,87,6,72.2,2,0,0,,0,0,0,0,0,0,18,87,87,87,0,RB
1531,Damien Williams,35,23,58,2016,24,MIA,15,0,35,115,3.3,3,7.7,9,37.1,32,23,249,10.8,3,16.6,71.9,7.8,10,34.4,58,115,364,396,32,RB
1532,DeAngelo Williams,98,18,116,2016,33,PIT,9,4,98,343,3.5,4,38.1,22,43.9,27,18,118,6.6,2,13.1,66.7,4.4,6,40.7,116,343,461,461,0,RB
1533,Jonathan Williams,27,1,28,2016,22,BUF,11,0,27,94,3.5,1,8.5,6,40.7,2,1,0,0,0,0,50,0,0,0,28,94,94,94,0,RB
1534,Kerwynn Williams,18,1,19,2016,25,ARI,10,0,18,157,8.7,2,15.7,8,55.6,2,1,6,6,0,0.6,50,3,0,50,19,157,163,163,0,RB
1535,Danny Woodhead,19,6,25,2016,31,SDG,2,1,19,116,6.1,0,58,6,57.9,8,6,35,5.8,1,17.5,75,4.4,2,37.5,25,116,151,151,0,RB
1536,T.J. Yeldon,130,50,180,2016,23,JAX,15,13,130,465,3.6,1,31,21,36.9,68,50,312,6.2,1,20.8,73.5,4.6,16,38.2,180,465,777,777,0,RB
1537,Zach Zenner,88,18,106,2016,25,DET,14,4,88,334,3.8,4,23.9,23,47.7,23,18,196,10.9,0,14,78.3,8.5,9,56.5,106,334,530,530,0,RB
1538,Ameer Abdullah,143,25,168,2015,22,DET,16,9,143,597,4.2,2,37.3,31,51,38,25,183,7.3,1,11.4,65.8,4.8,11,47.4,168,597,780,1857,1077,RB
1539,Jay Ajayi,49,7,56,2015,22,MIA,9,0,49,187,3.8,1,20.8,8,36.7,11,7,90,12.9,0,10,63.6,8.2,5,54.5,56,187,277,297,20,RB
1540,Javorius Allen,137,45,182,2015,24,BAL,16,6,137,514,3.8,1,32.1,29,46.7,62,45,353,7.8,2,22.1,72.6,5.7,15,46.8,182,514,867,867,0,RB
1541,C.J. Anderson,152,25,177,2015,24,DEN,15,6,152,720,4.7,5,48,34,38.8,36,25,183,7.3,0,12.2,69.4,5.1,6,25,177,720,903,903,0,RB
1542,Antonio Andrews,143,21,164,2015,23,TEN,14,10,143,520,3.6,3,37.1,31,39.9,29,21,174,8.3,0,12.4,72.4,6,8,41.4,164,561,694,707,13,RB
1543,Cameron Artis-Payne,45,5,50,2015,25,CAR,7,0,45,183,4.1,1,26.1,6,35.6,5,5,58,11.6,0,8.3,100,11.6,4,100,50,183,241,241,0,RB
1544,Matt Asiata,29,19,48,2015,28,MIN,16,0,29,112,3.9,0,7,4,37.9,22,19,132,6.9,0,8.3,86.4,6,5,31.8,48,112,244,244,0,RB
1545,Joe Banyard,0,0,0,2015,27,JAX,5,0,0,0,,0,0,0,,0,0,0,,0,0,,,0,,0,0,0,21,21,RB
1546,Kenjon Barner,28,9,37,2015,26,PHI,10,0,28,124,4.4,0,12.4,6,53.6,12,9,22,2.4,0,2.2,75,1.8,1,33.3,37,124,146,153,7,RB
1547,Joique Bell,90,22,112,2015,29,DET,13,5,90,311,3.5,4,23.9,19,44.4,27,22,286,13,0,22,81.5,10.6,10,74.1,112,311,597,608,11,RB
1548,Le'Veon Bell,113,24,137,2015,23,PIT,6,6,113,556,4.9,3,92.7,27,45.1,26,24,136,5.7,0,22.7,92.3,5.2,4,34.6,137,556,692,692,0,RB
1549,Giovani Bernard,154,49,203,2015,24,CIN,16,1,154,730,4.7,2,45.6,36,47.4,66,49,472,9.6,0,29.5,74.2,7.2,19,45.5,203,730,1202,1214,6,RB
1550,Kapri Bibbs,0,0,0,2015,22,DEN,1,0,0,0,,0,0,0,,0,0,0,,0,0,,,0,,0,0,0,15,15,RB
1551,LeGarrette Blount,165,6,171,2015,29,NWE,12,6,165,703,4.3,6,58.6,39,49.1,7,6,43,7.2,1,3.6,85.7,6.1,3,42.9,171,703,746,746,0,RB
1552,Alfred Blue,183,15,198,2015,24,HOU,16,9,183,698,3.8,2,43.6,34,43.2,16,15,109,7.3,1,6.8,93.8,6.8,2,62.5,198,698,807,807,0,RB
1553,Tommy Bohanon,2,4,6,2015,25,NYJ,16,4,2,2,1,0,0.1,0,0,8,4,56,14,0,3.5,50,7,3,37.5,6,2,58,58,0,RB
1554,Brandon Bolden,63,19,82,2015,25,NWE,15,2,63,207,3.3,0,13.8,9,31.7,30,19,180,9.5,2,12,63.3,6,8,30,82,207,387,387,0,RB
1555,Ahmad Bradshaw,31,10,41,2015,29,IND,6,0,31,85,2.7,0,14.2,5,32.3,14,10,64,6.4,3,10.7,71.4,4.6,5,57.1,41,85,149,149,0,RB
1556,Allen Bradford,0,0,0,2015,27,ATL,6,0,0,0,,0,0,0,,0,0,0,,0,0,,,0,,0,0,0,0,0,RB
1557,Bryce Brown,25,0,25,2015,24,SEA,3,0,25,72,2.9,1,24,6,36,2,0,0,,0,0,0,0,0,0,25,72,72,72,0,RB
1558,Donald Brown,59,8,67,2015,28,SDG,10,2,59,229,3.9,1,22.9,12,35.6,13,8,88,11,0,8.8,61.5,6.8,2,46.2,67,229,317,317,0,RB
1559,Malcolm Brown,4,1,5,2015,22,STL,1,0,4,17,4.3,0,17,1,50,1,1,-2,-2,0,-2,100,-2,1,0,5,17,15,15,0,RB
1560,Rex Burkhead,4,10,14,2015,25,CIN,16,0,4,4,1,0,0.3,0,0,15,10,94,9.4,1,5.9,66.7,6.3,4,46.7,14,4,98,98,0,RB
1561,Reggie Bush,8,4,12,2015,30,SFO,5,1,8,28,3.5,0,5.6,0,12.5,10,4,19,4.8,0,3.8,40,1.9,1,10,12,28,47,56,9,RB
1562,Travaris Cadet,11,17,28,2015,26,"NOR,NWE,SFO",7,1,11,28,2.5,0,4,0,36.4,22,17,214,12.6,1,30.6,77.3,9.7,9,63.6,28,28,242,337,95,RB
1563,Ka'Deem Carey,43,3,46,2015,23,CHI,11,1,43,159,3.7,2,14.5,13,53.5,3,3,19,6.3,1,1.7,100,6.3,2,100,46,159,178,216,38,RB
1564,Jamaal Charles,71,21,92,2015,29,KAN,5,5,71,364,5.1,4,72.8,22,46.5,29,21,177,8.4,1,35.4,72.4,6.1,10,44.8,92,364,541,541,0,RB
1565,Tyler Clutts,0,1,1,2015,31,DAL,16,5,0,0,,0,0,0,,1,1,4,4,0,0.3,100,4,0,0,1,0,4,4,0,RB
1566,David Cobb,52,1,53,2015,22,TEN,7,1,52,146,2.8,1,20.9,6,32.7,2,1,-2,-2,0,-0.3,50,-1,0,0,53,146,144,144,0,RB
1567,Derrick Coleman,8,1,9,2015,25,SEA,14,3,8,32,4,0,2.3,3,62.5,1,1,0,0,0,0,100,0,0,0,9,32,32,32,0,RB
1568,Tevin Coleman,87,2,89,2015,22,ATL,12,3,87,392,4.5,1,32.7,14,48.3,11,2,14,7,0,1.2,18.2,1.3,0,9.1,89,392,406,406,0,RB
1569,John Crockett,9,0,9,2015,23,GNB,2,0,9,21,2.3,0,10.5,2,44.4,0,0,0,,0,0,,,0,,9,21,21,21,0,RB
1570,Isaiah Crowell,185,19,204,2015,22,CLE,16,9,185,706,3.8,4,44.1,35,41.1,22,19,182,9.6,1,11.4,86.4,8.3,6,54.5,204,706,888,888,0,RB
1571,Benny Cunningham,37,26,63,2015,25,STL,16,1,37,140,3.8,0,8.8,7,40.5,36,26,250,9.6,0,15.6,72.2,6.9,12,38.9,63,140,390,1104,714,RB
1572,Orleans Darkwa,36,3,39,2015,23,NYG,16,0,36,153,4.3,1,9.6,7,47.2,5,3,31,10.3,0,1.9,60,6.2,2,60,39,153,184,184,0,RB
1573,Knile Davis,28,2,30,2015,24,KAN,14,0,28,72,2.6,1,5.1,5,32.1,3,2,24,12,0,1.7,66.7,8,1,33.3,30,72,96,699,603,RB
1574,Mike Davis,35,7,42,2015,22,SFO,6,0,35,58,1.7,0,9.7,5,31.4,13,7,38,5.4,0,6.3,53.8,2.9,2,30.8,42,58,96,96,0,RB
1575,Patrick DiMarco,1,13,14,2015,26,ATL,16,8,1,0,0,0,0,0,0,17,13,110,8.5,2,6.9,76.5,6.5,9,70.6,14,0,110,129,19,RB
1576,Anthony Dixon,21,6,27,2015,28,BUF,16,1,21,44,2.1,1,2.8,5,28.6,7,6,44,7.3,0,2.8,85.7,6.3,1,42.9,27,44,88,147,59,RB
1577,Shaun Draughn,78,27,105,2015,28,"CLE,SFO",11,6,78,273,3.5,1,24.8,13,35.9,35,27,176,6.5,0,16,77.1,5,7,37.1,105,273,449,555,106,RB
1578,Lance Dunbar,5,21,26,2015,25,DAL,4,0,5,67,13.4,0,16.8,1,40,23,21,215,10.2,0,53.8,91.3,9.3,9,60.9,26,67,282,432,150,RB
1579,Andre Ellington,45,15,60,2015,26,ARI,10,2,45,289,6.4,3,28.9,11,48.9,24,15,148,9.9,0,14.8,62.5,6.2,8,54.2,60,289,437,437,0,RB
1580,Jerome Felton,1,1,2,2015,29,BUF,16,8,1,2,2,0,0.1,1,100,2,1,12,12,0,0.8,50,6,0,50,2,2,14,19,5,RB
1581,Justin Forsett,151,31,182,2015,30,BAL,10,10,151,641,4.2,2,64.1,41,46.4,41,31,153,4.9,0,15.3,75.6,3.7,4,31.7,182,641,794,794,0,RB
1582,Matt Forte,218,44,262,2015,30,CHI,13,13,218,898,4.1,4,69.1,47,48.2,58,44,389,8.8,3,29.9,75.9,6.7,17,50,262,898,1287,1287,0,RB
1583,Arian Foster,63,22,85,2015,29,HOU,4,4,63,163,2.6,1,40.8,12,39.7,28,22,227,10.3,2,56.8,78.6,8.1,13,60.7,85,163,390,390,0,RB
1584,Jalston Fowler,7,5,12,2015,25,TEN,16,0,7,13,1.9,1,0.8,5,71.4,6,5,44,8.8,1,2.8,83.3,7.3,3,66.7,12,13,57,57,0,RB
1585,Devonta Freeman,265,73,338,2015,23,ATL,15,13,265,1056,4,11,70.4,71,45.7,97,73,578,7.9,3,38.5,75.3,6,21,52.6,338,1056,1634,1634,0,RB
1586,Kendall Gaskins,16,8,24,2015,25,SFO,9,0,16,38,2.4,0,4.2,3,31.3,10,8,69,8.6,0,7.7,80,6.9,3,60,24,38,107,107,0,RB
1587,Toby Gerhart,20,3,23,2015,28,JAX,7,1,20,44,2.2,0,6.3,3,35,5,3,23,7.7,0,3.3,60,4.6,1,40,23,44,67,68,0,RB
1588,Mike Gillislee,47,6,53,2015,25,BUF,5,1,47,267,5.7,3,53.4,9,34,7,6,29,4.8,0,5.8,85.7,4.1,2,28.6,53,267,296,296,0,RB
1589,Melvin Gordon,184,33,217,2015,22,SDG,14,12,184,641,3.5,0,45.8,36,42.4,37,33,192,5.8,0,13.7,89.2,5.2,8,48.6,217,641,833,833,0,RB
1590,Frank Gore,260,34,294,2015,32,IND,16,16,260,967,3.7,6,60.4,48,39.2,58,34,267,7.9,1,16.7,58.6,4.6,11,34.5,294,967,1234,1234,0,RB
1591,Corey Grant,6,2,8,2015,24,JAX,6,0,6,2,0.3,0,0.3,1,33.3,3,2,13,6.5,0,2.2,66.7,4.3,0,66.7,8,2,15,235,220,RB
1592,Jonas Gray,45,7,52,2015,25,"JAX,MIA",8,0,45,176,3.9,0,22,11,42.2,8,7,76,10.9,0,9.5,87.5,9.5,2,62.5,52,176,252,252,0,RB
1593,Jonathan Grimes,56,26,82,2015,26,HOU,14,0,56,282,5,1,20.1,11,37.5,31,26,173,6.7,1,12.4,83.9,5.6,8,41.9,82,282,455,455,0,RB
1594,Todd Gurley,229,21,250,2015,21,STL,13,12,229,1106,4.8,10,85.1,47,40.2,26,21,188,9,0,14.5,80.8,7.2,9,46.2,250,1106,1294,1294,0,RB
1595,Alonzo Harris,4,0,4,2015,23,GNB,6,0,4,19,4.8,0,3.2,1,25,1,0,0,,0,0,0,0,0,0,4,19,19,19,0,RB
1596,DuJuan Harris,48,9,57,2015,27,"SEA,SFO",4,1,48,189,3.9,0,47.3,9,35.4,14,9,97,10.8,0,24.3,64.3,6.9,6,50,57,189,286,286,0,RB
1597,Jarryd Hayne,17,6,23,2015,27,SFO,8,1,17,52,3.1,0,6.5,4,41.2,7,6,27,4.5,0,3.4,85.7,3.9,2,42.9,23,52,79,155,76,RB
1598,Roy Helu,17,9,26,2015,27,OAK,9,0,17,39,2.3,0,4.3,4,35.3,16,9,75,8.3,1,8.3,56.3,4.7,6,43.8,26,39,114,199,85,RB
1599,Dan Herron,25,9,34,2015,26,"BUF,IND",10,0,25,79,3.2,0,7.9,4,52,10,9,47,5.2,0,4.7,90,4.7,1,50,34,79,126,218,92,RB
1600,Tim Hightower,96,12,108,2015,29,NOR,8,3,96,375,3.9,4,46.9,24,55.2,13,12,129,10.8,0,16.1,92.3,9.9,7,53.8,108,375,504,504,0,RB
1601,Jeremy Hill,223,15,238,2015,23,CIN,16,15,223,794,3.6,11,49.6,47,46.2,19,15,79,5.3,1,4.9,78.9,4.2,6,36.8,238,794,873,866,0,RB
1602,Ronnie Hillman,207,24,231,2015,24,DEN,16,10,207,863,4.2,7,53.9,44,43,35,24,111,4.6,0,6.9,68.6,3.2,3,31.4,231,863,974,974,0,RB
1603,Akeem Hunt,17,6,23,2015,22,HOU,7,1,17,96,5.6,0,13.7,6,47.1,10,6,39,6.5,0,5.6,60,3.9,2,20,23,96,135,154,19,RB
1604,Kendall Hunter,1,0,1,2015,27,NOR,2,0,1,2,2,0,1,0,0,0,0,0,,0,0,,,0,,1,2,2,2,0,RB
1605,Carlos Hyde,115,11,126,2015,25,SFO,7,7,115,470,4.1,3,67.1,26,47,15,11,53,4.8,0,7.6,73.3,3.5,4,33.3,126,470,523,523,0,RB
1606,Mark Ingram,166,50,216,2015,26,NOR,12,10,166,769,4.6,6,64.1,47,43.4,60,50,405,8.1,0,33.8,83.3,6.8,22,53.3,216,769,1174,1174,0,RB
1607,Joey Iosefa,15,0,15,2015,24,NWE,2,0,15,51,3.4,0,25.5,2,53.3,0,0,0,,0,0,,,0,,15,51,51,51,0,RB
1608,Chris Ivory,247,30,277,2015,27,NYJ,15,14,247,1070,4.3,7,71.3,51,40.9,37,30,217,7.2,1,14.5,81.1,5.9,10,51.4,277,1070,1287,1287,0,RB
1609,Fred Jackson,26,32,58,2015,34,SEA,16,0,26,100,3.8,0,6.3,5,42.3,41,32,257,8,2,16.1,78,6.3,12,58.5,58,100,357,357,0,RB
1610,Steven Jackson,21,1,22,2015,32,NWE,2,1,21,50,2.4,1,25,4,42.9,1,1,20,20,0,10,100,20,1,100,22,50,70,70,0,RB
1611,LaMichael James,0,0,0,2015,26,MIA,1,0,0,0,,0,0,0,,0,0,0,,0,0,,,0,,0,0,0,54,54,RB
1612,Rashad Jennings,195,29,224,2015,30,NYG,16,16,195,863,4.4,3,53.9,42,55.9,40,29,296,10.2,1,18.5,72.5,7.4,8,50,224,863,1159,1152,-7,RB
1613,Austin Johnson,4,5,9,2015,26,NOR,10,1,4,9,2.3,1,0.9,3,100,8,5,30,6,0,3,62.5,3.8,3,37.5,9,9,39,39,0,RB
1614,Chris Johnson,196,6,202,2015,30,ARI,11,9,196,814,4.2,3,74,33,43.4,13,6,58,9.7,0,5.3,46.2,4.5,1,23.1,202,814,872,872,0,RB
1615,David Johnson,125,36,161,2015,24,ARI,16,5,125,581,4.6,8,36.3,36,55.2,57,36,457,12.7,4,28.6,63.2,8,21,47.4,161,581,1038,1636,598,RB
1616,Duke Johnson,104,61,165,2015,22,CLE,16,7,104,379,3.6,0,23.7,19,44.2,74,61,534,8.8,2,33.4,82.4,7.2,24,41.9,165,379,913,965,52,RB
1617,Malcolm Johnson,0,4,4,2015,23,CLE,12,5,0,0,,0,0,0,,6,4,15,3.8,0,1.3,66.7,2.5,0,0,4,0,15,15,0,RB
1618,Will Johnson,4,2,6,2015,26,PIT,16,3,4,7,1.8,1,0.4,1,25,4,2,16,8,0,1,50,4,1,50,6,7,23,23,0,FB
1619,Matt Jones,144,19,163,2015,22,WAS,13,0,144,490,3.4,3,37.7,31,43.1,25,19,304,16,1,23.4,76,12.2,10,60,163,490,794,794,0,RB
1620,Taiwan Jones,16,7,23,2015,27,OAK,12,0,16,74,4.6,0,6.2,3,43.8,9,7,106,15.1,1,8.8,77.8,11.8,4,66.7,23,74,180,1009,829,RB
1621,Kyle Juszczyk,2,41,43,2015,24,BAL,16,11,2,3,1.5,0,0.2,0,0,56,41,321,7.8,4,20.1,73.2,5.7,17,44.6,43,3,324,331,7,RB
1622,John Kuhn,9,6,15,2015,33,GNB,16,6,9,28,3.1,2,1.8,3,66.7,10,6,56,9.3,0,3.5,60,5.6,3,40,15,28,84,93,9,RB
1623,Eddie Lacy,187,20,207,2015,25,GNB,15,12,187,758,4.1,3,50.5,39,47.1,28,20,188,9.4,2,12.5,71.4,6.7,7,46.4,207,758,946,946,0,RB
1624,Jeremy Langford,148,22,170,2015,24,CHI,16,2,148,537,3.6,6,33.6,28,45.9,42,22,279,12.7,1,17.4,52.4,6.6,9,35.7,170,537,816,816,0,RB
1625,Dion Lewis,49,36,85,2015,25,NWE,7,6,49,234,4.8,2,33.4,15,53.1,50,36,388,10.8,2,55.4,72,7.8,17,56,85,234,622,622,0,RB
1626,Zach Line,6,6,12,2015,25,MIN,16,5,6,10,1.7,2,0.6,3,50,9,6,95,15.8,1,5.9,66.7,10.6,4,55.6,12,10,105,148,43,RB
1627,Marshawn Lynch,111,13,124,2015,29,SEA,7,6,111,417,3.8,3,59.6,29,46.8,21,13,80,6.2,0,11.4,61.9,3.8,5,28.6,124,417,497,497,0,RB
1628,Terrence Magee,2,1,3,2015,22,BAL,4,0,2,5,2.5,0,1.3,0,0,1,1,2,2,0,0.5,100,2,0,0,3,5,7,35,28,RB
1629,Doug Martin,288,33,321,2015,26,TAM,16,16,288,1402,4.9,6,87.6,68,46.2,44,33,271,8.2,1,16.9,75,6.2,10,45.5,321,1402,1673,1673,0,RB
1630,Tre Mason,75,18,93,2015,22,STL,13,3,75,207,2.8,1,15.9,10,34.7,25,18,88,4.9,0,6.8,72,3.5,5,24,93,207,295,295,0,RB
1631,Ryan Mathews,106,20,126,2015,28,PHI,13,6,106,539,5.1,6,41.5,34,52.8,28,20,146,7.3,1,11.2,71.4,5.2,6,39.3,126,539,685,682,0,RB
1632,LeSean McCoy,203,32,235,2015,27,BUF,12,12,203,895,4.4,3,74.6,42,45.8,50,32,292,9.1,2,24.3,64,5.8,12,46,235,895,1187,1193,0,RB
1633,Darren McFadden,239,40,279,2015,28,DAL,16,10,239,1089,4.6,3,68.1,53,50.2,53,40,328,8.2,0,20.5,75.5,6.2,12,41.5,279,1089,1417,1440,23,RB
1634,Jerick McKinnon,52,21,73,2015,23,MIN,16,0,52,271,5.2,2,16.9,13,48.1,29,21,173,8.2,1,10.8,72.4,6,9,44.8,73,271,444,468,24,RB
1635,Christine Michael,54,3,57,2015,25,"DAL,SEA",8,2,54,243,4.5,0,30.4,14,48.1,6,3,16,5.3,0,2,50,2.7,1,16.7,57,243,259,259,0,RB
1636,Bruce Miller,6,10,16,2015,28,SFO,16,5,6,14,2.3,1,0.9,5,83.3,14,10,135,13.5,0,8.4,71.4,9.6,5,64.3,16,14,149,152,3,RB
1637,Lamar Miller,194,47,241,2015,24,MIA,16,16,194,872,4.5,8,54.5,41,42.3,57,47,397,8.4,2,24.8,82.5,7,15,40.4,241,872,1269,1269,0,RB
1638,Alfred Morris,202,10,212,2015,27,WAS,16,16,202,751,3.7,1,46.9,35,38.1,13,10,55,5.5,0,3.4,76.9,4.2,2,38.5,212,751,806,806,0,RB
1639,Raheem Mostert,0,0,0,2015,23,"CLE,MIA,BAL",11,0,0,0,,0,0,0,,0,0,0,,0,0,,,0,,0,0,0,530,530,RB
1640,Marcus Murphy,1,0,1,2015,24,NOR,13,0,1,0,0,0,0,0,0,0,0,0,,0,0,,,0,,1,0,0,561,561,RB
1641,DeMarco Murray,193,44,237,2015,27,PHI,15,8,193,702,3.6,6,46.8,48,42,55,44,322,7.3,1,21.5,80,5.9,13,47.3,237,702,1024,1024,0,RB
1642,Latavius Murray,266,41,307,2015,25,OAK,16,16,266,1066,4,6,66.6,49,38,53,41,232,5.7,0,14.5,77.4,4.4,9,45.3,307,1066,1298,1298,0,RB
1643,Roosevelt Nix,0,2,2,2015,23,PIT,15,4,0,0,,0,0,0,,3,2,16,8,0,1.1,66.7,5.3,1,66.7,2,0,16,16,0,RB
1644,Jamize Olawale,24,9,33,2015,26,OAK,14,3,24,110,4.6,1,7.9,9,58.3,11,9,84,9.3,0,6,81.8,7.6,5,63.6,33,110,194,194,0,FB
1645,Branden Oliver,31,13,44,2015,24,SDG,8,1,31,108,3.5,0,13.5,8,48.4,15,13,112,8.6,0,14,86.7,7.5,5,66.7,44,108,220,417,197,RB
1646,Toben Opurum,0,0,0,2015,25,NOR,2,0,0,0,,0,0,0,,0,0,0,,0,0,,,0,,0,0,0,0,0,RB
1647,Isaiah Pead,2,0,2,2015,26,STL,2,0,2,3,1.5,0,1.5,0,0,0,0,0,,0,0,,,0,,2,3,3,66,63,RB
1648,Cedric Peerman,0,0,0,2015,29,CIN,16,0,0,0,,0,0,0,,0,0,0,,0,0,,,0,,0,0,0,44,44,RB
1649,Adrian Peterson,327,30,357,2015,30,MIN,16,16,327,1485,4.5,11,92.8,72,44.3,36,30,222,7.4,0,13.9,83.3,6.2,9,41.7,357,1485,1707,1707,0,RB
1650,Bernard Pierce,6,3,9,2015,24,JAX,7,0,6,11,1.8,0,1.6,1,16.7,5,3,7,2.3,0,1,60,1.4,0,40,9,11,18,18,0,RB
1651,Chris Polk,99,16,115,2015,26,HOU,15,2,99,334,3.4,1,22.3,13,33.3,28,16,109,6.8,1,7.3,57.1,3.9,5,35.7,115,334,443,443,0,RB
1652,Bilal Powell,70,47,117,2015,27,NYJ,11,2,70,313,4.5,1,28.5,18,41.4,63,47,388,8.3,2,35.3,74.6,6.2,21,39.7,117,313,701,721,20,RB
1653,Jay Prosch,6,0,6,2015,23,HOU,16,2,6,33,5.5,0,2.1,3,50,1,0,0,,0,0,0,0,0,0,6,33,33,33,0,RB
1654,Bobby Rainey,5,3,8,2015,28,TAM,16,0,5,18,3.6,0,1.1,0,40,3,3,16,5.3,0,1,100,5.3,1,66.7,8,18,34,794,760,RB
1655,Joseph Randle,76,10,86,2015,24,DAL,6,6,76,315,4.1,4,52.5,15,44.7,10,10,86,8.6,0,14.3,100,8.6,6,80,86,315,401,401,0,RB
1656,Thomas Rawls,147,9,156,2015,22,SEA,13,7,147,830,5.6,4,63.8,37,59.2,11,9,76,8.4,1,5.8,81.8,6.9,2,45.5,156,830,906,906,0,RB
1657,Marcel Reece,10,30,40,2015,30,OAK,15,7,10,36,3.6,0,2.4,2,40,37,30,269,9,3,17.9,81.1,7.3,12,54.1,40,36,305,337,32,RB
1658,Chase Reynolds,0,0,0,2015,28,STL,12,0,0,0,,0,0,0,,0,0,0,,0,0,,,0,,0,0,0,9,9,RB
1659,Theo Riddick,43,80,123,2015,24,DET,16,1,43,133,3.1,0,8.3,6,41.9,99,80,697,8.7,3,43.6,80.8,7,32,54.5,123,133,830,830,0,RB
1660,Stevan Ridley,36,4,40,2015,26,NYJ,8,1,36,90,2.5,0,11.3,5,27.8,5,4,-2,-0.5,0,-0.3,80,-0.4,0,0,40,90,88,88,0,RB
1661,Aaron Ripkowski,0,1,1,2015,23,GNB,15,0,0,0,,0,0,0,,1,1,18,18,0,1.2,100,18,1,100,1,0,18,18,0,RB
1662,Josh Robinson,17,6,23,2015,23,IND,5,0,17,39,2.3,0,7.8,0,23.5,6,6,33,5.5,0,6.6,100,5.5,2,83.3,23,39,72,72,0,RB
1663,Khiry Robinson,56,17,73,2015,26,NOR,8,0,56,180,3.2,4,22.5,15,42.9,20,17,115,6.8,0,14.4,85,5.8,4,45,73,180,295,328,33,RB
1664,Jacquizz Rodgers,14,1,15,2015,25,CHI,5,0,14,41,2.9,0,8.2,4,35.7,3,1,10,10,0,2,33.3,3.3,0,0,15,41,51,66,15,RB
1665,Bishop Sankey,47,14,61,2015,23,TEN,13,3,47,193,4.1,1,14.8,5,44.7,22,14,139,9.9,1,10.7,63.6,6.3,8,45.5,61,193,332,524,192,RB
1666,Anthony Sherman,1,4,5,2015,27,KAN,16,2,1,0,0,0,0,0,0,5,4,34,8.5,0,2.1,80,6.8,1,20,5,0,34,54,20,RB
1667,Charles Sims,107,51,158,2015,25,TAM,16,0,107,529,4.9,0,33.1,21,54.2,70,51,561,11,4,35.1,72.9,8,22,51.4,158,529,1090,1090,0,RB
1668,Antone Smith,1,0,1,2015,30,CHI,5,0,1,11,11,0,2.2,1,100,0,0,0,,0,0,,,0,,1,11,11,11,0,RB
1669,Dreamius Smith,0,0,0,2015,23,SDG,2,0,0,0,,0,0,0,,0,0,0,,0,0,,,0,,0,0,0,0,0,RB
1670,Rod Smith,2,1,3,2015,23,"DAL,SEA",11,0,2,5,2.5,0,0.5,1,50,2,1,6,6,0,0.5,50,3,1,50,3,5,11,37,26,RB
1671,C.J. Spiller,36,34,70,2015,28,NOR,13,2,36,112,3.1,0,8.6,5,36.1,44,34,239,7,2,18.4,77.3,5.4,13,34.1,70,112,351,500,149,RB
1672,Darren Sproles,83,55,138,2015,32,PHI,16,4,83,317,3.8,3,19.8,21,49.4,83,55,388,7.1,1,24.3,66.3,4.7,21,33.7,138,317,705,1171,466,RB
1673,Zac Stacy,31,9,40,2015,24,NYJ,8,0,31,89,2.9,1,11.1,4,32.3,12,9,65,7.2,0,8.1,75,5.4,4,41.7,40,89,154,358,204,RB
1674,James Starks,148,43,191,2015,29,GNB,16,4,148,601,4.1,2,37.6,30,40.5,53,43,392,9.1,3,24.5,81.1,7.4,17,54.7,191,601,993,993,0,RB
1675,Jonathan Stewart,242,16,258,2015,28,CAR,13,13,242,989,4.1,6,76.1,43,42.6,21,16,99,6.2,1,7.6,76.2,4.7,5,57.1,258,989,1088,1088,0,RB
1676,Lorenzo Taliaferro,13,5,18,2015,24,BAL,3,0,13,47,3.6,1,15.7,2,53.8,5,5,29,5.8,0,9.7,100,5.8,0,60,18,47,76,76,0,RB
1677,Stepfan Taylor,17,1,18,2015,24,ARI,16,0,17,58,3.4,0,3.6,5,35.3,3,1,4,4,0,0.3,33.3,1.3,0,0,18,58,62,62,0,RB
1678,Marcus Thigpen,1,0,1,2015,29,"BUF,OAK",9,0,1,-1,-1,0,-0.1,0,0,0,0,0,,0,0,,,0,,1,-1,-1,448,449,RB
1679,Chris Thompson,35,35,70,2015,25,WAS,13,0,35,216,6.2,0,16.6,8,42.9,48,35,240,6.9,2,18.5,72.9,5,14,45.8,70,216,456,519,63,RB
1680,De'Anthony Thomas,9,17,26,2015,22,KAN,10,1,9,34,3.8,1,3.4,3,55.6,25,17,140,8.2,1,14,68,5.6,6,28,26,34,174,539,365,RB
1681,Juwan Thompson,18,6,24,2015,23,DEN,15,1,18,48,2.7,0,3.2,2,27.8,9,6,51,8.5,0,3.4,66.7,5.7,1,33.3,24,48,99,99,0,RB
1682,Pierre Thomas,15,9,24,2015,31,"SFO,WAS",5,0,15,64,4.3,0,12.8,3,26.7,11,9,84,9.3,0,16.8,81.8,7.6,4,45.5,24,64,148,163,15,RB
1683,Zurlon Tipton,5,5,10,2015,25,IND,10,0,5,20,4,0,2,1,20,8,5,57,11.4,0,5.7,62.5,7.1,2,25,10,20,77,100,23,RB
1684,Jordan Todman,4,0,4,2015,25,PIT,11,0,4,22,5.5,0,2,1,50,2,0,0,,0,0,0,0,0,0,4,22,22,44,22,RB
1685,Mike Tolbert,62,18,80,2015,30,CAR,16,3,62,256,4.1,1,16,18,56.5,23,18,154,8.6,3,9.6,78.3,6.7,8,60.9,80,256,410,418,8,RB
1686,Fitzgerald Toussaint,18,0,18,2015,25,PIT,5,0,18,42,2.3,0,8.4,0,0,0,0,0,,0,0,,,0,,18,42,42,42,0,RB
1687,Will Tukuafu,4,1,5,2015,31,SEA,14,1,4,1,0.3,1,0.1,3,75,1,1,7,7,1,0.5,100,7,1,100,5,1,8,24,16,FB
1688,Robert Turbin,50,7,57,2015,26,"CLE,DAL",10,0,50,199,4,1,19.9,10,48,10,7,23,3.3,0,2.3,70,2.3,0,10,57,199,222,222,0,RB
1689,Tyler Varga,1,1,2,2015,22,IND,3,0,1,2,2,0,0.7,0,100,2,1,18,18,0,6,50,9,1,50,2,2,20,171,151,RB
1690,Shane Vereen,61,59,120,2015,26,NYG,16,0,61,260,4.3,0,16.3,16,39.3,81,59,494,8.4,4,30.9,72.8,6.1,22,44.4,120,260,754,1075,321,RB
1691,Terron Ward,29,9,38,2015,23,ATL,13,0,29,95,3.3,1,7.3,5,31,13,9,73,8.1,0,5.6,69.2,5.6,0,23.1,38,95,168,178,10,RB
1692,Spencer Ware,72,6,78,2015,24,KAN,11,2,72,403,5.6,6,36.6,20,54.2,6,6,5,0.8,0,0.5,100,0.8,0,0,78,403,408,422,14,RB
1693,Trey Watts,0,0,0,2015,24,STL,1,0,0,0,,0,0,0,,0,0,0,,0,0,,,0,,0,0,0,0,0,RB
1694,Brandon Wegher,0,0,0,2015,25,CAR,1,0,0,0,,0,0,0,,0,0,0,,0,0,,,0,,0,0,0,0,0,RB
1695,Charcandrick West,160,20,180,2015,24,KAN,15,9,160,634,4,4,42.3,36,42.5,34,20,214,10.7,1,14.3,58.8,6.3,6,32.4,180,634,848,848,0,RB
1696,Terrance West,62,4,66,2015,24,"TEN,BAL",8,0,62,231,3.7,0,28.9,11,41.9,5,4,21,5.3,0,2.6,80,4.2,0,20,66,231,252,252,0,RB
1697,Fozzy Whittaker,25,12,37,2015,26,CAR,15,1,25,108,4.3,1,7.2,7,36,15,12,64,5.3,0,4.3,80,4.3,2,46.7,37,108,172,381,209,RB
1698,James White,22,40,62,2015,23,NWE,14,1,22,56,2.5,2,4,3,27.3,54,40,410,10.3,4,29.3,74.1,7.6,19,51.9,62,56,466,466,0,RB
1699,Andre Williams,88,1,89,2015,23,NYG,16,0,88,257,2.9,1,16.1,12,31.8,3,1,7,7,0,0.4,33.3,2.3,0,33.3,89,257,264,264,0,RB
1700,Damien Williams,16,21,37,2015,23,MIA,16,0,16,59,3.7,0,3.7,2,37.5,28,21,142,6.8,1,8.9,75,5.1,6,39.3,37,59,201,658,457,RB
1701,DeAngelo Williams,200,40,240,2015,32,PIT,16,10,200,907,4.5,11,56.7,53,48,47,40,367,9.2,0,22.9,85.1,7.8,15,51.1,240,907,1274,1274,0,RB
1702,Karlos Williams,93,11,104,2015,22,BUF,11,3,93,517,5.6,7,47,25,53.8,14,11,96,8.7,2,8.7,78.6,6.9,3,42.9,104,517,613,613,0,RB
1703,Kerwynn Williams,27,2,29,2015,24,ARI,6,0,27,142,5.3,1,23.7,6,33.3,2,2,16,8,0,2.7,100,8,1,50,29,142,158,284,126,RB
1704,Trey Williams,2,0,2,2015,23,IND,2,0,2,12,6,0,6,1,50,0,0,0,,0,0,,,0,,2,12,12,12,0,RB
1705,George Winn,4,0,4,2015,25,DET,7,0,4,1,0.3,0,0.1,0,0,0,0,0,,0,0,,,0,,4,1,1,1,0,RB
1706,Glenn Winston,1,0,1,2015,26,CLE,3,0,1,-8,-8,0,-2.7,0,0,0,0,0,,0,0,,,0,,1,-8,-8,-8,0,RB
1707,Cierre Wood,2,1,3,2015,24,BUF,2,0,2,3,1.5,0,1.5,0,0,1,1,-6,-6,0,-3,100,-6,0,0,3,3,-3,-3,0,RB
1708,Danny Woodhead,98,80,178,2015,30,SDG,16,2,98,336,3.4,3,21,21,43.9,106,80,755,9.4,6,47.2,75.5,7.1,39,49.1,178,336,1091,1091,0,RB
1709,T.J. Yeldon,182,36,218,2015,22,JAX,12,12,182,740,4.1,2,61.7,29,41.2,46,36,279,7.8,1,23.3,78.3,6.1,15,50,218,740,1019,1019,0,RB
1710,Zach Zenner,17,2,19,2015,24,DET,6,1,17,60,3.5,0,10,1,52.9,3,2,11,5.5,0,1.8,66.7,3.7,0,33.3,19,60,71,71,0,RB
1711,Ray Agnew,2,3,5,2014,23,CLE,12,9,2,2,1,0,0.2,1,50,9,3,15,5,0,1.3,33.3,1.7,1,11.1,5,2,17,17,0,RB
1712,C.J. Anderson,179,34,213,2014,23,DEN,15,7,179,849,4.7,8,56.6,47,50.3,44,34,324,9.5,2,21.6,77.3,7.4,14,54.5,213,849,1173,1173,0,RB
1713,Antonio Andrews,0,2,2,2014,22,TEN,4,0,0,0,,0,0,0,,2,2,11,5.5,0,2.8,100,5.5,0,0,2,0,11,121,110,RB
1714,Matt Asiata,164,44,208,2014,27,MIN,15,9,164,570,3.5,9,38,34,51.2,63,44,312,7.1,1,20.8,69.8,5,7,38.1,208,570,882,929,47,RB
1715,George Atkinson,0,0,0,2014,22,OAK,5,0,0,0,,0,0,0,,0,0,0,,0,0,,,0,,0,0,0,134,134,RB
1716,Edwin Baker,1,0,1,2014,23,NOR,3,0,1,2,2,0,0.7,1,100,0,0,0,,0,0,,,0,,1,2,2,2,0,RB
1717,Montee Ball,55,9,64,2014,24,DEN,5,3,55,172,3.1,1,34.4,9,41.8,13,9,62,6.9,0,12.4,69.2,4.8,2,30.8,64,172,234,234,0,RB
1718,Joe Banyard,21,9,30,2014,26,MIN,15,0,21,88,4.2,0,5.9,4,52.4,11,9,62,6.9,0,4.1,81.8,5.6,4,54.5,30,88,150,158,8,RB
1719,Jackie Battle,5,5,10,2014,31,TEN,16,1,5,9,1.8,1,0.6,4,80,5,5,28,5.6,0,1.8,100,5.6,2,60,10,9,37,80,43,RB
1720,Joique Bell,223,34,257,2014,28,DET,15,6,223,860,3.9,7,57.3,45,43.5,53,34,322,9.5,1,21.5,64.2,6.1,14,43.4,257,860,1182,1182,0,RB
1721,Le'Veon Bell,290,83,373,2014,22,PIT,16,16,290,1361,4.7,8,85.1,75,49.3,105,83,854,10.3,3,53.4,79,8.1,41,60,373,1361,2215,2215,0,RB
1722,Giovani Bernard,168,43,211,2014,23,CIN,13,9,168,680,4,5,52.3,32,36.9,59,43,349,8.1,2,26.8,72.9,5.9,14,37.3,211,680,1029,1029,0,RB
1723,LeGarrette Blount,125,10,135,2014,28,"NWE,PIT",16,1,125,547,4.4,5,34.2,33,44.8,12,10,54,5.4,0,3.4,83.3,4.5,4,41.7,135,547,601,704,103,RB
1724,Alfred Blue,169,15,184,2014,23,HOU,16,3,169,528,3.1,2,33,29,39.6,18,15,113,7.5,1,7.1,83.3,6.3,7,66.7,184,528,641,641,0,RB
1725,Tommy Bohanon,1,2,3,2014,24,NYJ,4,2,1,3,3,0,0.8,1,100,2,2,30,15,0,7.5,100,15,2,100,3,3,33,33,0,RB
1726,Brandon Bolden,28,2,30,2014,24,NWE,16,2,28,89,3.2,1,5.6,5,39.3,6,2,8,4,0,0.5,33.3,1.3,0,0,30,89,97,97,0,RB
1727,Ahmad Bradshaw,90,38,128,2014,28,IND,10,1,90,425,4.7,2,42.5,18,53.3,47,38,300,7.9,6,30,80.9,6.4,20,61.7,128,425,725,737,0,RB
1728,Allen Bradford,0,0,0,2014,26,SEA,1,0,0,0,,0,0,0,,0,0,0,,0,0,,,0,,0,0,0,0,0,RB
1729,Bryce Brown,36,16,52,2014,23,BUF,7,2,36,126,3.5,0,18,6,47.2,25,16,176,11,0,25.1,64,7,8,60,52,126,302,377,75,RB
1730,Donald Brown,85,29,114,2014,27,SDG,13,3,85,223,2.6,0,17.2,13,30.6,41,29,211,7.3,0,16.2,70.7,5.1,7,34.1,114,223,434,442,8,RB
1731,Ronnie Brown,20,5,25,2014,33,"HOU,SDG",10,0,20,63,3.2,0,6.3,5,50,8,5,44,8.8,0,4.4,62.5,5.5,1,37.5,25,63,107,107,0,RB
1732,Rex Burkhead,9,7,16,2014,24,CIN,9,0,9,27,3,1,3,1,11.1,10,7,49,7,0,5.4,70,4.9,3,40,16,27,76,76,0,RB
1733,Reggie Bush,76,40,116,2014,29,DET,11,9,76,297,3.9,2,27,9,43.4,56,40,253,6.3,0,23,71.4,4.5,13,39.3,116,297,550,550,0,RB
1734,Travaris Cadet,10,38,48,2014,25,NOR,15,1,10,32,3.2,0,2.1,1,40,51,38,296,7.8,1,19.7,74.5,5.8,15,51,48,32,328,692,364,RB
1735,Ka'Deem Carey,36,5,41,2014,22,CHI,14,0,36,158,4.4,0,11.3,11,52.8,6,5,57,11.4,0,4.1,83.3,9.5,2,66.7,41,158,215,215,0,RB
1736,John Carlson,0,33,33,2014,30,ARI,16,12,0,0,,0,0,0,,55,33,350,10.6,1,21.9,60,6.4,17,41.8,33,0,350,350,0,RB
1737,Jamaal Charles,206,40,246,2014,28,KAN,15,15,206,1033,5,9,68.9,51,52.9,59,40,291,7.3,5,19.4,67.8,4.9,16,37.3,246,1033,1324,1324,0,RB
1738,Tyler Clutts,0,1,1,2014,30,DAL,16,1,0,0,,0,0,0,,1,1,1,1,0,0.1,100,1,0,0,1,0,1,1,0,RB
1739,Derrick Coleman,0,2,2,2014,24,SEA,5,1,0,0,,0,0,0,,2,2,29,14.5,1,5.8,100,14.5,2,100,2,0,29,29,0,RB
1740,Jed Collins,8,5,13,2014,28,DET,16,2,8,19,2.4,0,1.2,5,62.5,6,5,39,7.8,1,2.4,83.3,6.5,2,50,13,19,58,58,0,RB
1741,John Conner,6,2,8,2014,27,NYJ,12,3,6,20,3.3,0,1.7,1,33.3,3,2,35,17.5,1,2.9,66.7,11.7,2,66.7,8,20,55,67,12,RB
1742,Michael Cox,4,2,6,2014,26,NYG,4,0,4,33,8.3,0,8.3,1,50,3,2,9,4.5,0,2.3,66.7,3,0,0,6,33,42,303,261,RB
1743,Isaiah Crowell,148,9,157,2014,21,CLE,16,4,148,607,4.1,8,37.9,35,42.6,14,9,87,9.7,0,5.4,64.3,6.2,4,50,157,607,694,694,0,RB
1744,Benny Cunningham,66,45,111,2014,24,STL,16,2,66,246,3.7,3,15.4,12,37.9,52,45,352,7.8,1,22,86.5,6.8,21,51.9,111,246,598,1561,963,RB
1745,Orleans Darkwa,9,5,14,2014,22,"MIA,NYG",11,0,9,23,2.6,1,2.1,1,44.4,6,5,48,9.6,0,4.4,83.3,8,3,66.7,14,23,71,71,0,RB
1746,Knile Davis,134,16,150,2014,23,KAN,16,1,134,463,3.5,6,28.9,26,34.3,25,16,147,9.2,1,9.2,64,5.9,6,32,150,463,610,1439,829,RB
1747,James Develin,3,6,9,2014,26,NWE,16,4,3,5,1.7,0,0.3,0,33.3,8,6,43,7.2,0,2.7,75,5.4,3,37.5,9,5,48,48,0,RB
1748,Patrick DiMarco,0,9,9,2014,25,ATL,16,7,0,0,,0,0,0,,14,9,62,6.9,1,3.9,64.3,4.4,4,42.9,9,0,62,62,0,RB
1749,Anthony Dixon,105,8,113,2014,27,BUF,16,0,105,432,4.1,2,27,14,46.7,9,8,49,6.1,0,3.1,88.9,5.4,3,55.6,113,432,481,533,52,RB
1750,Shaun Draughn,10,0,10,2014,27,"CHI,CLE,SDG",10,0,10,19,1.9,0,1.9,0,0,0,0,0,,0,0,,,0,,10,19,19,192,173,RB
1751,Maurice Jones-Drew,43,11,54,2014,29,OAK,12,1,43,96,2.2,0,8,2,23.3,16,11,71,6.5,0,5.9,68.8,4.4,3,43.8,54,96,167,167,0,RB
1752,Lance Dunbar,29,18,47,2014,24,DAL,16,0,29,99,3.4,0,6.2,6,37.9,22,18,217,12.1,0,13.6,81.8,9.9,12,59.1,47,99,316,362,46,RB
1753,Jonathan Dwyer,16,2,18,2014,25,ARI,2,0,16,51,3.2,1,25.5,3,25,3,2,8,4,0,4,66.7,2.7,0,0,18,51,59,59,0,RB
1754,Andre Ellington,201,46,247,2014,25,ARI,12,12,201,660,3.3,3,55,31,35.8,64,46,395,8.6,2,32.9,71.9,6.2,19,40.6,247,660,1055,1055,0,RB
1755,Jerome Felton,4,0,4,2014,28,MIN,16,3,4,27,6.8,0,1.7,2,50,2,0,0,,0,0,0,0,0,0,4,27,27,63,36,RB
1756,Tony Fiammetta,0,0,0,2014,28,CHI,1,0,0,0,,0,0,0,,0,0,0,,0,0,,,0,,0,0,0,0,0,RB
1757,Justin Forsett,235,44,279,2014,29,BAL,16,14,235,1266,5.4,8,79.1,57,42.6,59,44,263,6,0,16.4,74.6,4.5,10,39,279,1266,1529,1529,0,RB
1758,Matt Forte,266,102,368,2014,29,CHI,16,16,266,1038,3.9,6,64.9,65,48.9,130,102,808,7.9,4,50.5,78.5,6.2,28,46.2,368,1038,1846,1846,0,RB
1759,Arian Foster,260,38,298,2014,28,HOU,13,13,260,1246,4.8,8,95.8,55,45,59,38,327,8.6,5,25.2,64.4,5.5,15,35.6,298,1251,1573,1573,0,RB
1760,Devonta Freeman,65,30,95,2014,22,ATL,16,0,65,248,3.8,1,15.5,10,27.7,37,30,225,7.5,1,14.1,81.1,6.1,8,45.9,95,248,473,473,0,RB
1761,Toby Gerhart,101,20,121,2014,27,JAX,14,7,101,326,3.2,2,23.3,23,41.6,24,20,186,9.3,0,13.3,83.3,7.8,10,62.5,121,326,512,512,0,RB
1762,Frank Gore,255,11,266,2014,31,SFO,16,16,255,1106,4.3,4,69.1,55,48.2,19,11,111,10.1,1,6.9,57.9,5.8,2,26.3,266,1106,1217,1217,0,RB
1763,Cyrus Gray,8,0,8,2014,25,KAN,9,0,8,31,3.9,1,3.4,1,50,0,0,0,,0,0,,,0,,8,31,31,31,0,RB
1764,Jonas Gray,89,1,90,2014,24,NWE,8,3,89,412,4.6,5,51.5,27,60.7,3,1,7,7,0,0.9,33.3,2.3,0,33.3,90,412,419,419,0,RB
1765,Shonn Greene,94,1,95,2014,29,TEN,13,5,94,392,4.2,2,30.2,18,45.7,3,1,13,13,0,1,33.3,4.3,1,33.3,95,392,405,405,0,RB
1766,Marion Grice,15,7,22,2014,23,ARI,10,0,15,41,2.7,1,4.1,3,53.3,11,7,29,4.1,0,2.9,63.6,2.6,3,36.4,22,41,70,70,0,RB
1767,Jonathan Grimes,39,6,45,2014,25,HOU,16,0,39,153,3.9,0,9.6,5,43.6,8,6,86,14.3,0,5.4,75,10.8,4,62.5,45,153,239,239,0,RB
1768,Cory Harkey,0,8,8,2014,24,STL,16,13,0,0,,0,0,0,,11,8,55,6.9,1,3.4,72.7,5,5,54.5,8,0,55,55,0,RB
1769,DuJuan Harris,16,1,17,2014,26,GNB,15,0,16,64,4,0,4.3,5,56.3,2,1,11,11,0,0.7,50,5.5,1,50,17,64,75,531,456,RB
1770,Josh Harris,9,0,9,2014,23,PIT,5,0,9,16,1.8,0,3.2,2,11.1,0,0,0,,0,0,,,0,,9,16,16,16,0,RB
1771,Roy Helu,40,42,82,2014,26,WAS,14,0,40,216,5.4,1,15.4,10,55,47,42,477,11.4,2,34.1,89.4,10.1,16,46.8,82,216,693,693,0,RB
1772,Dan Herron,78,21,99,2014,25,IND,16,3,78,351,4.5,1,21.9,17,50,26,21,173,8.2,0,10.8,80.8,6.7,7,50,99,351,524,602,78,RB
1773,Jeremy Hill,222,27,249,2014,22,CIN,16,8,222,1124,5.1,9,70.3,61,52.3,32,27,215,8,0,13.4,84.4,6.7,7,46.9,249,1124,1339,1339,0,RB
1774,Michael Hill,0,0,0,2014,25,IND,0,0,0,0,,0,,0,,0,0,0,,0,,,,0,,0,0,0,0,,RB
1775,Peyton Hillis,26,10,36,2014,28,NYG,9,0,26,115,4.4,0,12.8,4,38.5,16,10,87,8.7,0,9.7,62.5,5.4,2,37.5,36,115,202,202,0,RB
1776,Ronnie Hillman,106,21,127,2014,23,DEN,8,4,106,434,4.1,3,54.3,20,40.6,34,21,139,6.6,1,17.4,61.8,4.1,7,32.4,127,434,573,573,0,RB
1777,Robert Hughes,7,8,15,2014,25,ARI,16,4,7,11,1.6,0,0.7,3,42.9,12,8,140,17.5,0,8.8,66.7,11.7,7,66.7,15,11,151,151,0,RB
1778,Carlos Hyde,83,12,95,2014,24,SFO,14,0,83,333,4,4,23.8,17,43.4,16,12,68,5.7,0,4.9,75,4.3,4,25,95,333,401,669,268,RB
1779,Henry Hynoski,7,0,7,2014,26,NYG,16,4,7,13,1.9,0,0.8,4,71.4,0,0,0,,0,0,,,0,,7,13,13,13,0,RB
1780,Mark Ingram,226,29,255,2014,25,NOR,13,9,226,964,4.3,9,74.2,52,49.1,36,29,145,5,0,11.2,80.6,4,5,38.9,255,964,1109,1109,0,RB
1781,Chris Ivory,198,18,216,2014,26,NYJ,16,10,198,821,4.1,6,51.3,43,44.4,27,18,123,6.8,1,7.7,66.7,4.6,4,40.7,216,821,944,944,0,RB
1782,Fred Jackson,141,66,207,2014,33,BUF,14,9,141,525,3.7,2,37.5,24,46.1,90,66,501,7.6,1,35.8,73.3,5.6,26,46.7,207,525,1026,1031,5,RB
1783,Steven Jackson,190,20,210,2014,31,ATL,15,15,190,707,3.7,6,47.1,38,50,27,20,148,7.4,0,9.9,74.1,5.5,6,48.1,210,707,855,855,0,RB
1784,LaMichael James,5,0,5,2014,25,"MIA,SFO",3,0,5,9,1.8,0,3,0,0,1,0,0,,0,0,0,0,0,0,5,9,9,9,0,RB
1785,Mike James,19,1,20,2014,23,TAM,11,0,19,37,1.9,0,3.4,4,31.6,1,1,-5,-5,0,-0.5,100,-5,0,0,20,37,32,32,0,RB
1786,Rashad Jennings,167,30,197,2014,29,NYG,11,9,167,639,3.8,4,58.1,39,47.3,41,30,226,7.5,0,20.5,73.2,5.5,8,34.1,197,639,865,865,0,RB
1787,Austin Johnson,8,2,10,2014,25,NOR,7,1,8,22,2.8,0,3.1,5,62.5,2,2,15,7.5,1,2.1,100,7.5,2,100,10,22,37,37,0,RB
1788,Chris Johnson,155,24,179,2014,29,NYJ,16,6,155,663,4.3,1,41.4,22,44.5,34,24,151,6.3,1,9.4,70.6,4.4,9,38.2,179,663,814,814,0,RB
1789,Storm Johnson,29,1,30,2014,22,JAX,6,1,29,86,3,2,14.3,5,31,1,1,-4,-4,0,-0.7,100,-4,0,0,30,86,82,82,0,RB
1790,Will Johnson,2,6,8,2014,25,PIT,16,5,2,0,0,0,0,0,0,9,6,41,6.8,0,2.6,66.7,4.6,3,44.4,8,0,41,41,0,RB
1791,Taiwan Jones,0,0,0,2014,26,OAK,1,0,0,0,,0,0,0,,0,0,0,,0,0,,,0,,0,0,0,0,0,RB
1792,Kyle Juszczyk,0,19,19,2014,23,BAL,16,14,0,0,,0,0,0,,27,19,182,9.6,1,11.4,70.4,6.7,6,59.3,19,0,182,210,28,RB
1793,John Kuhn,24,4,28,2014,32,GNB,16,2,24,85,3.5,1,5.3,4,54.2,4,4,23,5.8,0,1.4,100,5.8,0,75,28,85,108,108,0,FB
1794,Eddie Lacy,246,42,288,2014,24,GNB,16,16,246,1139,4.6,9,71.2,60,45.9,55,42,427,10.2,4,26.7,76.4,7.8,18,52.7,288,1139,1566,1566,0,RB
1795,Jorvorskie Lane,3,1,4,2014,27,TAM,9,4,3,58,19.3,0,6.4,1,66.7,1,1,3,3,0,0.3,100,3,0,0,4,58,61,70,9,RB
1796,Brian Leonard,0,1,1,2014,30,NOR,1,0,0,0,,0,0,0,,1,1,15,15,0,15,100,15,1,100,1,0,15,15,0,RB
1797,Zach Line,0,0,0,2014,24,MIN,1,0,0,0,,0,0,0,,0,0,0,,0,0,,,0,,0,0,0,0,0,RB
1798,Erik Lorig,3,9,12,2014,28,NOR,10,6,3,4,1.3,0,0.4,0,33.3,10,9,27,3,1,2.7,90,2.7,2,30,12,4,31,31,0,RB
1799,Marshawn Lynch,280,37,317,2014,28,SEA,16,14,280,1306,4.7,13,81.6,67,52.1,48,37,367,9.9,4,22.9,77.1,7.6,16,45.8,317,1306,1673,1673,0,RB
1800,Doug Martin,134,13,147,2014,25,TAM,11,11,134,494,3.7,2,44.9,24,35.8,20,13,64,4.9,0,5.8,65,3.2,3,25,147,494,558,558,0,RB
1801,Tre Mason,179,16,195,2014,21,STL,12,9,179,765,4.3,4,63.8,38,40.8,26,16,148,9.3,1,12.3,61.5,5.7,8,46.2,195,765,913,913,0,RB
1802,Ryan Mathews,74,9,83,2014,27,SDG,6,6,74,330,4.5,3,55,19,47.3,10,9,69,7.7,0,11.5,90,6.9,4,80,83,330,399,399,0,RB
1803,Onterio McCalebb,0,0,0,2014,25,CIN,1,0,0,0,,0,0,0,,0,0,0,,0,0,,,0,,0,0,0,0,0,RB
1804,LeSean McCoy,312,28,340,2014,26,PHI,16,16,312,1319,4.2,5,82.4,68,44.6,37,28,155,5.5,0,9.7,75.7,4.2,10,43.2,340,1319,1474,1474,0,RB
1805,Darren McFadden,155,36,191,2014,27,OAK,16,12,155,534,3.4,2,33.4,21,40.6,56,36,212,5.9,0,13.3,64.3,3.8,8,33.9,191,534,746,805,59,RB
1806,Jerick McKinnon,113,27,140,2014,22,MIN,11,6,113,538,4.8,0,48.9,24,40.7,41,27,135,5,0,12.3,65.9,3.3,7,24.4,140,538,673,673,0,RB
1807,Joe McKnight,1,6,7,2014,26,KAN,2,0,1,3,3,0,1.5,0,0,7,6,64,10.7,2,32,85.7,9.1,5,85.7,7,3,67,132,65,RB
1808,Christine Michael,34,1,35,2014,24,SEA,10,0,34,175,5.1,0,17.5,11,50,2,1,12,12,0,1.2,50,6,0,50,35,175,187,187,0,RB
1809,Bruce Miller,6,18,24,2014,27,SFO,16,8,6,9,1.5,0,0.6,2,33.3,25,18,189,10.5,2,11.8,72,7.6,11,60,24,9,198,217,19,RB
1810,Lamar Miller,216,38,254,2014,23,MIA,16,16,216,1099,5.1,8,68.7,57,54.6,52,38,275,7.2,1,17.2,73.1,5.3,10,46.2,254,1099,1374,1374,0,RB
1811,Knowshon Moreno,31,1,32,2014,27,MIA,3,0,31,148,4.8,1,49.3,8,64.5,1,1,8,8,0,2.7,100,8,0,100,32,148,156,156,0,RB
1812,Alfred Morris,265,17,282,2014,26,WAS,16,16,265,1074,4.1,8,67.1,53,46,26,17,155,9.1,0,9.7,65.4,6,8,38.5,282,1074,1229,1229,0,RB
1813,DeMarco Murray,392,57,449,2014,26,DAL,16,16,392,1845,4.7,13,115.3,89,53.1,64,57,416,7.3,0,26,89.1,6.5,17,54.7,449,1845,2261,2261,0,RB
1814,Latavius Murray,82,17,99,2014,24,OAK,15,3,82,424,5.2,2,28.3,18,42.7,23,17,143,8.4,0,9.5,73.9,6.2,3,30.4,99,424,567,996,429,RB
1815,Chris Ogbonnaya,14,0,14,2014,28,"CAR,NYG",7,0,14,50,3.6,1,7.1,3,57.1,1,0,0,,0,0,0,0,0,0,14,50,50,50,0,RB
1816,Jamize Olawale,2,5,7,2014,25,OAK,16,0,2,0,0,0,0,0,0,6,5,18,3.6,2,1.1,83.3,3,2,66.7,7,0,18,18,0,FB
1817,Branden Oliver,160,36,196,2014,23,SDG,14,7,160,582,3.6,3,41.6,31,42.5,45,36,271,7.5,1,19.4,80,6,11,46.7,196,582,853,875,22,RB
1818,Montell Owens,0,0,0,2014,30,"CHI,DET",6,0,0,0,,0,0,0,,0,0,0,,0,0,,,0,,0,0,0,0,0,RB
1819,Jalen Parmele,1,0,1,2014,29,ARI,1,0,1,0,0,0,0,0,0,0,0,0,,0,0,,,0,,1,0,0,0,0,RB
1820,Cedric Peerman,15,3,18,2014,28,CIN,16,0,15,43,2.9,0,2.7,3,13.3,5,3,27,9,0,1.7,60,5.4,1,20,18,43,70,70,0,RB
1821,Senorise Perry,0,1,1,2014,23,CHI,16,0,0,0,,0,0,0,,1,1,-1,-1,0,-0.1,100,-1,0,0,1,0,-1,87,88,RB
1822,Adrian Peterson,21,2,23,2014,29,MIN,1,1,21,75,3.6,0,75,4,42.9,3,2,18,9,0,18,66.7,6,1,66.7,23,75,93,93,0,RB
1823,Bernard Pierce,93,2,95,2014,23,BAL,13,2,93,366,3.9,2,28.2,20,38.7,6,2,13,6.5,0,1,33.3,2.2,0,16.7,95,366,379,379,0,RB
1824,Chris Polk,46,2,48,2014,25,PHI,14,0,46,172,3.7,4,12.3,12,50,3,2,16,8,0,1.1,66.7,5.3,1,33.3,48,172,188,528,340,RB
1825,Tauren Poole,1,0,1,2014,25,CAR,1,0,1,0,0,0,0,0,0,0,0,0,,0,0,,,0,,1,0,0,0,0,RB
1826,Bilal Powell,33,11,44,2014,26,NYJ,15,1,33,141,4.3,1,9.4,7,48.5,15,11,92,8.4,0,6.1,73.3,6.1,5,33.3,44,141,233,267,34,RB
1827,Jay Prosch,0,1,1,2014,22,HOU,16,5,0,0,,0,0,0,,4,1,24,24,0,1.5,25,6,1,25,1,0,24,24,0,RB
1828,Bobby Rainey,94,33,127,2014,27,TAM,15,5,94,406,4.3,1,27.1,21,43.6,45,33,315,9.5,1,21,73.3,7,13,46.7,127,406,721,934,213,RB
1829,Joseph Randle,51,4,55,2014,23,DAL,16,0,51,343,6.7,3,21.4,12,49,5,4,23,5.8,0,1.4,80,4.6,1,40,55,343,366,366,0,RB
1830,Darrin Reaves,31,5,36,2014,21,CAR,6,1,31,78,2.5,0,13,3,35.5,8,5,31,6.2,0,5.2,62.5,3.9,1,37.5,36,78,109,109,0,RB
1831,Silas Redd,16,8,24,2014,22,WAS,15,0,16,75,4.7,1,5,6,50,10,8,107,13.4,0,7.1,80,10.7,5,60,24,75,182,182,0,RB
1832,Marcel Reece,21,37,58,2014,29,OAK,15,15,21,85,4,0,5.7,5,47.6,59,37,265,7.2,1,17.7,62.7,4.5,12,42.4,58,85,350,350,0,RB
1833,Chase Reynolds,0,0,0,2014,27,STL,15,0,0,0,,0,0,0,,0,0,0,,0,0,,,0,,0,0,0,0,0,RB
1834,Trent Richardson,159,27,186,2014,24,IND,15,12,159,519,3.3,3,34.6,27,40.3,34,27,229,8.5,0,15.3,79.4,6.7,9,50,186,519,748,750,0,RB
1835,Theo Riddick,20,34,54,2014,23,DET,14,2,20,51,2.6,0,3.6,2,40,50,34,316,9.3,4,22.6,68,6.3,14,42,54,51,367,367,0,RB
1836,Stevan Ridley,94,4,98,2014,25,NWE,6,5,94,340,3.6,2,56.7,17,53.2,5,4,20,5,0,3.3,80,4,0,60,98,340,360,360,0,RB
1837,Denard Robinson,135,23,158,2014,24,JAX,13,9,135,582,4.3,4,44.8,24,38.5,31,23,124,5.4,0,9.5,74.2,4,7,32.3,158,582,706,706,0,RB
1838,Khiry Robinson,76,8,84,2014,25,NOR,10,3,76,362,4.8,3,36.2,23,53.9,11,8,63,7.9,0,6.3,72.7,5.7,3,27.3,84,362,425,453,28,RB
1839,Patrick Robinson,0,0,0,2014,27,NOR,14,6,0,0,,0,0,0,,0,0,0,,0,0,,,0,,0,0,0,2,0,RB
1840,Jacquizz Rodgers,58,29,87,2014,24,ATL,16,1,58,217,3.7,1,13.6,12,39.7,40,29,173,6,1,10.8,72.5,4.3,9,40,87,217,390,400,10,RB
1841,Bishop Sankey,152,18,170,2014,22,TEN,16,9,152,569,3.7,2,35.6,26,44.1,23,18,133,7.4,0,8.3,78.3,5.8,5,47.8,170,569,702,900,198,RB
1842,Anthony Sherman,2,10,12,2014,26,KAN,16,6,2,8,4,0,0.5,1,50,14,10,71,7.1,1,4.4,71.4,5.1,4,28.6,12,8,79,92,13,RB
1843,Charles Sims,66,19,85,2014,24,TAM,8,0,66,185,2.8,1,23.1,10,31.8,27,19,190,10,0,23.8,70.4,7,7,37,85,185,375,375,0,RB
1844,Kiero Small,0,0,0,2014,25,CLE,3,3,0,0,,0,0,0,,0,0,0,,0,0,,,0,,0,0,0,0,0,RB
1845,Alfonso Smith,7,3,10,2014,27,SFO,6,0,7,19,2.7,0,3.2,1,28.6,4,3,11,3.7,0,1.8,75,2.8,0,0,10,19,30,30,0,RB
1846,Antone Smith,23,13,36,2014,29,ATL,10,0,23,144,6.3,2,14.4,6,56.5,15,13,222,17.1,3,22.2,86.7,14.8,5,66.7,36,144,366,366,0,RB
1847,Jerome Smith,0,0,0,2014,23,ATL,1,0,0,0,,0,0,0,,0,0,0,,0,0,,,0,,0,0,0,0,0,RB
1848,C.J. Spiller,78,19,97,2014,27,BUF,9,5,78,300,3.8,0,33.3,12,39.7,22,19,125,6.6,1,13.9,86.4,5.7,7,59.1,97,300,425,731,306,RB
1849,Darren Sproles,57,40,97,2014,31,PHI,15,0,57,329,5.8,6,21.9,18,43.9,62,40,387,9.7,0,25.8,64.5,6.2,18,41.9,97,329,716,1230,521,RB
1850,Zac Stacy,76,18,94,2014,23,STL,13,5,76,293,3.9,1,22.5,13,51.3,23,18,152,8.4,0,11.7,78.3,6.6,9,60.9,94,293,445,445,0,RB
1851,James Starks,85,18,103,2014,28,GNB,16,0,85,333,3.9,2,20.8,17,37.6,29,18,140,7.8,0,8.8,62.1,4.8,6,34.5,103,333,473,473,0,RB
1852,Jeremy Stewart,6,0,6,2014,25,DEN,6,0,6,22,3.7,0,3.7,1,33.3,0,0,0,,0,0,,,0,,6,22,22,22,0,RB
1853,Jonathan Stewart,175,25,200,2014,27,CAR,13,8,175,809,4.6,3,62.2,42,49.7,31,25,181,7.2,1,13.9,80.6,5.8,7,51.6,200,809,990,990,0,RB
1854,Luke Stocker,0,7,7,2014,26,TAM,13,7,0,0,,0,0,0,,11,7,41,5.9,0,3.2,63.6,3.7,2,45.5,7,0,41,41,0,RB
1855,Frank Summers,6,5,11,2014,29,BUF,10,6,6,17,2.8,1,1.7,4,66.7,8,5,9,1.8,0,0.9,62.5,1.1,0,0,11,17,26,37,11,RB
1856,Lorenzo Taliaferro,68,8,76,2014,23,BAL,13,0,68,292,4.3,4,22.5,17,48.5,10,8,114,14.3,0,8.8,80,11.4,4,50,76,292,406,421,15,RB
1857,Phillip Tanner,0,0,0,2014,26,SFO,2,0,0,0,,0,0,0,,0,0,0,,0,0,,,0,,0,0,0,0,0,RB
1858,Ben Tate,119,9,128,2014,26,"CLE,MIN,PIT",11,6,119,371,3.1,4,33.7,18,34.5,12,9,60,6.7,0,5.5,75,5,3,25,128,371,431,431,0,RB
1859,Will Ta'ufo'ou,0,7,7,2014,28,JAX,16,4,0,0,,0,0,0,,8,7,81,11.6,0,5.1,87.5,10.1,5,75,7,0,81,81,0,RB
1860,Stepfan Taylor,63,11,74,2014,23,ARI,14,4,63,208,3.3,1,14.9,13,39.7,15,11,79,7.2,3,5.6,73.3,5.3,5,53.3,74,208,287,287,0,RB
1861,Marcus Thigpen,0,0,0,2014,28,"BUF,TAM",9,0,0,0,,0,0,0,,1,0,0,,0,0,0,0,0,0,0,0,0,505,505,RB
1862,Chris Thompson,3,6,9,2014,24,WAS,2,0,3,12,4,0,6,0,66.7,7,6,27,4.5,1,13.5,85.7,3.9,2,28.6,9,12,39,39,0,RB
1863,Daniel Thomas,44,13,57,2014,27,MIA,12,0,44,168,3.8,2,14,8,54.5,19,13,121,9.3,0,10.1,68.4,6.4,8,47.4,57,168,289,289,0,RB
1864,De'Anthony Thomas,14,23,37,2014,21,KAN,12,3,14,113,8.1,1,9.4,3,71.4,31,23,156,6.8,0,13,74.2,5,8,38.7,37,113,269,1102,833,RB
1865,Juwan Thompson,54,4,58,2014,22,DEN,15,0,54,272,5,3,18.1,19,57.4,7,4,25,6.3,0,1.7,57.1,3.6,0,28.6,58,272,297,297,0,RB
1866,Pierre Thomas,45,45,90,2014,30,NOR,11,3,45,222,4.9,2,20.2,14,62.2,55,45,378,8.4,1,34.4,81.8,6.9,19,49.1,90,222,600,600,0,RB
1867,Zurlon Tipton,10,6,16,2014,24,IND,6,0,10,18,1.8,0,3,0,20,6,6,68,11.3,1,11.3,100,11.3,5,83.3,16,18,86,86,0,RB
1868,Jordan Todman,32,25,57,2014,24,JAX,16,1,32,186,5.8,1,11.6,5,25,37,25,198,7.9,1,12.4,67.6,5.4,6,24.3,57,186,384,1356,972,RB
1869,Mike Tolbert,37,12,49,2014,29,CAR,8,6,37,78,2.1,0,9.8,5,27,17,12,93,7.8,0,11.6,70.6,5.5,4,23.5,49,78,171,173,2,RB
1870,Fitzgerald Toussaint,6,3,9,2014,24,BAL,4,0,6,12,2,0,3,2,33.3,6,3,27,9,0,6.8,50,4.5,1,50,9,12,39,80,41,RB
1871,Will Tukuafu,1,1,2,2014,30,SEA,9,2,1,2,2,0,0.2,1,100,2,1,4,4,0,0.4,50,2,1,50,2,2,6,6,0,FB
1872,Robert Turbin,74,16,90,2014,25,SEA,16,3,74,310,4.2,0,19.4,16,59.5,20,16,186,11.6,2,11.6,80,9.3,9,65,90,310,496,496,0,RB
1873,Shane Vereen,96,52,148,2014,25,NWE,16,6,96,391,4.1,2,24.4,15,39.6,77,52,447,8.6,3,27.9,67.5,5.8,24,41.6,148,391,838,838,0,RB
1874,Leon Washington,13,22,35,2014,32,TEN,16,0,13,57,4.4,0,3.6,1,15.4,31,22,159,7.2,2,9.9,71,5.1,8,32.3,35,57,216,1001,785,RB
1875,Trey Watts,7,3,10,2014,23,STL,14,0,7,30,4.3,0,2.1,3,57.1,4,3,18,6,0,1.3,75,4.5,2,50,10,30,48,48,0,RB
1876,Charcandrick West,0,0,0,2014,23,KAN,6,0,0,0,,0,0,0,,1,0,0,,0,0,0,0,0,0,0,0,0,0,0,RB
1877,Terrance West,171,11,182,2014,23,CLE,14,6,171,673,3.9,4,48.1,31,46.2,13,11,64,5.8,1,4.6,84.6,4.9,3,38.5,182,673,737,737,0,RB
1878,Fozzy Whittaker,32,5,37,2014,25,CAR,10,1,32,145,4.5,1,14.5,8,40.6,6,5,60,12,1,6,83.3,10,2,66.7,37,145,205,467,262,RB
1879,James White,9,5,14,2014,22,NWE,3,0,9,38,4.2,0,12.7,1,33.3,5,5,23,4.6,0,7.7,100,4.6,1,40,14,38,61,61,0,RB
1880,Andre Williams,217,18,235,2014,22,NYG,16,7,217,721,3.3,7,45.1,32,35,37,18,130,7.2,0,8.1,48.6,3.5,6,27,235,721,851,851,0,RB
1881,Damien Williams,36,21,57,2014,22,MIA,16,0,36,122,3.4,0,7.6,6,47.2,27,21,187,8.9,1,11.7,77.8,6.9,13,63,57,122,309,411,102,RB
1882,DeAngelo Williams,62,5,67,2014,31,CAR,6,6,62,219,3.5,0,36.5,7,43.5,6,5,44,8.8,0,7.3,83.3,7.3,2,66.7,67,219,263,263,0,RB
1883,Kerwynn Williams,53,2,55,2014,23,ARI,5,0,53,246,4.6,0,49.2,11,52.8,6,2,11,5.5,0,2.2,33.3,1.8,0,16.7,55,246,257,257,0,RB
1884,George Winn,19,0,19,2014,24,DET,12,0,19,73,3.8,0,6.1,4,47.4,3,0,0,,0,0,0,0,0,0,19,73,73,101,28,RB
1885,Glenn Winston,0,0,0,2014,25,CLE,5,0,0,0,,0,0,0,,0,0,0,,0,0,,,0,,0,0,0,0,0,RB
1886,Danny Woodhead,15,5,20,2014,29,SDG,3,0,15,38,2.5,0,12.7,2,33.3,6,5,34,6.8,0,11.3,83.3,5.7,4,83.3,20,38,72,72,0,RB
1887,Darrel Young,9,11,20,2014,27,WAS,16,10,9,22,2.4,3,1.4,6,66.7,14,11,81,7.4,2,5.1,78.6,5.8,6,50,20,22,103,113,10,RB
1888,C.J. Anderson,7,0,7,2013,22,DEN,5,0,7,38,5.4,0,7.6,3,85.7,1,0,0,,0,0,0,0,0,0,7,38,38,38,0,RB
1889,Matt Asiata,44,5,49,2013,26,MIN,11,1,44,166,3.8,3,15.1,11,52.3,8,5,13,2.6,0,1.2,62.5,1.6,1,37.5,49,166,179,207,28,RB
1890,Edwin Baker,43,8,51,2013,22,CLE,3,2,43,171,4,2,57,11,53.5,9,8,57,7.1,0,19,88.9,6.3,3,66.7,51,171,228,228,0,RB
1891,Montee Ball,120,20,140,2013,23,DEN,16,0,120,559,4.7,4,34.9,35,51.7,27,20,145,7.3,0,9.1,74.1,5.4,10,51.9,140,559,704,704,0,RB
1892,Vick Ballard,13,1,14,2013,23,IND,1,1,13,63,4.8,0,63,4,46.2,2,1,-5,-5,0,-5,50,-2.5,0,0,14,63,58,58,0,RB
1893,Joe Banyard,0,1,1,2013,25,MIN,3,0,0,0,,0,0,0,,1,1,11,11,0,3.7,100,11,1,100,1,0,11,17,6,RB
1894,Kenjon Barner,6,2,8,2013,24,CAR,8,0,6,7,1.2,0,0.9,0,0,3,2,7,3.5,0,0.9,66.7,2.3,0,0,8,7,14,31,17,RB
1895,Jackie Battle,36,4,40,2013,30,TEN,16,0,36,142,3.9,1,8.9,7,33.3,5,4,36,9,0,2.3,80,7.2,1,20,40,142,178,204,26,RB
1896,Joique Bell,166,53,219,2013,27,DET,16,4,166,650,3.9,8,40.6,43,50.6,69,53,547,10.3,0,34.2,76.8,7.9,23,53.6,219,650,1197,1201,4,RB
1897,Kahlil Bell,0,0,0,2013,27,GNB,3,0,0,0,,0,0,0,,0,0,0,,0,0,,,0,,0,0,0,22,22,RB
1898,Le'Veon Bell,244,45,289,2013,21,PIT,13,13,244,860,3.5,8,66.2,53,45.5,66,45,399,8.9,0,30.7,68.2,6,15,43.9,289,860,1259,1259,0,RB
1899,Giovani Bernard,170,56,226,2013,22,CIN,16,0,170,695,4.1,5,43.4,33,47.1,71,56,514,9.2,3,32.1,78.9,7.2,22,45.1,226,695,1209,1209,0,RB
1900,LeGarrette Blount,153,2,155,2013,27,NWE,16,7,153,772,5,7,48.3,37,52.3,5,2,38,19,0,2.4,40,7.6,1,40,155,772,810,1304,494,RB
1901,Tommy Bohanon,17,11,28,2013,23,NYJ,16,8,17,62,3.6,0,3.9,4,58.8,16,11,69,6.3,0,4.3,68.8,4.3,4,43.8,28,62,131,146,15,RB
1902,Brandon Bolden,55,21,76,2013,23,NWE,12,2,55,271,4.9,3,22.6,16,47.3,29,21,152,7.2,0,12.7,72.4,5.2,6,31,76,271,423,423,0,RB
1903,Ahmad Bradshaw,41,7,48,2013,27,IND,3,2,41,186,4.5,2,62,11,51.2,8,7,42,6,0,14,87.5,5.3,3,50,48,186,228,228,0,RB
1904,Allen Bradford,0,0,0,2013,25,"NYG,SEA",10,0,0,0,,0,0,0,,0,0,0,,0,0,,,0,,0,0,0,0,0,RB
1905,Andre Brown,139,20,159,2013,27,NYG,8,8,139,492,3.5,3,61.5,31,48.2,29,20,103,5.2,0,12.9,69,3.6,3,34.5,159,492,595,595,0,RB
1906,Bryce Brown,75,8,83,2013,22,PHI,16,1,75,314,4.2,2,19.6,16,48,13,8,84,10.5,0,5.3,61.5,6.5,2,30.8,83,314,398,398,0,RB
1907,Donald Brown,102,27,129,2013,26,IND,16,5,102,537,5.3,6,33.6,21,49,35,27,214,7.9,2,13.4,77.1,6.1,10,48.6,129,537,751,751,0,RB
1908,Ronnie Brown,45,8,53,2013,32,SDG,16,0,45,157,3.5,1,9.8,10,35.6,8,8,60,7.5,0,3.8,100,7.5,3,62.5,53,157,217,330,113,RB
1909,Rex Burkhead,0,0,0,2013,23,CIN,1,0,0,0,,0,0,0,,0,0,0,,0,0,,,0,,0,0,0,0,0,RB
1910,Michael Bush,63,4,67,2013,29,CHI,15,0,63,197,3.1,3,13.1,10,33.3,8,4,48,12,1,3.2,50,6,2,50,67,197,245,245,0,RB
1911,Reggie Bush,223,54,277,2013,28,DET,14,14,223,1006,4.5,4,71.9,49,44.8,80,54,506,9.4,3,36.1,67.5,6.3,22,45,277,1006,1512,1512,0,RB
1912,Travaris Cadet,0,2,2,2013,24,NOR,13,0,0,0,,0,0,0,,2,2,5,2.5,1,0.4,100,2.5,1,50,2,0,5,244,239,RB
1913,Delone Carter,0,0,0,2013,26,JAX,1,0,0,0,,0,0,0,,0,0,0,,0,0,,,0,,0,0,0,0,0,RB
1914,Jamaal Charles,259,70,329,2013,27,KAN,15,15,259,1287,5,12,85.8,72,49.4,104,70,693,9.9,7,46.2,67.3,6.7,32,44.2,329,1287,1980,1980,0,RB
1915,Tashard Choice,46,5,51,2013,29,"BUF,IND",15,0,46,170,3.7,0,11.3,8,47.8,9,5,15,3,0,1,55.6,1.7,1,22.2,51,170,185,213,28,RB
1916,Tyler Clutts,0,1,1,2013,29,"DAL,MIA",8,0,0,0,,0,0,0,,2,1,4,4,0,0.5,50,2,0,0,1,0,4,16,12,RB
1917,Derrick Coleman,2,8,10,2013,23,SEA,12,3,2,3,1.5,0,0.3,0,0,8,8,62,7.8,1,5.2,100,7.8,4,87.5,10,3,65,65,0,RB
1918,Jed Collins,15,14,29,2013,27,NOR,16,8,15,45,3,1,2.8,9,66.7,17,14,54,3.9,0,3.4,82.4,3.2,3,52.9,29,45,99,99,0,RB
1919,John Conner,0,6,6,2013,26,NYG,13,7,0,0,,0,0,0,,11,6,31,5.2,0,2.4,54.5,2.8,2,27.3,6,0,31,31,0,RB
1920,Michael Cox,22,3,25,2013,25,NYG,14,1,22,43,2,0,3.1,1,22.7,3,3,12,4,0,0.9,100,4,1,33.3,25,43,55,491,436,RB
1921,Benny Cunningham,47,6,53,2013,23,STL,14,0,47,261,5.6,1,18.6,11,44.7,10,6,59,9.8,0,4.2,60,5.9,2,40,53,261,320,619,299,RB
1922,Knile Davis,70,11,81,2013,22,KAN,16,1,70,242,3.5,4,15.1,10,31.4,15,11,75,6.8,0,4.7,73.3,5,5,46.7,81,242,317,638,321,RB
1923,Jeff Demps,1,3,4,2013,23,TAM,2,0,1,14,14,0,7,1,100,3,3,21,7,0,10.5,100,7,1,66.7,4,14,35,128,93,RB
1924,Patrick DiMarco,0,8,8,2013,24,ATL,14,7,0,0,,0,0,0,,10,8,49,6.1,0,3.5,80,4.9,1,50,8,0,49,70,21,RB
1925,Anthony Dixon,28,3,31,2013,26,SFO,16,1,28,56,2,2,3.5,6,39.3,3,3,30,10,0,1.9,100,10,1,66.7,31,56,86,187,101,RB
1926,Shaun Draughn,4,0,4,2013,26,BAL,3,0,4,2,0.5,0,0.7,1,25,0,0,0,,0,0,,,0,,4,2,2,55,53,RB
1927,Maurice Jones-Drew,234,43,277,2013,28,JAX,15,15,234,803,3.4,5,53.5,46,36.3,60,43,314,7.3,0,20.9,71.7,5.2,13,51.7,277,811,1117,1117,0,RB
1928,Lance Dunbar,30,7,37,2013,23,DAL,9,0,30,150,5,0,16.7,9,56.7,7,7,59,8.4,0,6.6,100,8.4,3,71.4,37,150,209,237,28,RB
1929,Jonathan Dwyer,49,8,57,2013,24,PIT,15,0,49,197,4,0,13.1,16,42.9,11,8,64,8,0,4.3,72.7,5.8,3,45.5,57,197,261,351,90,RB
1930,Andre Ellington,118,39,157,2013,24,ARI,15,1,118,652,5.5,3,43.5,27,44.1,57,39,371,9.5,1,24.7,68.4,6.5,21,42.1,157,652,1023,1044,21,RB
1931,Rhett Ellison,0,5,5,2013,25,MIN,11,6,0,0,,0,0,0,,10,5,61,12.2,1,5.5,50,6.1,4,50,5,0,61,68,7,RB
1932,Bradie Ewing,0,2,2,2013,24,ATL,2,2,0,0,,0,0,0,,2,2,29,14.5,0,14.5,100,14.5,2,100,2,0,29,29,0,RB
1933,Jerome Felton,0,6,6,2013,27,MIN,13,9,0,0,,0,0,0,,8,6,37,6.2,0,2.8,75,4.6,3,50,6,0,37,59,22,RB
1934,Tony Fiammetta,0,4,4,2013,27,CHI,16,7,0,0,,0,0,0,,6,4,57,14.3,0,3.6,66.7,9.5,2,66.7,4,0,57,57,0,FB
1935,Michael Ford,0,0,0,2013,23,CHI,12,0,0,0,,0,0,0,,0,0,0,,0,0,,,0,,0,0,0,37,37,RB
1936,Justin Forsett,6,15,21,2013,28,JAX,9,0,6,31,5.2,0,3.4,1,33.3,16,15,82,5.5,0,9.1,93.8,5.1,5,31.3,21,31,113,134,21,RB
1937,Matt Forte,289,74,363,2013,28,CHI,16,16,289,1339,4.6,9,83.7,73,42.2,95,74,594,8,3,37.1,77.9,6.3,26,48.4,363,1339,1933,1933,0,RB
1938,Arian Foster,121,22,143,2013,27,HOU,8,8,121,542,4.5,1,67.8,31,49.6,35,22,183,8.3,1,22.9,62.9,5.2,6,28.6,143,542,725,725,0,RB
1939,Johnathan Franklin,19,4,23,2013,24,GNB,11,0,19,107,5.6,1,9.7,7,52.6,5,4,30,7.5,0,2.7,80,6,2,80,23,107,137,219,82,RB
1940,Toby Gerhart,36,13,49,2013,26,MIN,14,0,36,283,7.9,2,20.2,13,55.6,19,13,88,6.8,0,6.3,68.4,4.6,3,47.4,49,283,371,477,106,RB
1941,Mike Gillislee,6,0,6,2013,23,MIA,3,0,6,21,3.5,0,7,1,50,0,0,0,,0,0,,,0,,6,21,21,21,0,RB
1942,Mike Goodson,7,2,9,2013,26,NYJ,2,0,7,61,8.7,0,30.5,2,42.9,3,2,19,9.5,0,9.5,66.7,6.3,2,66.7,9,61,80,80,0,RB
1943,Frank Gore,276,16,292,2013,30,SFO,16,16,276,1128,4.1,9,70.5,50,38.8,27,16,141,8.8,0,8.8,59.3,5.2,5,29.6,292,1128,1269,1269,0,RB
1944,Ray Graham,4,1,5,2013,23,HOU,1,0,4,8,2,0,8,0,25,3,1,12,12,0,12,33.3,4,1,33.3,5,8,20,20,0,RB
1945,Cyrus Gray,9,7,16,2013,24,KAN,16,0,9,24,2.7,0,1.5,1,22.2,10,7,46,6.6,0,2.9,70,4.6,2,30,16,24,70,70,0,RB
1946,Alex Green,11,2,13,2013,25,NYJ,13,0,11,35,3.2,0,2.7,2,45.5,2,2,8,4,0,0.6,100,4,0,50,13,35,43,65,22,RB
1947,BenJarvus Green-Ellis,220,4,224,2013,28,CIN,16,16,220,756,3.4,7,47.3,49,47.3,8,4,22,5.5,0,1.4,50,2.8,1,12.5,224,756,778,778,0,RB
1948,Isaiah Green,0,0,0,2013,24,PIT,3,0,0,0,,0,0,0,,0,0,0,,0,0,,,0,,0,0,0,0,0,FB
1949,Shonn Greene,77,6,83,2013,28,TEN,11,0,77,295,3.8,4,26.8,20,58.4,8,6,39,6.5,0,3.5,75,4.9,1,12.5,83,295,334,334,0,RB
1950,Jonathan Grimes,21,6,27,2013,24,HOU,2,1,21,73,3.5,1,36.5,6,47.6,6,6,76,12.7,0,38,100,12.7,2,66.7,27,73,149,149,0,RB
1951,Cory Harkey,0,13,13,2013,23,STL,15,10,0,0,,0,0,0,,18,13,113,8.7,2,7.5,72.2,6.3,7,61.1,13,0,113,113,0,RB
1952,Stanley Havili,7,18,25,2013,26,IND,13,8,7,7,1,0,0.5,1,14.3,21,18,128,7.1,1,9.8,85.7,6.1,6,52.4,25,7,135,135,0,RB
1953,Roy Helu,62,31,93,2013,25,WAS,16,0,62,274,4.4,4,17.1,20,45.2,42,31,251,8.1,0,15.7,73.8,6,9,38.1,93,274,525,525,0,RB
1954,Dan Herron,5,1,6,2013,24,IND,6,0,5,33,6.6,0,5.5,2,80,1,1,57,57,0,9.5,100,57,1,100,6,33,90,103,13,RB
1955,Michael Hill,9,2,11,2013,24,"GNB,TAM",8,0,9,23,2.6,0,2.9,1,11.1,2,2,23,11.5,0,2.9,100,11.5,1,50,11,23,46,65,19,RB
1956,Peyton Hillis,73,13,86,2013,27,NYG,7,1,73,247,3.4,2,35.3,13,45.2,21,13,96,7.4,0,13.7,61.9,4.6,5,47.6,86,247,343,343,0,RB
1957,Ronnie Hillman,55,12,67,2013,22,DEN,10,0,55,218,4,1,21.8,14,52.7,14,12,119,9.9,0,11.9,85.7,8.5,7,71.4,67,218,337,337,0,RB
1958,Robert Hughes,0,1,1,2013,24,IND,1,0,0,0,,0,0,0,,2,1,6,6,0,6,50,3,0,0,1,0,6,6,0,RB
1959,Kendall Hunter,78,2,80,2013,25,SFO,16,0,78,358,4.6,3,22.4,19,35.9,4,2,13,6.5,0,0.8,50,3.3,0,25,80,358,371,454,81,RB
1960,Henry Hynoski,0,1,1,2013,25,NYG,3,2,0,0,,0,0,0,,2,1,5,5,0,1.7,50,2.5,0,0,1,0,5,5,0,RB
1961,Mark Ingram,78,7,85,2013,24,NOR,11,3,78,386,4.9,1,35.1,18,46.2,11,7,68,9.7,0,6.2,63.6,6.2,3,45.5,85,386,454,454,0,RB
1962,Chris Ivory,182,2,184,2013,25,NYJ,15,6,182,833,4.6,3,55.5,35,44,7,2,10,5,0,0.7,28.6,1.4,1,14.3,184,833,843,843,0,RB
1963,Fred Jackson,206,47,253,2013,32,BUF,16,6,206,890,4.3,9,55.6,54,51,65,47,387,8.2,1,24.2,72.3,6,17,43.1,253,890,1277,1277,0,RB
1964,Steven Jackson,157,33,190,2013,30,ATL,12,12,157,543,3.5,6,45.3,26,40.1,49,33,191,5.8,1,15.9,67.3,3.9,11,26.5,190,543,734,734,0,RB
1965,Brandon Jacobs,58,2,60,2013,31,NYG,7,1,58,238,4.1,4,34,16,44.8,7,2,13,6.5,0,1.9,28.6,1.9,0,28.6,60,238,251,251,0,RB
1966,LaMichael James,12,2,14,2013,24,SFO,10,0,12,59,4.9,0,5.9,2,33.3,3,2,16,8,0,1.6,66.7,5.3,1,66.7,14,59,75,647,572,RB
1967,Mike James,60,10,70,2013,22,TAM,8,3,60,295,4.9,0,36.9,14,50,11,10,43,4.3,0,5.4,90.9,3.9,1,45.5,70,297,338,338,0,RB
1968,Rashad Jennings,163,36,199,2013,28,OAK,15,8,163,733,4.5,6,48.9,35,46.6,48,36,292,8.1,0,19.5,75,6.1,12,52.1,199,733,1025,1025,0,RB
1969,Chris Johnson,279,42,321,2013,28,TEN,16,16,279,1077,3.9,6,67.3,57,44.8,52,42,345,8.2,4,21.6,80.8,6.6,11,38.5,321,1077,1422,1422,0,RB
1970,Dennis Johnson,49,8,57,2013,23,HOU,8,1,49,183,3.7,0,22.9,8,42.9,12,8,46,5.8,0,5.8,66.7,3.8,2,33.3,57,183,229,380,151,RB
1971,Quinn Johnson,0,0,0,2013,27,TEN,4,0,0,0,,0,0,0,,1,0,0,,0,0,0,0,0,0,0,0,0,0,0,RB
1972,Will Johnson,0,8,8,2013,24,PIT,15,5,0,0,,0,0,0,,11,8,41,5.1,1,2.7,72.7,3.7,3,54.5,8,0,41,41,0,RB
1973,Felix Jones,48,9,57,2013,26,PIT,16,2,48,184,3.8,0,11.5,9,37.5,13,9,63,7,0,3.9,69.2,4.8,2,53.8,57,184,247,757,510,RB
1974,Greg Jones,2,5,7,2013,32,HOU,16,5,2,2,1,0,0.1,0,50,11,5,34,6.8,0,2.1,45.5,3.1,1,27.3,7,2,36,79,43,RB
1975,Taiwan Jones,5,2,7,2013,25,OAK,16,0,5,23,4.6,0,1.4,1,20,3,2,55,27.5,0,3.4,66.7,18.3,1,33.3,7,23,78,701,623,RB
1976,Kyle Juszczyk,0,0,0,2013,22,BAL,16,0,0,0,,0,0,0,,1,0,0,,0,0,0,0,0,0,0,0,0,17,17,RB
1977,Deji Karim,12,1,13,2013,27,HOU,7,0,12,51,4.3,0,7.3,3,58.3,2,1,-1,-1,0,-0.1,50,-0.5,0,0,13,51,50,128,78,RB
1978,John Kuhn,10,13,23,2013,31,GNB,15,6,10,38,3.8,1,2.5,7,70,19,13,81,6.2,0,5.4,68.4,4.3,2,47.4,23,38,119,159,40,RB
1979,Eddie Lacy,284,35,319,2013,23,GNB,15,15,284,1178,4.1,11,78.5,63,44.4,44,35,257,7.3,0,17.1,79.5,5.8,12,50,319,1178,1435,1435,0,RB
1980,Spencer Larsen,0,0,0,2013,29,TAM,13,1,0,0,,0,0,0,,0,0,0,,0,0,,,0,,0,0,0,17,17,FB
1981,Vonta Leach,11,11,22,2013,32,BAL,16,7,11,23,2.1,0,1.4,2,36.4,20,11,47,4.3,1,2.9,55,2.4,3,25,22,23,70,70,0,RB
1982,Brian Leonard,47,29,76,2013,29,TAM,16,1,47,182,3.9,0,11.4,12,40.4,37,29,179,6.2,0,11.2,78.4,4.8,9,37.8,76,182,361,361,0,RB
1983,Mikel Leshoure,2,0,2,2013,23,DET,3,0,2,9,4.5,0,3,0,0,0,0,0,,0,0,,,0,,2,9,9,9,0,RB
1984,Zach Line,0,1,1,2013,23,MIN,3,1,0,0,,0,0,0,,3,1,8,8,0,2.7,33.3,2.7,0,0,1,0,8,8,0,RB
1985,Erik Lorig,0,11,11,2013,27,TAM,15,9,0,0,,0,0,0,,14,11,47,4.3,0,3.1,78.6,3.4,2,28.6,11,0,47,53,6,RB
1986,Marshawn Lynch,301,36,337,2013,27,SEA,16,16,301,1257,4.2,12,78.6,73,48.2,44,36,316,8.8,2,19.8,81.8,7.2,12,40.9,337,1257,1573,1573,0,RB
1987,Doug Martin,127,12,139,2013,24,TAM,6,6,127,456,3.6,1,76,18,37.8,24,12,66,5.5,0,11,50,2.8,1,16.7,139,456,522,562,40,RB
1988,Ryan Mathews,285,26,311,2013,26,SDG,16,14,285,1255,4.4,6,78.4,55,47.7,33,26,189,7.3,1,11.8,78.8,5.7,9,57.6,311,1255,1444,1444,0,RB
1989,Le'Ron McClain,11,2,13,2013,29,SDG,16,2,11,32,2.9,0,2,7,72.7,4,2,-7,-3.5,0,-0.4,50,-1.8,0,0,13,32,25,25,0,RB
1990,LeSean McCoy,314,52,366,2013,25,PHI,16,16,314,1607,5.1,9,100.4,79,49.7,64,52,539,10.4,2,33.7,81.3,8.4,24,51.6,366,1607,2146,2146,0,RB
1991,Darren McFadden,114,17,131,2013,26,OAK,10,7,114,379,3.3,5,37.9,17,30.7,25,17,108,6.4,0,10.8,68,4.3,4,36,131,395,487,487,0,RB
1992,Willis McGahee,138,8,146,2013,32,CLE,12,6,138,377,2.7,2,31.4,31,43.5,11,8,20,2.5,0,1.7,72.7,1.8,0,18.2,146,377,397,397,0,RB
1993,Rashard Mendenhall,217,18,235,2013,26,ARI,15,15,217,687,3.2,8,45.8,45,40.6,21,18,134,7.4,0,8.9,85.7,6.4,5,52.4,235,687,821,821,0,RB
1994,Christine Michael,18,0,18,2013,23,SEA,4,0,18,79,4.4,0,19.8,5,61.1,0,0,0,,0,0,,,0,,18,79,79,79,0,RB
1995,Bruce Miller,7,25,32,2013,26,SFO,14,13,7,13,1.9,0,0.9,3,42.9,36,25,243,9.7,0,17.4,69.4,6.8,12,52.8,32,13,256,256,0,RB
1996,Lamar Miller,177,26,203,2013,22,MIA,16,15,177,709,4,2,44.3,27,44.6,35,26,170,6.5,0,10.6,74.3,4.9,6,31.4,203,709,879,879,0,RB
1997,Collin Mooney,0,6,6,2013,27,TEN,12,4,0,0,,0,0,0,,6,6,32,5.3,0,2.7,100,5.3,1,50,6,0,32,32,0,RB
1998,Knowshon Moreno,241,60,301,2013,26,DEN,16,15,241,1038,4.3,10,64.9,56,47.7,74,60,548,9.1,3,34.3,81.1,7.4,30,59.5,301,1038,1586,1591,0,RB
1999,Alfred Morris,276,9,285,2013,25,WAS,16,16,276,1275,4.6,7,79.7,61,48.2,12,9,78,8.7,0,4.9,75,6.5,2,50,285,1275,1353,1353,0,RB
2000,DeMarco Murray,217,53,270,2013,25,DAL,14,14,217,1121,5.2,9,80.1,65,51.6,66,53,350,6.6,1,25,80.3,5.3,18,54.5,270,1121,1471,1471,0,RB
2001,Chris Ogbonnaya,49,48,97,2013,27,CLE,16,7,49,240,4.9,0,15,14,53.1,74,48,343,7.1,2,21.4,64.9,4.6,15,37.8,97,240,583,583,0,RB
2002,Jamize Olawale,3,7,10,2013,24,OAK,16,1,3,6,2,0,0.4,0,33.3,11,7,63,9,0,3.9,63.6,5.7,3,45.5,10,6,69,75,6,FB
2003,Montell Owens,0,0,0,2013,29,DET,1,0,0,0,,0,0,0,,0,0,0,,0,0,,,0,,0,0,0,0,0,RB
2004,Isaiah Pead,7,11,18,2013,24,STL,10,0,7,21,3,0,2.1,2,42.9,15,11,78,7.1,0,7.8,73.3,5.2,3,46.7,18,21,99,237,138,RB
2005,Cedric Peerman,8,0,8,2013,27,CIN,16,0,8,17,2.1,0,1.1,0,0,0,0,0,,0,0,,,0,,8,17,17,83,66,RB
2006,Adrian Peterson,279,29,308,2013,28,MIN,14,14,279,1266,4.5,10,90.4,61,43.7,40,29,171,5.9,1,12.2,72.5,4.3,11,42.5,308,1266,1437,1437,0,RB
2007,Bernard Pierce,152,20,172,2013,22,BAL,16,1,152,436,2.9,2,27.3,23,34.2,25,20,104,5.2,0,6.5,80,4.2,3,28,172,436,540,540,0,RB
2008,Chris Polk,11,4,15,2013,24,PHI,15,0,11,98,8.9,3,6.5,5,63.6,5,4,61,15.3,0,4.1,80,12.2,1,60,15,98,159,167,8,RB
2009,Bilal Powell,176,36,212,2013,25,NYJ,16,11,176,697,4,1,43.6,36,41.5,57,36,272,7.6,0,17,63.2,4.8,15,35.1,212,727,969,969,0,RB
2010,Bobby Rainey,150,15,165,2013,26,"CLE,TAM",15,6,150,566,3.8,5,37.7,23,27.3,19,15,46,3.1,1,3.1,78.9,2.4,3,26.3,165,566,612,774,162,RB
2011,Chris Rainey,0,0,0,2013,25,IND,2,0,0,0,,0,0,0,,1,0,0,,0,0,0,0,0,0,0,0,0,160,160,RB
2012,Joseph Randle,54,8,62,2013,22,DAL,13,2,54,164,3,2,12.6,7,40.7,10,8,61,7.6,0,4.7,80,6.1,2,70,62,164,225,225,7,RB
2013,Isaac Redman,10,4,14,2013,29,PIT,3,1,10,12,1.2,0,4,0,10,5,4,14,3.5,0,4.7,80,2.8,1,40,14,12,26,26,0,RB
2014,Marcel Reece,46,32,78,2013,28,OAK,16,15,46,218,4.7,2,13.6,8,37,54,32,331,10.3,2,20.7,59.3,6.1,12,38.9,78,240,549,549,0,RB
2015,Chase Reynolds,0,0,0,2013,26,STL,16,0,0,0,,0,0,0,,0,0,0,,0,0,,,0,,0,0,0,0,0,RB
2016,Ray Rice,214,58,272,2013,26,BAL,15,15,214,660,3.1,4,44,28,33.6,72,58,321,5.5,0,21.4,80.6,4.5,13,37.5,272,660,981,981,0,RB
2017,Daryl Richardson,69,14,83,2013,23,STL,8,3,69,215,3.1,0,26.9,12,42,18,14,121,8.6,0,15.1,77.8,6.7,3,38.9,83,215,336,336,0,RB
2018,Trent Richardson,188,35,223,2013,23,"CLE,IND",16,10,188,563,3,3,35.2,28,42,52,35,316,9,1,19.8,67.3,6.1,16,48.1,223,563,879,879,0,RB
2019,Theo Riddick,9,4,13,2013,22,DET,14,0,9,25,2.8,1,1.8,2,44.4,8,4,26,6.5,0,1.9,50,3.3,1,37.5,13,25,51,63,12,RB
2020,Stevan Ridley,178,10,188,2013,24,NWE,14,6,178,773,4.3,7,55.2,40,49.4,12,10,62,6.2,0,4.4,83.3,5.2,2,41.7,188,773,835,835,0,RB
2021,Khiry Robinson,54,0,54,2013,24,NOR,10,0,54,224,4.1,1,22.4,12,40.7,0,0,0,,0,0,,,0,,54,224,224,224,0,RB
2022,Michael Robinson,1,2,3,2013,30,SEA,9,3,1,0,0,0,0,0,0,3,2,27,13.5,0,3,66.7,9,1,66.7,3,0,27,31,4,FB
2023,Jacquizz Rodgers,96,52,148,2013,23,ATL,15,4,96,332,3.5,2,22.1,19,43.8,63,52,341,6.6,2,22.7,82.5,5.4,12,44.4,148,332,673,1248,575,RB
2024,Evan Royster,2,1,3,2013,26,WAS,10,0,2,0,0,0,0,0,0,1,1,3,3,0,0.3,100,3,0,0,3,0,3,3,0,RB
2025,Bernard Scott,4,2,6,2013,29,BAL,2,0,4,14,3.5,0,7,0,0,2,2,10,5,0,5,100,5,0,0,6,14,24,24,0,RB
2026,Da'Rel Scott,20,11,31,2013,25,NYG,5,1,20,73,3.7,0,14.6,3,35,19,11,102,9.3,1,20.4,57.9,5.4,3,42.1,31,73,175,175,0,RB
2027,Anthony Sherman,2,18,20,2013,25,KAN,16,8,2,3,1.5,0,0.2,1,50,24,18,155,8.6,1,9.7,75,6.5,8,54.2,20,3,158,158,0,RB
2028,Alfonso Smith,18,10,28,2013,26,ARI,16,0,18,54,3,1,3.4,5,50,13,10,68,6.8,0,4.3,76.9,5.2,1,69.2,28,54,122,122,0,RB
2029,Antone Smith,5,2,7,2013,28,ATL,15,0,5,145,29,2,9.7,4,100,3,2,10,5,0,0.7,66.7,3.3,0,0,7,145,155,195,40,RB
2030,Armond Smith,4,0,4,2013,27,CAR,5,0,4,5,1.3,0,1,0,0,0,0,0,,0,0,,,0,,4,5,5,5,0,RB
2031,Jason Snelling,44,29,73,2013,30,ATL,14,1,44,164,3.7,1,11.7,9,50,34,29,216,7.4,3,15.4,85.3,6.4,11,50,73,164,380,403,23,RB
2032,Chad Spann,0,0,0,2013,25,HOU,1,0,0,0,,0,0,0,,0,0,0,,0,0,,,0,,0,0,0,0,0,RB
2033,C.J. Spiller,202,33,235,2013,26,BUF,15,10,202,933,4.6,2,62.2,27,34.7,41,33,185,5.6,0,12.3,80.5,4.5,7,36.6,235,933,1118,1118,0,RB
2034,Darren Sproles,53,71,124,2013,30,NOR,15,4,53,220,4.2,2,14.7,13,49.1,89,71,604,8.5,2,40.3,79.8,6.8,25,50.6,124,220,824,1273,449,RB
2035,Zac Stacy,250,26,276,2013,22,STL,14,12,250,973,3.9,7,69.5,48,41.6,35,26,141,5.4,1,10.1,74.3,4,8,37.1,276,973,1114,1115,0,RB
2036,James Starks,89,10,99,2013,27,GNB,13,1,89,493,5.5,3,37.9,27,55.1,13,10,89,8.9,1,6.8,76.9,6.8,3,61.5,99,493,582,582,0,RB
2037,LaRod Stephens-Howling,6,2,8,2013,26,PIT,1,0,6,19,3.2,0,19,0,0,3,2,11,5.5,0,11,66.7,3.7,0,0,8,19,30,55,25,RB
2038,Jeremy Stewart,2,2,4,2013,24,OAK,13,0,2,2,1,1,0.2,1,50,2,2,6,3,0,0.5,100,3,0,0,4,2,8,103,95,RB
2039,Jonathan Stewart,48,7,55,2013,26,CAR,6,1,48,180,3.8,0,30,7,41.7,7,7,44,6.3,0,7.3,100,6.3,3,57.1,55,180,224,224,0,RB
2040,Frank Summers,12,7,19,2013,28,BUF,15,9,12,46,3.8,1,3.1,3,50,8,7,79,11.3,1,5.3,87.5,9.9,5,87.5,19,46,125,125,0,RB
2041,Phillip Tanner,9,3,12,2013,25,DAL,16,0,9,12,1.3,1,0.8,2,33.3,4,3,33,11,0,2.1,75,8.3,1,75,12,12,45,45,0,RB
2042,Ben Tate,181,34,215,2013,25,HOU,14,7,181,771,4.3,4,55.1,37,49.7,49,34,140,4.1,0,10,69.4,2.9,2,30.6,215,771,911,911,0,RB
2043,Will Ta'ufo'ou,1,10,11,2013,27,JAX,16,7,1,1,1,0,0.1,0,0,15,10,40,4,0,2.5,66.7,2.7,2,33.3,11,1,41,46,5,RB
2044,Stepfan Taylor,36,8,44,2013,22,ARI,16,0,36,115,3.2,0,7.2,6,30.6,9,8,71,8.9,0,4.4,88.9,7.9,2,33.3,44,115,186,186,0,RB
2045,Marcus Thigpen,6,8,14,2013,27,MIA,16,0,6,18,3,0,1.1,1,33.3,11,8,97,12.1,1,6.1,72.7,8.8,4,54.5,14,18,115,1257,1142,RB
2046,Chris Thompson,0,0,0,2013,23,WAS,4,0,0,0,,0,0,0,,0,0,0,,0,0,,,0,,0,0,0,196,196,RB
2047,Daniel Thomas,109,15,124,2013,26,MIA,15,1,109,406,3.7,4,27.1,17,46.8,17,15,63,4.2,2,4.2,88.2,3.7,6,35.3,124,406,469,469,0,RB
2048,Pierre Thomas,147,77,224,2013,29,NOR,16,9,147,549,3.7,2,34.3,32,51.7,84,77,513,6.7,3,32.1,91.7,6.1,21,53.6,224,549,1062,1074,12,RB
2049,Jordan Todman,76,14,90,2013,23,JAX,16,2,76,256,3.4,2,16,17,38.2,26,14,116,8.3,1,7.3,53.8,4.5,6,26.9,90,256,372,1084,712,RB
2050,Mike Tolbert,101,27,128,2013,28,CAR,16,13,101,361,3.6,5,22.6,32,50.5,33,27,184,6.8,2,11.5,81.8,5.6,12,45.5,128,361,545,545,0,RB
2051,Matthew Tucker,0,0,0,2013,22,PHI,2,0,0,0,,0,0,0,,0,0,0,,0,0,,,0,,0,0,0,0,0,RB
2052,Will Tukuafu,0,0,0,2013,29,SFO,2,0,0,0,,0,0,0,,0,0,0,,0,0,,,0,,0,0,0,0,0,FB
2053,Robert Turbin,77,8,85,2013,24,SEA,16,0,77,264,3.4,0,16.5,10,39,12,8,60,7.5,0,3.8,66.7,5,2,41.7,85,264,324,501,177,RB
2054,Josh Vaughan,1,1,2,2013,27,ATL,6,0,1,1,1,0,0.2,0,0,1,1,-5,-5,0,-0.8,100,-5,0,0,2,1,-4,-4,0,RB
2055,Shane Vereen,44,47,91,2013,24,NWE,8,1,44,208,4.7,1,26,12,38.6,69,47,427,9.1,3,53.4,68.1,6.2,25,52.2,91,208,635,701,66,RB
2056,Spencer Ware,3,0,3,2013,22,SEA,2,0,3,10,3.3,0,5,1,33.3,0,0,0,,0,0,,,0,,3,10,10,10,0,RB
2057,Leon Washington,1,0,1,2013,31,"NWE,TEN",7,0,1,1,1,0,0.1,0,0,1,0,0,,0,0,0,0,0,0,1,1,1,579,578,RB
2058,Fozzy Whittaker,28,21,49,2013,24,"CLE,SDG",14,2,28,79,2.8,0,5.6,3,42.9,36,21,155,7.4,2,11.1,58.3,4.3,6,41.7,49,79,234,872,638,RB
2059,DeAngelo Williams,201,26,227,2013,30,CAR,15,15,201,843,4.2,3,56.2,36,41.3,36,26,333,12.8,1,22.2,72.2,9.3,10,47.2,227,843,1176,1176,0,RB
2060,Kerwynn Williams,0,0,0,2013,22,IND,1,0,0,0,,0,0,0,,0,0,0,,0,0,,,0,,0,0,0,28,28,RB
2061,David Wilson,44,2,46,2013,22,NYG,5,4,44,146,3.3,1,29.2,10,45.5,6,2,8,4,0,1.6,33.3,1.3,0,16.7,46,146,154,376,222,RB
2062,Ronnie Wingo,1,1,2,2013,22,BUF,2,0,1,4,4,0,2,0,0,1,1,2,2,0,1,100,2,0,0,2,4,6,6,0,RB
2063,Cierre Wood,3,0,3,2013,22,HOU,3,0,3,9,3,0,3,0,0,0,0,0,,0,0,,,0,,3,9,9,29,20,RB
2064,Danny Woodhead,106,76,182,2013,28,SDG,16,2,106,429,4,2,26.8,27,60.4,88,76,605,8,6,37.8,86.4,6.9,32,64.8,182,429,1034,1296,262,RB
2065,Darrel Young,12,4,16,2013,26,WAS,13,7,12,41,3.4,3,3.2,7,58.3,9,4,71,17.8,1,5.5,44.4,7.9,1,22.2,16,41,112,112,0,RB
2066,Anthony Allen,16,2,18,2012,24,BAL,16,0,16,61,3.8,1,3.8,4,43.8,4,2,12,6,0,0.8,50,3,1,25,18,61,73,129,56,RB
2067,Armando Allen,27,2,29,2012,23,CHI,15,0,27,124,4.6,1,8.3,6,40.7,3,2,16,8,0,1.1,66.7,5.3,0,33.3,29,124,140,150,10,RB
2068,Matt Asiata,3,1,4,2012,25,MIN,16,0,3,9,3,0,0.6,0,0,1,1,2,2,0,0.1,100,2,0,0,4,9,11,66,55,RB
2069,Lance Ball,42,7,49,2012,27,DEN,15,0,42,158,3.8,1,10.5,11,31,12,7,61,8.7,1,4.1,58.3,5.1,4,33.3,49,158,219,219,0,RB
2070,Vick Ballard,211,17,228,2012,22,IND,16,12,211,814,3.9,2,50.9,52,46,27,17,152,8.9,1,9.5,63,5.6,7,44.4,228,814,966,966,0,RB
2071,Baron Batch,25,4,29,2012,25,PIT,12,0,25,49,2,1,4.1,4,24,5,4,31,7.8,0,2.6,80,6.2,3,60,29,49,80,80,0,RB
2072,Jackie Battle,95,15,110,2012,29,SDG,16,5,95,311,3.3,3,19.4,19,34.7,15,15,108,7.2,1,6.8,100,7.2,7,73.3,110,311,419,419,0,RB
2073,Joique Bell,82,52,134,2012,26,DET,16,0,82,414,5,3,25.9,16,52.4,68,52,485,9.3,0,30.3,76.5,7.1,29,60.3,134,414,899,953,54,RB
2074,Kahlil Bell,29,2,31,2012,26,"CHI,NYJ",7,0,29,76,2.6,0,10.9,4,27.6,2,2,13,6.5,0,1.9,100,6.5,1,50,31,76,89,89,0,RB
2075,Cedric Benson,71,14,85,2012,30,GNB,5,5,71,248,3.5,1,49.6,10,49.3,15,14,97,6.9,0,19.4,93.3,6.5,5,73.3,85,248,345,345,0,RB
2076,LeGarrette Blount,41,1,42,2012,26,TAM,13,0,41,151,3.7,2,11.6,7,36.6,2,1,2,2,0,0.2,50,1,0,0,42,151,153,153,0,RB
2077,Brandon Bolden,56,2,58,2012,22,NWE,10,0,56,274,4.9,2,27.4,18,53.6,2,2,11,5.5,0,1.1,100,5.5,1,50,58,274,285,285,0,RB
2078,Ahmad Bradshaw,221,23,244,2012,26,NYG,14,12,221,1015,4.6,6,72.5,58,50.7,31,23,245,10.7,0,17.5,74.2,7.9,7,38.7,244,1015,1260,1260,0,RB
2079,Allen Bradford,0,0,0,2012,24,SEA,1,0,0,0,,0,0,0,,0,0,0,,0,0,,,0,,0,0,0,0,0,RB
2080,Curtis Brinkley,39,12,51,2012,27,SDG,10,1,39,115,2.9,0,11.5,8,41,15,12,77,6.4,0,7.7,80,5.1,3,46.7,51,115,192,278,86,RB
2081,Andre Brown,73,12,85,2012,26,NYG,10,2,73,385,5.3,8,38.5,26,63,17,12,86,7.2,0,8.6,70.6,5.1,2,41.2,85,385,471,514,42,RB
2082,Bryce Brown,115,13,128,2012,21,PHI,16,4,115,564,4.9,4,35.3,33,39.1,19,13,56,4.3,0,3.5,68.4,2.9,3,31.6,128,564,620,776,156,RB
2083,Donald Brown,108,9,117,2012,25,IND,10,4,108,417,3.9,1,41.7,23,43.5,13,9,93,10.3,0,9.3,69.2,7.2,2,46.2,117,417,510,510,0,RB
2084,Ronnie Brown,46,49,95,2012,31,SDG,14,1,46,220,4.8,0,15.7,12,41.3,59,49,371,7.6,0,26.5,83.1,6.3,16,44.1,95,220,591,591,0,RB
2085,Michael Bush,114,9,123,2012,28,CHI,13,1,114,411,3.6,5,31.6,28,46.5,11,9,83,9.2,0,6.4,81.8,7.5,6,54.5,123,411,494,494,0,RB
2086,Reggie Bush,227,35,262,2012,27,MIA,16,16,227,986,4.3,6,61.6,43,50.2,52,35,292,8.3,2,18.3,67.3,5.6,14,40.4,262,986,1278,1278,0,RB
2087,Travaris Cadet,1,5,6,2012,23,NOR,13,0,1,5,5,0,0.4,1,100,8,5,44,8.8,0,3.4,62.5,5.5,3,50,6,5,49,741,692,RB
2088,Delone Carter,32,1,33,2012,25,IND,10,0,32,122,3.8,3,12.2,11,59.4,2,1,13,13,0,1.3,50,6.5,1,50,33,122,135,135,0,RB
2089,James Casey,1,34,35,2012,28,HOU,16,9,1,6,6,0,0.4,1,100,45,34,330,9.7,3,20.6,75.6,7.3,18,60,35,6,336,336,0,FB
2090,Shaun Chapas,0,1,1,2012,24,DET,3,1,0,0,,0,0,0,,2,1,6,6,0,2,50,3,0,0,1,0,6,6,0,RB
2091,Jamaal Charles,285,35,320,2012,26,KAN,16,15,285,1509,5.3,5,94.3,63,46.7,49,35,236,6.7,1,14.8,71.4,4.8,11,42.9,320,1509,1745,1745,0,RB
2092,Tashard Choice,47,4,51,2012,28,BUF,12,0,47,193,4.1,1,16.1,9,40.4,9,4,9,2.3,0,0.8,44.4,1,0,11.1,51,193,202,202,0,RB
2093,Charles Clay,0,18,18,2012,23,MIA,14,9,0,0,,0,0,0,,33,18,212,11.8,2,15.1,54.5,6.4,8,39.4,18,0,212,212,0,FB
2094,Tyler Clutts,0,0,0,2012,28,HOU,16,0,0,0,,0,0,0,,0,0,0,,0,0,,,0,,0,0,0,0,0,RB
2095,Jed Collins,0,14,14,2012,26,NOR,15,7,0,0,,0,0,0,,16,14,70,5,2,4.7,87.5,4.4,5,43.8,14,0,70,70,0,FB
2096,John Conner,0,0,0,2012,25,"CIN,NYJ",5,2,0,0,,0,0,0,,2,0,0,,0,0,0,0,0,0,0,0,0,0,0,RB
2097,Mike Cox,0,3,3,2012,27,ATL,8,7,0,0,,0,0,0,,3,3,22,7.3,0,2.8,100,7.3,1,66.7,3,0,22,22,,FB
2098,James Develin,0,0,0,2012,24,NWE,1,0,0,0,,0,0,0,,0,0,0,,0,0,,,0,,0,0,0,0,0,RB
2099,Patrick DiMarco,0,0,0,2012,23,KAN,5,4,0,0,,0,0,0,,1,0,0,,0,0,0,0,0,0,0,0,0,0,0,RB
2100,Anthony Dixon,21,0,21,2012,25,SFO,16,0,21,78,3.7,2,4.9,3,61.9,0,0,0,,0,0,,,0,,21,78,78,78,0,RB
2101,Shaun Draughn,59,24,83,2012,25,KAN,16,0,59,233,3.9,2,14.6,16,47.5,30,24,158,6.6,0,9.9,80,5.3,5,26.7,83,233,391,928,537,RB
2102,Maurice Jones-Drew,86,14,100,2012,27,JAX,6,5,86,414,4.8,1,69,21,46.5,18,14,86,6.1,1,14.3,77.8,4.8,3,33.3,100,414,500,504,4,RB
2103,Lance Dunbar,21,6,27,2012,22,DAL,12,0,21,75,3.6,0,6.3,5,52.4,12,6,33,5.5,0,2.8,50,2.8,3,33.3,27,75,108,369,261,RB
2104,Jonathan Dwyer,156,18,174,2012,23,PIT,13,6,156,623,4,2,47.9,29,41.7,25,18,106,5.9,0,8.2,72,4.2,7,44,174,623,729,729,0,RB
2105,Nate Eachus,5,1,6,2012,22,KAN,11,2,5,18,3.6,0,1.6,0,80,3,1,19,19,0,1.7,33.3,6.3,1,33.3,6,18,37,37,0,RB
2106,Rhett Ellison,0,7,7,2012,24,MIN,16,7,0,0,,0,0,0,,9,7,65,9.3,0,4.1,77.8,7.2,2,66.7,7,0,65,65,0,FB
2107,Darren Evans,0,0,0,2012,24,TEN,1,0,0,0,,0,0,0,,0,0,0,,0,0,,,0,,0,0,0,0,0,RB
2108,Jerome Felton,0,3,3,2012,26,MIN,16,7,0,0,,0,0,0,,4,3,35,11.7,0,2.2,75,8.8,2,75,3,0,35,51,16,FB
2109,Justin Forsett,63,3,66,2012,27,HOU,16,0,63,374,5.9,1,23.4,14,47.6,5,3,38,12.7,0,2.4,60,7.6,2,60,66,374,412,412,0,RB
2110,Matt Forte,248,44,292,2012,27,CHI,15,15,248,1094,4.4,5,72.9,45,41.5,59,44,340,7.7,1,22.7,74.6,5.8,15,33.9,292,1094,1434,1434,0,RB
2111,Arian Foster,351,40,391,2012,26,HOU,16,16,351,1424,4.1,15,89,78,44.4,58,40,217,5.4,2,13.6,69,3.7,10,25.9,391,1424,1641,1641,0,RB
2112,Terrance Ganaway,0,0,0,2012,24,STL,3,0,0,0,,0,0,0,,0,0,0,,0,0,,,0,,0,0,0,0,0,RB
2113,Toby Gerhart,50,20,70,2012,25,MIN,16,0,50,169,3.4,1,10.6,11,38,27,20,155,7.8,0,9.7,74.1,5.7,9,37,70,169,324,324,0,RB
2114,Mike Goodson,35,16,51,2012,25,OAK,12,0,35,221,6.3,0,18.4,6,42.9,16,16,195,12.2,1,16.3,100,12.2,9,75,51,221,416,775,359,RB
2115,Frank Gore,258,28,286,2012,29,SFO,16,16,258,1214,4.7,8,75.9,68,47.7,36,28,234,8.4,1,14.6,77.8,6.5,10,47.2,286,1214,1448,1463,0,RB
2116,Garrett Graham,0,28,28,2012,26,HOU,15,9,0,0,,0,0,0,,39,28,263,9.4,3,17.5,71.8,6.7,16,53.8,28,0,263,263,0,FB
2117,Ryan Grant,32,1,33,2012,30,"GNB,WAS",5,1,32,132,4.1,2,26.4,8,37.5,2,1,34,34,0,6.8,50,17,1,50,33,132,166,166,0,RB
2118,Cyrus Gray,7,2,9,2012,23,KAN,10,0,7,44,6.3,0,4.4,3,85.7,3,2,18,9,0,1.8,66.7,6,0,0,9,44,62,95,33,RB
2119,Alex Green,135,18,153,2012,24,GNB,12,4,135,464,3.4,0,38.7,17,37.8,30,18,125,6.9,0,10.4,60,4.2,6,36.7,153,464,589,589,0,RB
2120,BenJarvus Green-Ellis,278,22,300,2012,27,CIN,15,15,278,1094,3.9,6,72.9,55,46,30,22,104,4.7,0,6.9,73.3,3.5,4,36.7,300,1094,1198,1198,0,RB
2121,Shonn Greene,276,19,295,2012,27,NYJ,16,14,276,1063,3.9,8,66.4,52,51.1,30,19,151,7.9,0,9.4,63.3,5,3,40,295,1063,1214,1214,0,RB
2122,John Griffin,0,0,0,2012,24,NYJ,1,0,0,0,,0,0,0,,0,0,0,,0,0,,,0,,0,0,0,0,0,RB
2123,Jonathan Grimes,2,2,4,2012,23,"HOU,NYJ",9,0,2,6,3,0,0.7,0,50,2,2,7,3.5,0,0.8,100,3.5,1,50,4,6,13,13,0,RB
2124,Chris Gronkowski,0,1,1,2012,26,DEN,14,0,0,0,,0,0,0,,1,1,11,11,0,0.8,100,11,1,100,1,0,11,11,0,RB
2125,Montario Hardesty,65,2,67,2012,25,CLE,13,1,65,271,4.2,1,20.8,12,40,5,2,16,8,0,1.2,40,3.2,1,40,67,271,287,287,0,RB
2126,Jamie Harper,19,1,20,2012,23,TEN,10,0,19,30,1.6,3,3,4,36.8,1,1,8,8,0,0.8,100,8,0,0,20,30,38,38,0,RB
2127,DuJuan Harris,34,2,36,2012,24,GNB,4,2,34,157,4.6,2,39.3,8,41.2,2,2,17,8.5,0,4.3,100,8.5,1,100,36,157,174,174,0,RB
2128,Stanley Havili,6,7,13,2012,25,PHI,15,2,6,22,3.7,1,1.5,1,50,12,7,43,6.1,0,2.9,58.3,3.6,1,25,13,22,65,83,18,RB
2129,Roy Helu,2,7,9,2012,24,WAS,3,0,2,2,1,0,0.7,0,0,7,7,45,6.4,0,15,100,6.4,1,57.1,9,2,47,47,0,RB
2130,Dan Herron,4,0,4,2012,23,CIN,3,0,4,5,1.3,0,1.7,0,0,1,0,0,,0,0,0,0,0,0,4,5,5,5,0,RB
2131,Jacob Hester,17,1,18,2012,27,DEN,3,0,17,81,4.8,2,27,5,29.4,1,1,7,7,0,2.3,100,7,1,100,18,81,88,88,0,RB
2132,Lex Hilliard,9,4,13,2012,28,"NWE,NYJ",14,9,9,33,3.7,0,2.4,5,77.8,9,4,23,5.8,0,1.6,44.4,2.6,2,33.3,13,33,56,63,0,RB
2133,Peyton Hillis,85,10,95,2012,26,KAN,13,2,85,309,3.6,1,23.8,19,41.2,14,10,62,6.2,0,4.8,71.4,4.4,2,21.4,95,309,371,371,0,RB
2134,Ronnie Hillman,85,10,95,2012,21,DEN,14,0,85,330,3.9,1,23.6,19,48.2,12,10,62,6.2,0,4.4,83.3,5.2,3,33.3,95,330,392,392,0,RB
2135,Robert Hughes,1,1,2,2012,23,IND,5,1,1,5,5,0,1,1,100,1,1,3,3,0,0.6,100,3,0,0,2,5,8,8,0,RB
2136,Kendall Hunter,72,9,81,2012,24,SFO,11,0,72,371,5.2,2,33.7,18,55.6,12,9,60,6.7,0,5.5,75,5,3,41.7,81,367,431,596,165,RB
2137,Henry Hynoski,5,11,16,2012,24,NYG,16,11,5,20,4,0,1.3,0,40,15,11,50,4.5,1,3.1,73.3,3.3,2,46.7,16,20,70,70,0,FB
2138,Mark Ingram,156,6,162,2012,23,NOR,16,5,156,602,3.9,5,37.6,29,47.4,10,6,29,4.8,0,1.8,60,2.9,2,30,162,602,631,632,0,RB
2139,Chris Ivory,40,2,42,2012,24,NOR,6,2,40,217,5.4,2,36.2,7,47.5,3,2,15,7.5,0,2.5,66.7,5,1,33.3,42,217,232,232,0,RB
2140,Brandon Jackson,8,2,10,2012,27,CLE,2,0,8,54,6.8,0,27,2,50,4,2,20,10,0,10,50,5,2,50,10,54,74,74,0,RB
2141,Fred Jackson,115,34,149,2012,31,BUF,10,8,115,437,3.8,3,43.7,26,47,42,34,217,6.4,1,21.7,81,5.2,10,45.2,149,437,654,654,0,RB
2142,Steven Jackson,258,38,296,2012,29,STL,16,16,258,1045,4.1,4,65.3,49,45.3,53,38,321,8.4,0,20.1,71.7,6.1,13,49.1,296,1045,1366,1366,0,RB
2143,Brandon Jacobs,5,0,5,2012,30,SFO,2,0,5,7,1.4,0,3.5,1,20,0,0,0,,0,0,,,0,,5,7,7,7,0,RB
2144,LaMichael James,27,3,30,2012,23,SFO,4,0,27,125,4.6,0,31.3,10,40.7,5,3,29,9.7,0,7.3,60,5.8,3,60,30,125,154,571,417,RB
2145,Rashad Jennings,101,19,120,2012,27,JAX,10,6,101,283,2.8,2,28.3,16,37.6,26,19,130,6.8,0,13,73.1,5,5,26.9,120,283,413,654,241,RB
2146,Chris Johnson,276,36,312,2012,27,TEN,16,15,276,1243,4.5,6,77.7,46,41.7,49,36,232,6.4,0,14.5,73.5,4.7,7,36.7,312,1243,1475,1475,0,RB
2147,Quinn Johnson,4,5,9,2012,26,TEN,16,8,4,5,1.3,0,0.3,2,50,8,5,40,8,0,2.5,62.5,5,2,25,9,5,45,45,0,FB
2148,Will Johnson,2,15,17,2012,23,PIT,16,7,2,7,3.5,0,0.4,0,50,26,15,137,9.1,1,8.6,57.7,5.3,8,50,17,7,144,152,8,RB
2149,Felix Jones,111,25,136,2012,25,DAL,16,7,111,402,3.6,3,25.1,24,47.7,36,25,262,10.5,2,16.4,69.4,7.3,10,50,136,402,664,900,236,RB
2150,Greg Jones,5,11,16,2012,31,JAX,12,4,5,8,1.6,0,0.7,3,60,14,11,64,5.8,0,5.3,78.6,4.6,1,50,16,8,72,72,0,RB
2151,Taiwan Jones,6,2,8,2012,24,OAK,14,0,6,21,3.5,0,1.5,1,33.3,2,2,11,5.5,0,0.8,100,5.5,0,0,8,21,32,52,22,RB
2152,Deji Karim,0,0,0,2012,26,IND,3,0,0,0,,0,0,0,,0,0,0,,0,0,,,0,,0,0,0,328,328,RB
2153,John Kuhn,23,15,38,2012,30,GNB,14,3,23,63,2.7,1,4.5,4,39.1,18,15,148,9.9,0,10.6,83.3,8.2,7,55.6,38,63,211,211,0,FB
2154,Jorvorskie Lane,13,11,24,2012,25,MIA,16,5,13,13,1,2,0.8,5,38.5,12,11,79,7.2,1,4.9,91.7,6.6,3,58.3,24,13,92,134,42,FB
2155,Vonta Leach,9,21,30,2012,31,BAL,16,13,9,32,3.6,1,2,3,88.9,24,21,143,6.8,0,8.9,87.5,6,7,54.2,30,32,175,175,0,FB
2156,Brian Leonard,33,11,44,2012,28,CIN,15,0,33,106,3.2,0,7.1,7,42.4,15,11,67,6.1,0,4.5,73.3,4.5,3,26.7,44,106,173,173,0,RB
2157,Mikel Leshoure,215,34,249,2012,22,DET,14,14,215,798,3.7,9,57,47,45.6,49,34,214,6.3,0,15.3,69.4,4.4,12,40.8,249,798,1012,1012,0,RB
2158,Dion Lewis,13,2,15,2012,22,PHI,9,0,13,69,5.3,1,7.7,6,53.8,2,2,24,12,0,2.7,100,12,1,50,15,69,93,126,33,RB
2159,Stefan Logan,3,6,9,2012,31,DET,16,0,3,17,5.7,0,1.1,1,66.7,7,6,28,4.7,0,1.8,85.7,4,2,57.1,9,17,45,942,897,RB
2160,Kregg Lumpkin,9,0,9,2012,28,NYG,5,0,9,42,4.7,0,8.4,2,33.3,2,0,0,,0,0,0,0,0,0,9,42,42,42,0,RB
2161,Marshawn Lynch,315,23,338,2012,26,SEA,16,15,315,1590,5,11,99.4,70,48.6,30,23,196,8.5,1,12.3,76.7,6.5,11,60,338,1590,1786,1786,0,RB
2162,Owen Marecic,0,0,0,2012,24,CLE,10,2,0,0,,0,0,0,,5,0,0,,0,0,0,0,0,0,0,0,0,0,0,RB
2163,Doug Martin,319,49,368,2012,23,TAM,16,16,319,1454,4.6,11,90.9,64,44.8,70,49,472,9.6,1,29.5,70,6.7,18,45.7,368,1454,1926,1926,0,RB
2164,Ryan Mathews,184,39,223,2012,25,SDG,12,9,184,707,3.8,1,58.9,35,47.3,56,39,252,6.5,0,21,69.6,4.5,9,42.9,223,707,959,959,0,RB
2165,Reagan Maui'a,0,1,1,2012,28,ARI,3,1,0,0,,0,0,0,,1,1,7,7,0,2.3,100,7,0,0,1,0,7,7,0,RB
2166,Dexter McCluster,12,52,64,2012,23,KAN,16,6,12,70,5.8,0,4.4,4,58.3,77,52,452,8.7,1,28.3,67.5,5.9,24,40.3,64,70,522,528,6,RB
2167,Le'Ron McClain,14,8,22,2012,28,SDG,16,9,14,42,3,0,2.6,2,35.7,10,8,29,3.6,0,1.8,80,2.9,2,30,22,42,71,71,0,FB
2168,Jamie McCoy,0,0,0,2012,25,PIT,1,0,0,0,,0,0,0,,0,0,0,,0,0,,,0,,0,0,0,0,0,RB
2169,LeSean McCoy,200,54,254,2012,24,PHI,12,12,200,840,4.2,2,70,45,49.5,67,54,373,6.9,3,31.1,80.6,5.6,20,46.3,254,840,1213,1213,0,RB
2170,Darren McFadden,216,42,258,2012,25,OAK,12,12,216,707,3.3,2,58.9,35,35.2,63,42,258,6.1,1,21.5,66.7,4.1,12,33.3,258,707,965,965,0,RB
2171,Willis McGahee,167,26,193,2012,31,DEN,10,9,167,731,4.4,4,73.1,44,56.3,33,26,221,8.5,0,22.1,78.8,6.7,10,51.5,193,731,952,952,0,RB
2172,Corey McIntyre,0,1,1,2012,33,BUF,16,3,0,0,,0,0,0,,2,1,9,9,0,0.6,50,4.5,0,0,1,0,9,9,0,FB
2173,Joe McKnight,30,1,31,2012,24,NYJ,15,0,30,179,6,0,11.9,7,50,2,1,18,18,0,1.2,50,9,1,50,31,179,197,1269,1072,RB
2174,Rashard Mendenhall,51,9,60,2012,25,PIT,6,4,51,182,3.6,0,30.3,9,45.1,10,9,62,6.9,1,10.3,90,6.2,4,50,60,182,244,244,0,RB
2175,Bruce Miller,5,12,17,2012,25,SFO,16,13,5,18,3.6,0,1.1,2,60,13,12,84,7,0,5.3,92.3,6.5,4,53.8,17,18,102,102,0,FB
2176,Lamar Miller,51,6,57,2012,21,MIA,13,1,51,250,4.9,1,19.2,12,51,8,6,45,7.5,0,3.5,75,5.6,3,62.5,57,250,295,295,0,RB
2177,Collin Mooney,5,0,5,2012,26,TEN,2,0,5,19,3.8,0,9.5,2,40,0,0,0,,0,0,,,0,,5,19,19,19,0,RB
2178,Mewelde Moore,13,6,19,2012,30,IND,9,0,13,20,1.5,0,2.2,1,30.8,8,6,77,12.8,1,8.6,75,9.6,4,62.5,19,20,97,147,50,RB
2179,Knowshon Moreno,138,21,159,2012,25,DEN,8,6,138,525,3.8,4,65.6,32,53.6,26,21,167,8,0,20.9,80.8,6.4,11,53.8,159,525,692,692,0,RB
2180,Alfred Morris,335,11,346,2012,24,WAS,16,16,335,1613,4.8,13,100.8,86,50.1,16,11,77,7,0,4.8,68.8,4.8,3,37.5,346,1613,1690,1690,0,RB
2181,Richard Murphy,23,0,23,2012,26,JAX,5,0,23,92,4,0,18.4,3,52.2,1,0,0,,0,0,0,0,0,0,23,92,92,210,118,RB
2182,DeMarco Murray,161,35,196,2012,24,DAL,10,10,161,663,4.1,4,66.3,39,53.4,42,35,251,7.2,0,25.1,83.3,6,11,59.5,196,663,914,914,0,RB
2183,Chris Ogbonnaya,8,24,32,2012,26,CLE,15,1,8,30,3.8,0,2,1,50,32,24,187,7.8,0,12.5,75,5.8,10,43.8,32,30,217,217,0,RB
2184,Jamize Olawale,0,0,0,2012,23,OAK,3,0,0,0,,0,0,0,,0,0,0,,0,0,,,0,,0,0,0,0,0,FB
2185,Montell Owens,42,8,50,2012,28,JAX,13,4,42,209,5,1,16.1,10,54.8,10,8,113,14.1,0,8.7,80,11.3,5,70,50,209,322,322,0,RB
2186,Jalen Parmele,40,7,47,2012,27,JAX,11,2,40,143,3.6,0,13,9,32.5,9,7,60,8.6,0,5.5,77.8,6.7,2,55.6,47,143,203,436,233,RB
2187,Isaiah Pead,10,3,13,2012,23,STL,15,1,10,54,5.4,0,3.6,2,60,4,3,16,5.3,0,1.1,75,4,0,50,13,54,70,282,212,RB
2188,Cedric Peerman,36,9,45,2012,26,CIN,14,1,36,258,7.2,1,18.4,10,52.8,9,9,85,9.4,0,6.1,100,9.4,6,77.8,45,258,343,380,37,RB
2189,Adrian Peterson,348,40,388,2012,27,MIN,16,16,348,2097,6,12,131.1,88,46.8,51,40,217,5.4,1,13.6,78.4,4.3,11,45.1,388,2097,2314,2314,0,RB
2190,Bernard Pierce,108,7,115,2012,21,BAL,16,0,108,532,4.9,1,33.3,24,45.4,11,7,47,6.7,0,2.9,63.6,4.3,4,54.5,115,532,579,579,0,RB
2191,Lousaka Polite,0,1,1,2012,31,ATL,6,5,0,0,,0,0,0,,7,1,8,8,0,1.3,14.3,1.1,0,0,1,0,8,32,24,FB
2192,Chris Polk,0,0,0,2012,23,PHI,7,0,0,0,,0,0,0,,0,0,0,,0,0,,,0,,0,0,0,0,0,RB
2193,Bilal Powell,110,17,127,2012,24,NYJ,14,2,110,437,4,4,31.2,24,46.4,36,17,140,8.2,0,10,47.2,3.9,9,33.3,127,437,577,577,0,RB
2194,William Powell,60,19,79,2012,24,ARI,13,1,60,217,3.6,0,16.7,10,40,25,19,132,6.9,0,10.2,76,5.3,7,36,79,217,349,856,507,RB
2195,Chris Pressley,0,1,1,2012,26,CIN,14,7,0,0,,0,0,0,,3,1,1,1,1,0.1,33.3,0.3,1,33.3,1,0,1,16,15,FB
2196,Chris Rainey,26,14,40,2012,24,PIT,16,0,26,102,3.9,2,6.4,5,50,22,14,60,4.3,0,3.8,63.6,2.7,1,31.8,40,102,162,1213,1051,RB
2197,Isaac Redman,110,19,129,2012,28,PIT,14,5,110,410,3.7,2,29.3,28,40.9,23,19,244,12.8,0,17.4,82.6,10.6,10,65.2,129,410,654,654,0,RB
2198,Marcel Reece,59,52,111,2012,27,OAK,16,14,59,271,4.6,0,16.9,16,54.2,73,52,496,9.5,1,31,71.2,6.8,23,46.6,111,271,767,780,36,RB
2199,Ray Rice,257,61,318,2012,25,BAL,16,16,257,1143,4.4,9,71.4,52,43.2,83,61,478,7.8,1,29.9,73.5,5.8,24,42.2,318,1143,1621,1621,0,RB
2200,Daryl Richardson,98,24,122,2012,22,STL,16,0,98,475,4.8,0,29.7,22,42.9,36,24,163,6.8,0,10.2,66.7,4.5,7,22.2,122,475,638,638,0,RB
2201,Trent Richardson,267,51,318,2012,22,CLE,15,15,267,950,3.6,11,63.3,38,42.3,70,51,367,7.2,1,24.5,72.9,5.2,18,50,318,950,1317,1317,0,RB
2202,Stevan Ridley,290,6,296,2012,23,NWE,16,12,290,1263,4.4,12,78.9,83,52.8,14,6,51,8.5,0,3.2,42.9,3.6,2,28.6,296,1263,1314,1314,0,RB
2203,Javon Ringer,2,3,5,2012,25,TEN,2,0,2,14,7,0,7,0,0,5,3,12,4,0,6,60,2.4,0,0,5,14,26,26,0,RB
2204,Michael Robinson,12,13,25,2012,29,SEA,16,6,12,49,4.1,0,3.1,10,83.3,15,13,126,9.7,2,7.9,86.7,8.4,9,73.3,25,49,175,175,0,FB
2205,Jacquizz Rodgers,94,53,147,2012,22,ATL,16,0,94,362,3.9,1,22.6,16,36.2,59,53,402,7.6,1,25.1,89.8,6.8,18,61,147,362,764,1356,592,RB
2206,Evan Royster,23,15,38,2012,25,WAS,16,0,23,88,3.8,2,5.5,8,43.5,23,15,109,7.3,0,6.8,65.2,4.7,2,21.7,38,88,197,236,39,RB
2207,Brandon Saine,0,0,0,2012,24,GNB,6,0,0,0,,0,0,0,,0,0,0,,0,0,,,0,,0,0,0,0,0,RB
2208,Owen Schmitt,2,0,2,2012,27,OAK,13,4,2,1,0.5,0,0.1,1,50,0,0,0,,0,0,,,0,,2,1,1,1,0,RB
2209,Bernard Scott,8,0,8,2012,28,CIN,2,0,8,35,4.4,0,17.5,2,37.5,0,0,0,,0,0,,,0,,8,35,35,35,0,RB
2210,Da'Rel Scott,6,0,6,2012,24,NYG,4,0,6,9,1.5,0,2.3,1,50,0,0,0,,0,0,,,0,,6,9,9,9,0,RB
2211,Anthony Sherman,0,5,5,2012,24,ARI,13,4,0,0,,0,0,0,,8,5,39,7.8,0,3,62.5,4.9,1,25,5,0,39,50,0,RB
2212,Alfonso Smith,0,2,2,2012,25,ARI,11,0,0,0,,0,0,0,,3,2,21,10.5,0,1.9,66.7,7,0,0,2,0,21,21,0,RB
2213,Antone Smith,0,0,0,2012,27,ATL,13,0,0,0,,0,0,0,,1,0,0,,0,0,0,0,0,0,0,0,0,0,0,RB
2214,Armond Smith,3,0,3,2012,26,CAR,4,0,3,0,0,0,0,0,0,0,0,0,,0,0,,,0,,3,0,0,131,131,RB
2215,Kevin Smith,37,10,47,2012,26,DET,12,2,37,134,3.6,1,11.2,5,43.2,16,10,79,7.9,1,6.6,62.5,4.9,6,37.5,47,134,213,213,0,RB
2216,Michael Smith,0,0,0,2012,24,TAM,1,0,0,0,,0,0,0,,0,0,0,,0,0,,,0,,0,0,0,55,55,RB
2217,Jason Snelling,18,31,49,2012,29,ATL,16,2,18,63,3.5,0,3.9,3,38.9,35,31,203,6.5,1,12.7,88.6,5.8,9,48.6,49,63,266,282,16,RB
2218,C.J. Spiller,207,43,250,2012,25,BUF,16,9,207,1244,6,6,77.8,53,53.6,57,43,459,10.7,2,28.7,75.4,8.1,20,43.9,250,1244,1703,1703,0,RB
2219,Darren Sproles,48,75,123,2012,29,NOR,13,6,48,244,5.1,1,18.8,10,41.7,104,75,667,8.9,7,51.3,72.1,6.4,30,47.1,123,244,911,1577,666,RB
2220,James Starks,71,4,75,2012,26,GNB,6,2,71,255,3.6,1,42.5,13,46.5,6,4,31,7.8,0,5.2,66.7,5.2,0,50,75,255,286,286,0,RB
2221,LaRod Stephens-Howling,110,17,127,2012,25,ARI,14,5,110,356,3.2,4,25.4,15,32.7,30,17,106,6.2,0,7.6,56.7,3.5,5,23.3,127,356,462,867,405,RB
2222,Jeremy Stewart,25,8,33,2012,23,OAK,4,0,25,101,4,0,25.3,3,36,8,8,62,7.8,0,15.5,100,7.8,2,25,33,101,163,206,43,RB
2223,Jonathan Stewart,93,17,110,2012,25,CAR,9,6,93,336,3.6,1,37.3,15,38.7,23,17,157,9.2,1,17.4,73.9,6.8,5,43.5,110,336,493,493,0,RB
2224,Phillip Tanner,25,4,29,2012,24,DAL,14,0,25,61,2.4,0,4.4,4,36,5,4,41,10.3,0,2.9,80,8.2,3,60,29,61,102,102,0,RB
2225,Ben Tate,65,11,76,2012,24,HOU,11,0,65,279,4.3,2,25.4,18,49.2,11,11,49,4.5,0,4.5,100,4.5,2,54.5,76,279,328,328,0,RB
2226,Will Ta'ufo'ou,0,1,1,2012,26,JAX,6,1,0,0,,0,0,0,,1,1,5,5,0,0.8,100,5,0,0,1,0,5,5,0,RB
2227,Marcus Thigpen,1,1,2,2012,26,MIA,16,0,1,8,8,0,0.5,1,100,2,1,15,15,0,0.9,50,7.5,1,50,2,8,23,1379,1356,RB
2228,Daniel Thomas,91,15,106,2012,25,MIA,12,0,91,325,3.6,4,27.1,15,50.5,22,15,156,10.4,0,13,68.2,7.1,5,31.8,106,325,481,481,0,RB
2229,Pierre Thomas,105,39,144,2012,28,NOR,15,4,105,473,4.5,1,31.5,17,52.4,53,39,354,9.1,1,23.6,73.6,6.7,20,50.9,144,473,827,918,91,RB
2230,Jordan Todman,3,1,4,2012,22,JAX,1,0,3,8,2.7,0,8,0,0,1,1,0,0,0,0,100,0,0,0,4,8,8,86,78,RB
2231,Mike Tolbert,54,27,81,2012,27,CAR,16,5,54,183,3.4,7,11.4,23,61.1,39,27,268,9.9,0,16.8,69.2,6.9,13,51.3,81,183,451,477,26,RB
2232,Ryan Torain,0,0,0,2012,26,NYG,2,0,0,0,,0,0,0,,0,0,0,,0,0,,,0,,0,0,0,0,0,RB
2233,Keith Toston,17,3,20,2012,25,JAX,5,1,17,74,4.4,0,14.8,2,52.9,4,3,41,13.7,0,8.2,75,10.3,2,75,20,74,115,180,65,RB
2234,Will Tukuafu,0,0,0,2012,28,SFO,14,0,0,0,,0,0,0,,0,0,0,,0,0,,,0,,0,0,0,0,0,DT/FB
2235,Robert Turbin,80,19,99,2012,23,SEA,16,0,80,354,4.4,0,22.1,16,42.5,23,19,181,9.5,0,11.3,82.6,7.9,8,52.2,99,354,535,535,0,RB
2236,Michael Turner,222,19,241,2012,30,ATL,16,16,222,800,3.6,10,50,40,41,30,19,128,6.7,1,8,63.3,4.3,2,26.7,241,800,928,928,0,RB
2237,Shane Vereen,62,8,70,2012,23,NWE,13,1,62,251,4,3,19.3,15,51.6,13,8,149,18.6,1,11.5,61.5,11.5,6,53.8,70,251,400,400,0,RB
2238,Lawrence Vickers,3,13,16,2012,29,DAL,16,6,3,11,3.7,0,0.7,1,33.3,15,13,104,8,0,6.5,86.7,6.9,8,66.7,16,11,115,129,14,FB
2239,Danny Ware,11,14,25,2012,27,TAM,16,1,11,51,4.6,0,3.2,5,45.5,20,14,100,7.1,0,6.3,70,5,4,20,25,51,151,176,25,RB
2240,Leon Washington,23,4,27,2012,30,SEA,16,0,23,83,3.6,1,5.2,3,21.7,8,4,31,7.8,0,1.9,50,3.9,2,50,27,83,114,1254,1140,RB
2241,Beanie Wells,88,1,89,2012,24,ARI,8,7,88,234,2.7,5,29.3,11,34.1,1,1,24,24,0,3,100,24,1,100,89,234,258,258,0,RB
2242,Johnny White,8,0,8,2012,24,"BUF,GNB",7,0,8,34,4.3,0,4.9,1,50,0,0,0,,0,0,,,0,,8,34,34,34,0,RB
2243,DeAngelo Williams,173,13,186,2012,29,CAR,16,10,173,737,4.3,5,46.1,34,42.8,20,13,187,14.4,2,11.7,65,9.4,5,40,186,737,924,924,0,RB
2244,Keiland Williams,2,2,4,2012,26,"DET,WAS",14,0,2,3,1.5,0,0.2,0,0,2,2,9,4.5,0,0.6,100,4.5,0,0,4,3,12,12,0,RB
2245,Ryan Williams,58,7,65,2012,22,ARI,5,3,58,164,2.8,0,32.8,8,32.8,10,7,44,6.3,0,8.8,70,4.4,3,30,65,164,208,208,0,RB
2246,David Wilson,71,4,75,2012,21,NYG,16,2,71,358,5,4,22.4,17,38,9,4,34,8.5,1,2.1,44.4,3.8,2,33.3,75,358,392,1925,1533,RB
2247,Danny Woodhead,76,40,116,2012,27,NWE,16,2,76,301,4,4,18.8,20,52.6,55,40,446,11.2,3,27.9,72.7,8.1,23,54.5,116,301,747,790,43,RB
2248,Darrel Young,14,8,22,2012,25,WAS,16,8,14,60,4.3,0,3.8,7,57.1,9,8,109,13.6,2,6.8,88.9,12.1,6,88.9,22,60,169,169,0,FB
2249,Joseph Addai,118,15,133,2011,28,IND,12,11,118,433,3.7,1,36.1,16,35.6,22,15,93,6.2,0,7.8,68.2,4.2,5,31.8,133,433,526,526,0,RB
2250,Anthony Allen,3,0,3,2011,23,BAL,5,0,3,8,2.7,0,1.6,0,0,0,0,0,,0,0,,,0,,3,8,8,8,0,RB
2251,Armando Allen,15,0,15,2011,22,CHI,2,0,15,48,3.2,0,24,3,33.3,1,0,0,,0,0,0,0,0,0,15,48,48,65,17,RB
2252,Lance Ball,96,16,112,2011,26,DEN,16,0,96,402,4.2,1,25.1,26,43.8,32,16,148,9.3,1,9.3,50,4.6,8,37.5,112,402,550,559,9,RB
2253,Marion Barber III,114,5,119,2011,28,CHI,11,1,114,422,3.7,6,38.4,26,39.5,9,5,50,10,0,4.5,55.6,5.6,1,33.3,119,422,472,472,0,RB
2254,Jackie Battle,149,9,158,2011,28,KAN,15,4,149,597,4,2,39.8,27,44.3,13,9,68,7.6,0,4.5,69.2,5.2,2,23.1,158,597,665,665,0,RB
2255,Kahlil Bell,79,19,98,2011,25,CHI,13,3,79,337,4.3,0,25.9,15,40.5,23,19,133,7,1,10.2,82.6,5.8,4,43.5,98,337,470,515,45,RB
2256,Cedric Benson,273,15,288,2011,29,CIN,15,15,273,1067,3.9,6,71.1,51,45.1,22,15,82,5.5,0,5.5,68.2,3.7,3,31.8,288,1067,1149,1149,0,RB
2257,Jahvid Best,84,27,111,2011,22,DET,6,6,84,390,4.6,2,65,16,39.3,40,27,287,10.6,1,47.8,67.5,7.2,11,37.5,111,390,677,677,0,RB
2258,LeGarrette Blount,184,15,199,2011,25,TAM,14,14,184,781,4.2,5,55.8,32,46.2,25,15,148,9.9,0,10.6,60,5.9,6,40,199,781,929,929,0,RB
2259,Brock Bolen,2,2,4,2011,26,JAX,13,0,2,14,7,0,1.1,1,100,5,2,6,3,0,0.5,40,1.2,0,0,4,14,20,20,0,RB
2260,Lorenzo Booker,13,8,21,2011,27,MIN,15,0,13,52,4,0,3.5,3,46.2,14,8,82,10.3,0,5.5,57.1,5.9,3,35.7,21,52,134,584,450,RB
2261,Ahmad Bradshaw,171,34,205,2011,25,NYG,12,9,171,659,3.9,9,54.9,41,42.1,44,34,267,7.9,2,22.3,77.3,6.1,12,43.2,205,659,926,926,0,RB
2262,Allen Bradford,5,0,5,2011,23,TAM,1,0,5,13,2.6,0,13,0,0,0,0,0,,0,0,,,0,,5,13,13,13,0,RB
2263,Curtis Brinkley,30,7,37,2011,26,SDG,10,1,30,101,3.4,1,10.1,4,36.7,9,7,41,5.9,0,4.1,77.8,4.6,1,33.3,37,101,142,176,34,RB
2264,Aaron Brown,1,1,2,2011,26,DET,1,0,1,0,0,0,0,0,0,1,1,9,9,0,9,100,9,0,0,2,0,9,9,0,RB
2265,Donald Brown,134,16,150,2011,24,IND,16,2,134,645,4.8,5,40.3,26,40.3,19,16,86,5.4,0,5.4,84.2,4.5,3,31.6,150,645,731,731,0,RB
2266,Ronnie Brown,42,0,42,2011,30,PHI,16,2,42,136,3.2,1,8.5,11,45.2,2,0,0,,0,0,0,0,0,0,42,136,136,164,28,RB
2267,Eldra Buckley,0,0,0,2011,26,DET,2,0,0,0,,0,0,0,,0,0,0,,0,0,,,0,,0,0,0,0,,RB
2268,Michael Bush,256,37,293,2011,27,OAK,16,9,256,977,3.8,7,61.1,56,43.4,47,37,418,11.3,1,26.1,78.7,8.9,14,55.3,293,977,1395,1395,0,RB
2269,Reggie Bush,216,43,259,2011,26,MIA,15,15,216,1086,5,6,72.4,41,43.5,52,43,296,6.9,1,19.7,82.7,5.7,12,38.5,259,1086,1382,1434,52,RB
2270,Delone Carter,101,5,106,2011,24,IND,16,3,101,377,3.7,2,23.6,18,45.5,8,5,18,3.6,0,1.1,62.5,2.3,0,12.5,106,377,395,395,0,RB
2271,Rock Cartwright,4,4,8,2011,32,OAK,15,0,4,45,11.3,0,3,1,75,6,4,24,6,0,1.6,66.7,4,1,33.3,8,45,69,84,15,FB
2272,James Casey,1,18,19,2011,27,HOU,14,7,1,11,11,0,0.8,1,100,24,18,260,14.4,1,18.6,75,10.8,11,62.5,19,11,271,271,0,FB
2273,Shaun Chapas,0,1,1,2011,23,DAL,3,0,0,0,,0,0,0,,1,1,9,9,0,3,100,9,0,0,1,0,9,9,0,RB
2274,Jamaal Charles,12,5,17,2011,25,KAN,2,1,12,83,6.9,0,41.5,3,50,6,5,9,1.8,1,4.5,83.3,1.5,2,33.3,17,83,92,92,0,RB
2275,Tashard Choice,57,19,76,2011,27,"BUF,DAL,WAS",13,1,57,152,2.7,1,11.7,10,31.6,30,19,124,6.5,0,9.5,63.3,4.1,2,13.3,76,152,276,275,0,RB
2276,Charles Clay,0,16,16,2011,22,MIA,14,9,0,0,,0,0,0,,25,16,233,14.6,3,16.6,64,9.3,12,48,16,0,233,233,0,FB
2277,John Clay,10,0,10,2011,23,PIT,2,0,10,41,4.1,1,20.5,1,40,0,0,0,,0,0,,,0,,10,41,41,41,0,RB
2278,Thomas Clayton,8,1,9,2011,27,CLE,3,0,8,12,1.5,0,4,1,50,1,1,3,3,0,1,100,3,0,0,9,12,15,15,0,RB
2279,Tyler Clutts,0,8,8,2011,27,CHI,16,8,0,0,,0,0,0,,10,8,48,6,0,3,80,4.8,2,60,8,0,48,57,9,FB
2280,Jed Collins,4,11,15,2011,25,NOR,16,11,4,4,1,2,0.3,3,75,14,11,50,4.5,2,3.1,78.6,3.6,6,42.9,15,4,54,61,7,FB
2281,John Conner,13,2,15,2011,24,NYJ,16,8,13,44,3.4,1,2.8,6,69.2,5,2,9,4.5,0,0.6,40,1.8,1,20,15,44,53,82,29,FB
2282,Mike Cox,0,2,2,2011,26,ATL,9,5,0,0,,0,0,0,,3,2,8,4,0,0.9,66.7,2.7,0,0,2,0,8,8,0,FB
2283,Anthony Dixon,29,1,30,2011,24,SFO,16,0,29,87,3,2,5.4,6,41.4,1,1,6,6,0,0.4,100,6,0,0,30,87,93,93,0,RB
2284,Shaun Draughn,0,0,0,2011,24,KAN,1,0,0,0,,0,0,0,,0,0,0,,0,0,,,0,,0,0,0,0,0,RB
2285,Maurice Jones-Drew,343,43,386,2011,26,JAX,16,16,343,1606,4.7,8,100.4,76,48.1,64,43,374,8.7,3,23.4,67.2,5.8,18,43.8,386,1606,1980,1964,0,RB
2286,Jonathan Dwyer,16,1,17,2011,22,PIT,7,0,16,123,7.7,0,17.6,2,37.5,1,1,6,6,0,0.9,100,6,0,0,17,123,129,129,0,RB
2287,Darren Evans,0,0,0,2011,23,IND,2,0,0,0,,0,0,0,,0,0,0,,0,0,,,0,,0,0,0,0,0,RB
2288,Kevin Faulk,17,7,24,2011,35,NWE,7,3,17,57,3.4,0,8.1,1,52.9,9,7,34,4.9,0,4.9,77.8,3.8,2,33.3,24,57,91,102,11,RB
2289,Jerome Felton,3,4,7,2011,25,"CAR,IND",14,3,3,10,3.3,0,0.7,3,100,7,4,40,10,0,2.9,57.1,5.7,1,28.6,7,10,50,50,0,RB
2290,Tony Fiammetta,4,3,7,2011,25,DAL,10,6,4,4,1,0,0.4,1,25,5,3,39,13,0,3.9,60,7.8,3,60,7,4,43,43,0,FB
2291,Justin Forsett,46,23,69,2011,26,SEA,16,0,46,145,3.2,1,9.1,6,23.9,34,23,128,5.6,0,8,67.6,3.8,6,32.4,69,145,273,284,11,RB
2292,Matt Forte,203,52,255,2011,26,CHI,12,12,203,997,4.9,3,83.1,41,43.8,76,52,490,9.4,1,40.8,68.4,6.4,20,38.2,255,997,1487,1487,0,RB
2293,Arian Foster,278,53,331,2011,25,HOU,13,13,278,1224,4.4,10,94.2,58,42.4,72,53,617,11.6,2,47.5,73.6,8.6,19,43.1,331,1224,1841,1841,0,RB
2294,Toby Gerhart,109,23,132,2011,24,MIN,16,5,109,531,4.9,1,33.2,26,41.3,28,23,190,8.3,3,11.9,82.1,6.8,8,53.6,132,531,721,721,0,RB
2295,Mike Goodson,0,1,1,2011,24,CAR,4,0,0,0,,0,0,0,,3,1,4,4,0,1,33.3,1.3,0,0,1,0,4,254,250,RB
2296,Frank Gore,282,17,299,2011,28,SFO,16,15,282,1211,4.3,8,75.7,55,41.5,31,17,114,6.7,0,7.1,54.8,3.7,4,35.5,299,1211,1325,1325,0,RB
2297,Earnest Graham,37,26,63,2011,31,TAM,7,2,37,206,5.6,0,29.4,5,45.9,31,26,163,6.3,0,23.3,83.9,5.3,8,54.8,63,206,369,367,0,RB
2298,Ryan Grant,134,19,153,2011,29,GNB,15,14,134,559,4.2,2,37.3,27,42.5,24,19,268,14.1,1,17.9,79.2,11.2,10,66.7,153,559,827,827,0,RB
2299,Alex Green,3,1,4,2011,23,GNB,4,0,3,11,3.7,0,2.8,0,33.3,1,1,6,6,0,1.5,100,6,1,100,4,11,17,17,0,RB
2300,BenJarvus Green-Ellis,181,9,190,2011,26,NWE,16,6,181,667,3.7,11,41.7,42,51.4,13,9,159,17.7,0,9.9,69.2,12.2,7,61.5,190,667,826,826,0,RB
2301,Shonn Greene,253,30,283,2011,26,NYJ,16,15,253,1054,4.2,6,65.9,46,47.4,41,30,211,7,0,13.2,73.2,5.1,7,53.7,283,1054,1265,1265,0,RB
2302,Chris Gronkowski,0,0,0,2011,25,IND,7,0,0,0,,0,0,0,,0,0,0,,0,0,,,0,,0,0,0,0,0,RB
2303,Ahmard Hall,6,9,15,2011,32,TEN,12,7,6,24,4,0,2,3,66.7,14,9,46,5.1,0,3.8,64.3,3.3,1,35.7,15,24,70,70,0,FB
2304,Korey Hall,0,0,0,2011,28,NOR,13,0,0,0,,0,0,0,,0,0,0,,0,0,,,0,,0,0,0,0,0,FB
2305,Montario Hardesty,88,14,102,2011,24,CLE,10,4,88,266,3,0,26.6,6,33,21,14,122,8.7,0,12.2,66.7,5.8,8,57.1,102,266,388,388,0,RB
2306,Jamie Harper,17,4,21,2011,22,TEN,13,0,17,44,2.6,1,3.4,4,35.3,6,4,32,8,0,2.5,66.7,5.3,1,16.7,21,44,76,76,0,RB
2307,DuJuan Harris,9,1,10,2011,23,JAX,5,0,9,42,4.7,0,8.4,2,55.6,2,1,4,4,0,0.8,50,2,0,0,10,42,46,354,308,RB
2308,Jerome Harrison,14,1,15,2011,28,DET,4,0,14,41,2.9,0,10.3,3,50,2,1,3,3,0,0.8,50,1.5,0,0,15,41,44,44,0,RB
2309,Roy Helu,151,49,200,2011,23,WAS,15,5,151,640,4.2,2,42.7,31,45.7,59,49,379,7.7,1,25.3,83.1,6.4,13,42.4,200,640,1019,1019,0,RB
2310,Jacob Hester,28,12,40,2011,26,SDG,16,3,28,90,3.2,0,5.6,9,42.9,18,12,48,4,1,3,66.7,2.7,3,33.3,40,90,138,209,71,RB
2311,Tim Hightower,84,10,94,2011,25,WAS,5,5,84,321,3.8,1,64.2,13,45.2,15,10,78,7.8,1,15.6,66.7,5.2,6,46.7,94,321,399,399,0,RB
2312,Lex Hilliard,16,5,21,2011,27,MIA,16,4,16,41,2.6,1,2.6,9,75,7,5,49,9.8,0,3.1,71.4,7,2,42.9,21,41,90,104,14,RB
2313,Peyton Hillis,161,22,183,2011,25,CLE,10,9,161,587,3.6,3,58.7,33,55.9,34,22,130,5.9,0,13,64.7,3.8,5,26.5,183,587,717,717,0,RB
2314,Kendall Hunter,112,16,128,2011,23,SFO,16,1,112,473,4.2,2,29.6,23,45.5,26,16,195,12.2,0,12.2,61.5,7.5,10,46.2,128,473,668,824,156,RB
2315,Henry Hynoski,0,12,12,2011,23,NYG,11,4,0,0,,0,0,0,,16,12,83,6.9,0,7.5,75,5.2,6,56.3,12,0,83,98,15,RB
2316,Mark Ingram,122,11,133,2011,22,NOR,10,4,122,474,3.9,5,47.4,29,53.3,13,11,46,4.2,0,4.6,84.6,3.5,3,46.2,133,474,520,520,0,RB
2317,Chris Ivory,79,0,79,2011,23,NOR,6,2,79,374,4.7,1,62.3,21,54.4,1,0,0,,0,0,0,0,0,0,79,374,374,374,0,RB
2318,Fred Jackson,170,39,209,2011,30,BUF,10,10,170,934,5.5,6,93.4,38,50.6,50,39,442,11.3,0,44.2,78,8.8,15,40,209,934,1376,1376,0,RB
2319,Steven Jackson,260,42,302,2011,28,STL,15,15,260,1145,4.4,5,76.3,51,38.5,58,42,333,7.9,1,22.2,72.4,5.7,17,48.3,302,1145,1478,1478,0,RB
2320,Brandon Jacobs,152,15,167,2011,29,NYG,14,6,152,571,3.8,7,40.8,32,47.4,23,15,128,8.5,1,9.1,65.2,5.6,6,30.4,167,571,699,699,0,RB
2321,Chris Johnson,262,57,319,2011,26,TEN,16,16,262,1047,4,4,65.4,47,39.7,79,57,418,7.3,0,26.1,72.2,5.3,14,36.7,319,1047,1465,1465,0,RB
2322,Jeremiah Johnson,14,7,21,2011,24,DEN,8,0,14,77,5.5,0,9.6,4,57.1,9,7,62,8.9,0,7.8,77.8,6.9,3,44.4,21,77,139,139,0,RB
2323,Larry Johnson,1,0,1,2011,32,MIA,1,0,1,2,2,0,2,0,0,0,0,0,,0,0,,,0,,1,2,2,2,0,RB
2324,Marquis Johnson,0,0,0,2011,23,STL,3,0,0,0,,0,0,0,,0,0,0,,0,0,,,0,,0,0,0,0,0,FB
2325,Quinn Johnson,0,3,3,2011,25,TEN,4,1,0,0,,0,0,0,,3,3,30,10,0,7.5,100,10,1,100,3,0,30,30,0,RB
2326,Felix Jones,127,33,160,2011,24,DAL,12,8,127,575,4.5,1,47.9,28,51.2,45,33,221,6.7,0,18.4,73.3,4.9,13,51.1,160,575,796,982,186,RB
2327,Greg Jones,2,4,6,2011,30,JAX,16,9,2,7,3.5,1,0.4,1,100,9,4,19,4.8,0,1.2,44.4,2.1,2,22.2,6,7,26,26,0,FB
2328,Taiwan Jones,16,2,18,2011,23,OAK,10,0,16,73,4.6,0,7.3,2,37.5,3,2,25,12.5,0,2.5,66.7,8.3,1,33.3,18,73,98,263,165,RB
2329,Thomas Jones,153,5,158,2011,33,KAN,16,8,153,478,3.1,0,29.9,19,34.6,7,5,43,8.6,0,2.7,71.4,6.1,1,42.9,158,478,521,521,0,RB
2330,Deji Karim,63,14,77,2011,25,JAX,12,0,63,130,2.1,0,10.8,10,28.6,19,14,120,8.6,0,10,73.7,6.3,4,21.1,77,130,250,902,652,RB
2331,Lance Kendricks,1,28,29,2011,23,STL,15,10,1,-8,-8,0,-0.5,0,0,58,28,352,12.6,0,23.5,48.3,6.1,15,36.2,29,-8,344,344,0,FB
2332,Jameson Konz,0,0,0,2011,25,SEA,1,0,0,0,,0,0,0,,0,0,0,,0,0,,,0,,0,0,0,0,0,RB
2333,John Kuhn,30,15,45,2011,29,GNB,16,3,30,78,2.6,4,4.9,9,33.3,18,15,77,5.1,2,4.8,83.3,4.3,5,55.6,45,78,155,155,0,FB
2334,Spencer Larsen,14,9,23,2011,27,DEN,16,6,14,44,3.1,0,2.8,3,57.1,9,9,76,8.4,0,4.8,100,8.4,4,100,23,44,120,120,0,FB
2335,Vonta Leach,12,15,27,2011,30,BAL,16,16,12,35,2.9,0,2.2,10,83.3,27,15,69,4.6,0,4.3,55.6,2.6,3,33.3,27,35,104,133,29,FB
2336,Brian Leonard,17,22,39,2011,27,CIN,13,0,17,85,5,0,6.5,4,35.3,31,22,210,9.5,0,16.2,71,6.8,10,35.5,39,85,295,295,0,RB
2337,Dion Lewis,23,1,24,2011,21,PHI,15,0,23,102,4.4,1,6.8,5,43.5,1,1,-3,-3,0,-0.2,100,-3,0,0,24,102,99,768,669,RB
2338,Stefan Logan,9,1,10,2011,30,DET,16,1,9,32,3.6,0,2,2,55.6,1,1,19,19,0,1.2,100,19,1,100,10,32,51,1184,1133,RB
2339,Erik Lorig,0,6,6,2011,25,TAM,16,7,0,0,,0,0,0,,9,6,53,8.8,0,3.3,66.7,5.9,2,44.4,6,0,53,53,0,FB
2340,Kregg Lumpkin,31,41,72,2011,27,TAM,16,0,31,105,3.4,0,6.6,5,38.7,53,41,291,7.1,0,18.2,77.4,5.5,13,41.5,72,105,396,396,0,RB
2341,Marshawn Lynch,285,28,313,2011,25,SEA,15,15,285,1204,4.2,12,80.3,65,43.5,41,28,212,7.6,1,14.1,68.3,5.2,8,36.6,313,1204,1416,1416,0,RB
2342,Mossis Madu,15,10,25,2011,24,TAM,9,0,15,55,3.7,0,6.1,3,46.7,12,10,72,7.2,0,8,83.3,6,1,58.3,25,55,127,127,0,RB
2343,Ryan Mahaffey,0,1,1,2011,24,IND,5,0,0,0,,0,0,0,,1,1,5,5,0,1,100,5,1,100,1,0,5,5,0,RB
2344,Owen Marecic,4,5,9,2011,23,CLE,14,4,4,8,2,0,0.6,1,25,7,5,31,6.2,0,2.2,71.4,4.4,2,57.1,9,8,39,85,46,RB
2345,Chris Massey,0,0,0,2011,32,CHI,6,0,0,0,,0,0,0,,0,0,0,,0,0,,,0,,0,0,0,0,0,RB
2346,Ryan Mathews,222,50,272,2011,24,SDG,14,14,222,1091,4.9,6,77.9,51,45.5,59,50,455,9.1,0,32.5,84.7,7.7,18,61,272,1091,1546,1546,0,RB
2347,Reagan Maui'a,0,1,1,2011,27,ARI,3,3,0,0,,0,0,0,,1,1,12,12,0,4,100,12,1,100,1,0,12,12,0,RB
2348,Le'Ron McClain,15,14,29,2011,27,KAN,16,10,15,51,3.4,1,3.2,3,46.7,22,14,82,5.9,1,5.1,63.6,3.7,7,45.5,29,51,133,133,0,FB
2349,LeSean McCoy,273,48,321,2011,23,PHI,15,15,273,1309,4.8,17,87.3,85,50.9,69,48,315,6.6,3,21,69.6,4.6,18,44.9,321,1309,1624,1624,0,RB
2350,Darren McFadden,113,19,132,2011,24,OAK,7,7,113,614,5.4,4,87.7,24,42.5,23,19,154,8.1,1,22,82.6,6.7,7,47.8,132,614,768,768,0,RB
2351,Willis McGahee,249,12,261,2011,30,DEN,15,14,249,1199,4.8,4,79.9,53,46.2,20,12,51,4.3,1,3.4,60,2.6,3,30,261,1199,1250,1250,0,RB
2352,Corey McIntyre,0,1,1,2011,32,BUF,16,1,0,0,,0,0,0,,1,1,4,4,0,0.3,100,4,0,0,1,0,4,4,0,FB
2353,Joe McKnight,43,13,56,2011,23,NYJ,15,0,43,134,3.1,0,8.9,8,39.5,18,13,139,10.7,0,9.3,72.2,7.7,7,55.6,56,134,273,1372,1099,RB
2354,Richard Medlin,0,0,0,2011,24,MIA,1,0,0,0,,0,0,0,,0,0,0,,0,0,,,0,,0,0,0,0,0,RB
2355,Rashard Mendenhall,228,18,246,2011,24,PIT,15,15,228,928,4.1,9,61.9,46,50.9,28,18,154,8.6,0,10.3,64.3,5.5,5,39.3,246,928,1082,1082,0,RB
2356,Bruce Miller,4,11,15,2011,24,SFO,15,8,4,8,2,0,0.5,2,50,15,11,83,7.5,1,5.5,73.3,5.5,4,33.3,15,8,91,91,0,FB
2357,Mewelde Moore,22,11,33,2011,29,PIT,12,0,22,157,7.1,0,13.1,5,63.6,14,11,104,9.5,1,8.7,78.6,7.4,4,57.1,33,157,261,271,10,RB
2358,Knowshon Moreno,37,11,48,2011,24,DEN,7,2,37,179,4.8,0,25.6,5,32.4,15,11,101,9.2,1,14.4,73.3,6.7,3,40,48,179,280,280,0,RB
2359,Maurice Morris,80,26,106,2011,32,DET,16,5,80,316,4,1,19.8,12,46.3,35,26,230,8.8,1,14.4,74.3,6.6,9,45.7,106,316,546,561,15,RB
2360,Sammy Morris,28,5,33,2011,34,DAL,3,0,28,98,3.5,0,32.7,7,42.9,7,5,13,2.6,0,4.3,71.4,1.9,0,14.3,33,98,111,111,0,RB
2361,Ovie Mughelli,2,4,6,2011,31,ATL,7,5,2,1,0.5,0,0.1,0,0,8,4,25,6.3,2,3.6,50,3.1,2,37.5,6,1,26,26,0,FB
2362,DeMarco Murray,164,26,190,2011,23,DAL,13,7,164,897,5.5,2,69,42,56.7,35,26,183,7,0,14.1,74.3,5.2,9,45.7,190,897,1080,1116,36,RB
2363,Moran Norris,0,0,0,2011,33,SFO,5,2,0,0,,0,0,0,,0,0,0,,0,0,,,0,,0,0,0,0,0,FB
2364,Jerious Norwood,24,0,24,2011,28,STL,9,0,24,61,2.5,0,6.8,1,16.7,1,0,0,,0,0,0,0,0,0,24,61,61,672,611,RB
2365,Chris Ogbonnaya,76,23,99,2011,25,"CLE,HOU",13,4,76,340,4.5,1,26.2,13,46.1,31,23,165,7.2,0,12.7,74.2,5.3,7,35.5,99,340,505,505,0,RB
2366,Montell Owens,10,2,12,2011,27,JAX,13,0,10,39,3.9,0,3,4,50,3,2,2,1,0,0.2,66.7,0.7,0,0,12,39,41,54,13,RB
2367,Cedric Peerman,3,0,3,2011,25,CIN,15,0,3,15,5,0,1,0,0,1,0,0,,0,0,0,0,0,0,3,15,15,25,10,RB
2368,Adrian Peterson,208,18,226,2011,26,MIN,12,12,208,970,4.7,12,80.8,48,45.7,24,18,139,7.7,1,11.6,75,5.8,5,29.2,226,970,1109,1109,0,RB
2369,Lousaka Polite,0,0,0,2011,30,NWE,1,0,0,0,,0,0,0,,0,0,0,,0,0,,,0,,0,0,0,0,0,RB
2370,Quinn Porter,0,0,0,2011,25,STL,12,0,0,0,,0,0,0,,1,0,0,,0,0,0,0,0,0,0,0,0,555,555,RB
2371,Bilal Powell,13,1,14,2011,23,NYJ,2,0,13,21,1.6,0,10.5,1,0,1,1,7,7,0,3.5,100,7,0,0,14,21,28,28,0,RB
2372,Chris Pressley,0,3,3,2011,25,CIN,15,10,0,0,,0,0,0,,5,3,19,6.3,0,1.3,60,3.8,1,40,3,0,19,19,0,FB
2373,Isaac Redman,110,18,128,2011,27,PIT,16,1,110,479,4.4,3,29.9,30,53.6,22,18,78,4.3,0,4.9,81.8,3.5,6,40.9,128,479,557,575,18,RB
2374,Marcel Reece,17,27,44,2011,26,OAK,12,6,17,112,6.6,0,9.3,7,58.8,36,27,301,11.1,2,25.1,75,8.4,13,47.2,44,112,413,413,0,FB
2375,Ray Rice,291,76,367,2011,24,BAL,16,16,291,1364,4.7,12,85.3,54,43,104,76,704,9.3,3,44,73.1,6.8,30,46.2,367,1365,2068,2068,0,RB
2376,Stevan Ridley,87,3,90,2011,22,NWE,16,2,87,441,5.1,1,27.6,18,49.4,5,3,13,4.3,0,0.8,60,2.6,0,20,90,441,454,606,152,RB
2377,Javon Ringer,59,28,87,2011,24,TEN,12,0,59,185,3.1,1,15.4,7,30.5,36,28,187,6.7,0,15.6,77.8,5.2,13,44.4,87,185,372,372,0,RB
2378,Michael Robinson,4,9,13,2011,28,SEA,14,4,4,7,1.8,0,0.5,1,50,14,9,74,8.2,1,5.3,64.3,5.3,4,64.3,13,7,81,81,0,FB
2379,Jacquizz Rodgers,57,21,78,2011,21,ATL,16,0,57,205,3.6,1,12.8,16,47.4,27,21,188,9,1,11.8,77.8,7,6,40.7,78,205,393,393,0,RB
2380,Evan Royster,56,9,65,2011,24,WAS,6,2,56,328,5.9,0,54.7,17,60.7,14,9,68,7.6,0,11.3,64.3,4.9,5,57.1,65,328,396,396,0,RB
2381,Brandon Saine,18,10,28,2011,23,GNB,8,0,18,69,3.8,0,8.6,1,55.6,12,10,69,6.9,0,8.6,83.3,5.8,1,33.3,28,69,138,178,40,RB
2382,Owen Schmitt,4,3,7,2011,26,PHI,16,5,4,6,1.5,0,0.4,0,25,7,3,32,10.7,0,2,42.9,4.6,2,42.9,7,6,38,38,0,FB
2383,Bernard Scott,112,13,125,2011,27,CIN,16,1,112,380,3.4,3,23.8,21,41.1,17,13,38,2.9,0,2.4,76.5,2.2,1,17.6,125,380,418,444,26,RB
2384,Da'Rel Scott,5,2,7,2011,23,NYG,11,0,5,16,3.2,0,1.5,1,40,2,2,13,6.5,0,1.2,100,6.5,0,50,7,16,29,370,341,RB
2385,Mike Sellers,0,1,1,2011,36,WAS,12,0,0,0,,0,0,0,,2,1,15,15,0,1.3,50,7.5,1,50,1,0,15,30,15,FB
2386,Anthony Sherman,1,8,9,2011,23,ARI,15,7,1,3,3,0,0.2,1,100,9,8,72,9,0,4.8,88.9,8,3,66.7,9,3,75,75,0,FB
2387,Steve Slaton,24,3,27,2011,25,"HOU,MIA",6,0,24,84,3.5,1,14,3,37.5,4,3,3,1,0,0.5,75,0.8,0,25,27,84,87,172,85,RB
2388,Alfonso Smith,30,3,33,2011,24,ARI,15,0,30,102,3.4,1,6.8,7,53.3,5,3,21,7,0,1.4,60,4.2,2,40,33,102,123,123,0,RB
2389,Antone Smith,0,0,0,2011,26,ATL,12,0,0,0,,0,0,0,,0,0,0,,0,0,,,0,,0,0,0,0,0,RB
2390,Armond Smith,3,0,3,2011,25,CLE,3,0,3,2,0.7,0,0.7,0,0,1,0,0,,0,0,0,0,0,0,3,2,2,2,0,RB
2391,Kevin Smith,72,22,94,2011,25,DET,7,4,72,356,4.9,4,50.9,16,40.3,28,22,179,8.1,3,25.6,78.6,6.4,9,57.1,94,356,535,535,0,RB
2392,Jason Snelling,44,26,70,2011,28,ATL,15,0,44,151,3.4,0,10.1,8,34.1,32,26,179,6.9,1,11.9,81.3,5.6,6,50,70,151,330,330,0,RB
2393,Chad Spann,0,0,0,2011,23,PIT,0,0,0,0,,0,,0,,0,0,0,,0,,,,0,,0,0,0,0,0,RB
2394,C.J. Spiller,107,39,146,2011,24,BUF,16,11,107,561,5.2,4,35.1,27,51.4,54,39,269,6.9,2,16.8,72.2,5,16,44.4,146,561,830,1100,270,RB
2395,Darren Sproles,87,86,173,2011,28,NOR,16,4,87,603,6.9,2,37.7,27,52.9,111,86,710,8.3,7,44.4,77.5,6.4,35,51.4,173,603,1313,2696,1383,RB
2396,James Starks,133,29,162,2011,25,GNB,13,2,133,578,4.3,1,44.5,31,45.1,37,29,216,7.4,0,16.6,78.4,5.8,9,48.6,162,578,794,794,0,RB
2397,LaRod Stephens-Howling,43,13,56,2011,24,ARI,14,1,43,167,3.9,0,11.9,5,39.5,17,13,234,18,2,16.7,76.5,13.8,6,58.8,56,167,401,1258,857,RB
2398,Jonathan Stewart,142,47,189,2011,24,CAR,16,3,142,761,5.4,4,47.6,47,52.1,61,47,413,8.8,1,25.8,77,6.8,18,45.9,189,761,1174,1174,0,RB
2399,Luke Stocker,0,12,12,2011,23,TAM,14,9,0,0,,0,0,0,,17,12,92,7.7,0,6.6,70.6,5.4,5,41.2,12,0,92,92,0,FB
2400,Phillip Tanner,22,2,24,2011,23,DAL,9,0,22,76,3.5,1,8.4,5,45.5,2,2,19,9.5,0,2.1,100,9.5,2,100,24,76,95,95,0,RB
2401,Ben Tate,175,13,188,2011,23,HOU,15,2,175,942,5.4,4,62.8,53,50.3,19,13,98,7.5,0,6.5,68.4,5.2,4,47.4,188,942,1040,1040,0,RB
2402,Chester Taylor,20,14,34,2011,32,ARI,12,1,20,77,3.9,1,6.4,4,40,24,14,91,6.5,0,7.6,58.3,3.8,3,16.7,34,77,168,168,0,RB
2403,Daniel Thomas,165,12,177,2011,24,MIA,13,2,165,581,3.5,0,44.7,25,40,16,12,72,6,1,5.5,75,4.5,5,50,177,581,653,653,0,RB
2404,Pierre Thomas,110,50,160,2011,27,NOR,16,7,110,562,5.1,5,35.1,29,60.9,59,50,425,8.5,1,26.6,84.7,7.2,18,52.5,160,562,987,1002,15,RB
2405,Mike Tolbert,121,54,175,2011,26,SDG,15,1,121,490,4,8,32.7,26,44.6,79,54,433,8,2,28.9,68.4,5.5,23,46.8,175,490,923,923,0,RB
2406,LaDainian Tomlinson,75,42,117,2011,32,NYJ,14,1,75,280,3.7,1,20,15,45.3,61,42,449,10.7,2,32.1,68.9,7.4,12,31.1,117,278,729,729,0,RB
2407,Manase Tonga,1,3,4,2011,27,OAK,11,3,1,12,12,0,1.1,1,100,4,3,18,6,0,1.6,75,4.5,1,50,4,12,30,30,0,RB
2408,Ryan Torain,59,6,65,2011,25,WAS,8,4,59,200,3.4,1,25,5,40.7,9,6,23,3.8,0,2.9,66.7,2.6,0,33.3,65,200,223,223,0,RB
2409,Michael Turner,301,17,318,2011,29,ATL,16,15,301,1340,4.5,11,83.8,63,44.5,26,17,168,9.9,0,10.5,65.4,6.5,8,53.8,318,1340,1508,1508,0,RB
2410,Josh Vaughan,7,0,7,2011,25,CAR,7,0,7,24,3.4,0,3.4,0,0,0,0,0,,0,0,,,0,,7,24,24,24,0,RB
2411,Shane Vereen,15,0,15,2011,22,NWE,5,0,15,57,3.8,1,11.4,2,33.3,0,0,0,,0,0,,,0,,15,57,57,57,0,RB
2412,Lawrence Vickers,1,4,5,2011,28,HOU,14,1,1,0,0,0,0,0,0,8,4,29,7.3,0,2.1,50,3.6,2,37.5,5,0,29,29,0,FB
2413,Delanie Walker,3,19,22,2011,27,SFO,15,7,3,5,1.7,0,0.3,1,33.3,35,19,198,10.4,3,13.2,54.3,5.7,9,40,22,5,203,203,0,FB
2414,Derrick Ward,45,0,45,2011,31,HOU,12,1,45,154,3.4,2,12.8,11,46.7,1,0,0,,0,0,0,0,0,0,45,154,154,154,0,RB
2415,Danny Ware,46,27,73,2011,26,NYG,16,1,46,163,3.5,0,10.2,7,43.5,37,27,170,6.3,0,10.6,73,4.6,6,51.4,73,163,333,350,17,RB
2416,Chauncey Washington,1,2,3,2011,26,DAL,2,0,1,-1,-1,0,-0.5,0,0,3,2,13,6.5,0,6.5,66.7,4.3,1,33.3,3,-1,12,12,0,RB
2417,Leon Washington,53,10,63,2011,29,SEA,16,1,53,248,4.7,1,15.5,9,35.8,14,10,48,4.8,0,3,71.4,3.4,2,42.9,63,248,296,1844,1548,RB
2418,Beanie Wells,245,10,255,2011,23,ARI,14,14,245,1047,4.3,10,74.8,48,50.2,16,10,52,5.2,0,3.7,62.5,3.3,1,31.3,255,1047,1099,1099,0,RB
2419,Johnny White,12,1,13,2011,23,BUF,12,0,12,38,3.2,0,3.2,1,41.7,4,1,-3,-3,0,-0.3,25,-0.8,0,0,13,38,35,35,0,RB
2420,Cadillac Williams,87,14,101,2011,29,STL,11,1,87,361,4.1,1,32.8,18,43.7,23,14,93,6.6,0,8.5,60.9,4,5,39.1,101,361,454,454,0,RB
2421,DeAngelo Williams,155,16,171,2011,28,CAR,16,14,155,836,5.4,7,52.3,33,43.9,25,16,135,8.4,0,8.4,64,5.4,6,52,171,836,971,971,0,RB
2422,Eddie Williams,2,1,3,2011,24,"CLE,SEA",6,0,2,2,1,0,0.3,1,50,1,1,17,17,0,2.8,100,17,1,100,3,2,19,19,0,RB
2423,Keiland Williams,58,8,66,2011,25,DET,15,0,58,195,3.4,2,13,12,32.8,8,8,62,7.8,0,4.1,100,7.8,3,87.5,66,195,257,257,0,RB
2424,Ricky Williams,108,13,121,2011,34,BAL,16,0,108,444,4.1,2,27.8,20,48.1,20,13,83,6.4,0,5.2,65,4.2,6,55,121,444,527,527,0,RB
2425,Danny Woodhead,77,18,95,2011,26,NWE,15,4,77,351,4.6,1,23.4,18,53.2,31,18,157,8.7,0,10.5,58.1,5.1,8,45.2,95,351,508,945,437,RB
2426,Darrel Young,6,15,21,2011,24,WAS,13,8,6,33,5.5,1,2.5,6,100,19,15,146,9.7,0,11.2,78.9,7.7,6,52.6,21,33,179,179,0,FB
2427,Joseph Addai,116,19,135,2010,27,IND,8,7,116,495,4.3,4,61.9,32,53.4,26,19,124,6.5,0,15.5,73.1,4.8,5,42.3,135,495,619,619,0,RB
2428,Andre' Anderson,0,0,0,2010,22,BUF,2,0,0,0,,0,0,0,,0,0,0,,0,0,,,0,,0,0,0,0,0,RB
2429,Deon Anderson,0,0,0,2010,27,DAL,1,0,0,0,,0,0,0,,0,0,0,,0,0,,,0,,0,0,0,0,0,FB
2430,Lance Ball,41,3,44,2010,25,DEN,10,0,41,158,3.9,0,15.8,7,36.6,6,3,16,5.3,0,1.6,50,2.7,1,33.3,44,158,174,207,33,RB
2431,Marion Barber III,113,11,124,2010,27,DAL,13,10,113,374,3.3,4,28.8,27,45.1,16,11,49,4.5,0,3.8,68.8,3.1,0,18.8,124,374,423,423,0,RB
2432,Jackie Battle,20,1,21,2010,27,KAN,16,0,20,50,2.5,1,3.1,7,45,3,1,9,9,0,0.6,33.3,3,0,33.3,21,50,59,59,0,RB
2433,Joique Bell,0,0,0,2010,24,"IND,PHI",8,0,0,0,,0,0,0,,0,0,0,,0,0,,,0,,0,0,0,0,0,RB
2434,Mike Bell,47,7,54,2010,27,"CLE,PHI",16,1,47,99,2.1,0,6.2,6,21.3,10,7,67,9.6,0,4.2,70,6.7,3,40,54,99,166,229,63,RB
2435,Michael Bennett,2,2,4,2010,32,OAK,7,0,2,11,5.5,0,1.6,1,50,2,2,9,4.5,0,1.3,100,4.5,0,50,4,11,20,20,0,RB
2436,Cedric Benson,321,28,349,2010,28,CIN,16,16,321,1111,3.5,7,69.4,59,44.2,37,28,178,6.4,1,11.1,75.7,4.8,9,45.9,349,1111,1289,1289,0,RB
2437,Jahvid Best,171,58,229,2010,21,DET,16,9,171,555,3.2,4,34.7,25,35.7,80,58,487,8.4,2,30.4,72.5,6.1,15,37.5,229,555,1042,1042,0,RB
2438,Ladell Betts,45,23,68,2010,31,NOR,8,1,45,150,3.3,2,18.8,11,48.9,31,23,141,6.1,0,17.6,74.2,4.5,6,32.3,68,150,291,314,23,RB
2439,LeGarrette Blount,201,5,206,2010,24,TAM,13,7,201,1007,5,6,77.5,38,43.8,7,5,14,2.8,0,1.1,71.4,2,0,14.3,206,1007,1021,1021,0,RB
2440,Brock Bolen,0,1,1,2010,25,JAX,4,0,0,0,,0,0,0,,3,1,15,15,0,3.8,33.3,5,1,33.3,1,0,15,20,5,RB
2441,Lorenzo Booker,0,5,5,2010,26,MIN,4,0,0,0,,0,0,0,,6,5,32,6.4,0,8,83.3,5.3,3,66.7,5,0,32,461,429,RB
2442,Ahmad Bradshaw,276,47,323,2010,24,NYG,16,11,276,1235,4.5,8,77.2,53,44.2,58,47,314,6.7,0,19.6,81,5.4,18,44.8,323,1235,1549,1549,0,RB
2443,Curtis Brinkley,2,0,2,2010,25,SDG,3,0,2,11,5.5,0,3.7,1,50,0,0,0,,0,0,,,0,,2,11,11,40,29,RB
2444,Aaron Brown,17,8,25,2010,25,DET,6,0,17,58,3.4,0,9.7,2,47.1,13,8,45,5.6,0,7.5,61.5,3.5,2,38.5,25,58,103,103,0,RB
2445,Andre Brown,2,0,2,2010,24,"IND,DEN",4,0,2,-1,-0.5,0,-0.3,0,0,0,0,0,,0,0,,,0,,2,-1,-1,-1,0,RB
2446,Donald Brown,129,20,149,2010,23,IND,13,8,129,497,3.9,2,38.2,27,43.4,28,20,205,10.3,0,15.8,71.4,7.3,9,57.1,149,497,702,702,0,RB
2447,Ronnie Brown,200,33,233,2010,29,MIA,16,16,200,734,3.7,5,45.9,40,41.5,43,33,242,7.3,0,15.1,76.7,5.6,13,44.2,233,734,976,976,0,RB
2448,Correll Buckhalter,59,28,87,2010,32,DEN,15,0,59,147,2.5,2,9.8,10,27.1,39,28,240,8.6,2,16,71.8,6.2,9,41,87,147,387,387,0,RB
2449,Eldra Buckley,21,1,22,2010,25,PHI,16,0,21,67,3.2,0,4.2,3,33.3,2,1,10,10,0,0.6,50,5,0,50,22,67,77,97,20,RB
2450,Michael Bush,158,18,176,2010,26,OAK,14,3,158,655,4.1,8,46.8,32,44.3,24,18,194,10.8,0,13.9,75,8.1,11,58.3,176,655,849,849,0,RB
2451,Reggie Bush,36,34,70,2010,25,NOR,8,6,36,150,4.2,0,18.8,6,41.7,42,34,208,6.1,1,26,81,5,10,47.6,70,150,358,482,124,RB
2452,Rock Cartwright,9,1,10,2010,31,OAK,16,0,9,22,2.4,0,1.4,2,22.2,3,1,10,10,0,0.6,33.3,3.3,0,0,10,22,32,135,103,FB
2453,Tim Castille,5,10,15,2010,26,KAN,10,4,5,3,0.6,0,0.3,0,20,12,10,43,4.3,0,4.3,83.3,3.6,3,33.3,15,3,46,46,0,RB
2454,Jehuu Caulcrick,1,0,1,2010,27,BUF,2,0,1,2,2,0,1,1,100,0,0,0,,0,0,,,0,,1,2,2,30,28,RB
2455,Jamaal Charles,230,45,275,2010,24,KAN,16,6,230,1467,6.4,5,91.7,70,54.8,64,45,468,10.4,3,29.3,70.3,7.3,22,51.6,275,1467,1935,1935,0,RB
2456,Tashard Choice,66,17,83,2010,26,DAL,16,0,66,243,3.7,3,15.2,13,43.9,22,17,109,6.4,0,6.8,77.3,5,6,36.4,83,243,352,413,61,RB
2457,Thomas Clayton,7,0,7,2010,26,"CLE,NWE",3,0,7,17,2.4,0,5.7,1,28.6,0,0,0,,0,0,,,0,,7,17,17,17,0,RB
2458,Patrick Cobbs,4,8,12,2010,27,MIA,16,1,4,0,0,0,0,0,0,18,8,91,11.4,2,5.7,44.4,5.1,4,33.3,12,0,91,539,448,RB
2459,John Conner,8,2,10,2010,23,NYJ,16,0,8,44,5.5,1,2.8,2,37.5,4,2,9,4.5,0,0.6,50,2.3,1,25,10,44,53,88,35,RB
2460,Mike Cox,0,4,4,2010,25,KAN,7,2,0,0,,0,0,0,,4,4,27,6.8,0,3.9,100,6.8,1,75,4,0,27,27,0,RB
2461,Kenneth Darby,34,10,44,2010,28,STL,14,0,34,107,3.1,2,7.6,7,35.3,13,10,61,6.1,1,4.4,76.9,4.7,2,30.8,44,107,168,168,0,RB
2462,James Davis,19,4,23,2010,24,"CLE,WAS",7,0,19,60,3.2,0,8.6,1,21.1,5,4,45,11.3,0,6.4,80,9,1,80,23,60,105,116,11,RB
2463,Anthony Dixon,70,5,75,2010,23,SFO,16,0,70,237,3.4,2,14.8,11,41.4,5,5,11,2.2,0,0.7,100,2.2,1,40,75,237,248,248,0,RB
2464,Maurice Jones-Drew,299,34,333,2010,25,JAX,14,14,299,1324,4.4,5,94.6,74,50.8,44,34,317,9.3,2,22.6,77.3,7.2,13,43.2,333,1324,1641,1641,0,RB
2465,Jonathan Dwyer,9,0,9,2010,21,PIT,1,0,9,28,3.1,0,28,0,0,0,0,0,,0,0,,,0,,9,28,28,28,0,RB
2466,Heath Evans,2,7,9,2010,32,NOR,16,6,2,2,1,0,0.1,0,0,11,7,41,5.9,1,2.6,63.6,3.7,4,54.5,9,2,43,88,45,FB
2467,Kevin Faulk,8,6,14,2010,34,NWE,2,2,8,45,5.6,0,22.5,1,50,10,6,62,10.3,0,31,60,6.2,2,50,14,45,107,107,0,RB
2468,Jerome Felton,22,8,30,2010,24,DET,16,2,22,76,3.5,0,4.8,4,40.9,15,8,54,6.8,0,3.4,53.3,3.6,3,40,30,76,130,189,59,RB
2469,Tony Fiammetta,7,5,12,2010,24,CAR,14,9,7,22,3.1,0,1.6,4,57.1,10,5,34,6.8,0,2.4,50,3.4,3,40,12,22,56,56,0,FB
2470,Justin Forsett,118,33,151,2010,25,SEA,16,5,118,523,4.4,2,32.7,24,37.3,51,33,252,7.6,0,15.8,64.7,4.9,10,39.2,151,523,775,800,25,RB
2471,Matt Forte,237,51,288,2010,25,CHI,16,16,237,1069,4.5,6,66.8,43,40.9,70,51,547,10.7,3,34.2,72.9,7.8,21,48.6,288,1069,1616,1616,0,RB
2472,Arian Foster,327,66,393,2010,24,HOU,16,13,327,1616,4.9,16,101,90,51.4,84,66,604,9.2,2,37.8,78.6,7.2,34,51.2,393,1616,2220,2221,0,RB
2473,Quinton Ganther,9,2,11,2010,26,"BUF,SEA",11,1,9,18,2,0,1.6,1,33.3,3,2,9,4.5,0,0.8,66.7,3,0,33.3,11,18,27,27,0,RB
2474,Toby Gerhart,81,21,102,2010,23,MIN,15,1,81,322,4,1,21.5,14,42,29,21,167,8,0,11.1,72.4,5.8,4,41.4,102,322,489,489,0,RB
2475,Mike Goodson,103,40,143,2010,23,CAR,16,3,103,452,4.4,3,28.3,20,40.8,57,40,310,7.8,0,19.4,70.2,5.4,15,36.8,143,452,762,1783,1034,RB
2476,Frank Gore,203,46,249,2010,27,SFO,11,11,203,853,4.2,3,77.5,42,47.3,72,46,452,9.8,2,41.1,63.9,6.3,15,38.9,249,853,1305,1305,0,RB
2477,Earnest Graham,20,16,36,2010,30,TAM,12,7,20,99,5,1,8.3,5,45,19,16,130,8.1,1,10.8,84.2,6.8,3,52.6,36,101,229,229,0,RB
2478,Ryan Grant,8,0,8,2010,28,GNB,1,1,8,45,5.6,0,45,2,37.5,0,0,0,,0,0,,,0,,8,45,45,45,0,RB
2479,BenJarvus Green-Ellis,229,12,241,2010,25,NWE,16,11,229,1008,4.4,13,63,65,54.1,16,12,85,7.1,0,5.3,75,5.3,5,62.5,241,1008,1093,1093,0,RB
2480,Shonn Greene,185,16,201,2010,25,NYJ,15,2,185,766,4.1,2,51.1,41,53,24,16,120,7.5,0,8,66.7,5,9,58.3,201,766,886,886,0,RB
2481,Chris Gronkowski,5,7,12,2010,24,DAL,14,7,5,17,3.4,0,1.2,2,80,14,7,35,5,1,2.5,50,2.5,2,35.7,12,17,52,75,23,FB
2482,Ahmard Hall,1,15,16,2010,31,TEN,16,4,1,1,1,0,0.1,1,100,20,15,100,6.7,0,6.3,75,5,5,45,16,1,101,122,21,RB
2483,Korey Hall,0,1,1,2010,27,GNB,12,6,0,0,,0,0,0,,1,1,9,9,0,0.8,100,9,0,0,1,0,9,9,0,FB
2484,Jerome Harrison,71,12,83,2010,27,"CLE,PHI",12,2,71,330,4.6,1,27.5,12,35.2,13,12,85,7.1,0,7.1,92.3,6.5,2,46.2,83,330,415,447,32,RB
2485,Mike Hart,43,6,49,2010,24,IND,7,1,43,185,4.3,1,26.4,10,46.5,6,6,25,4.2,0,3.6,100,4.2,2,50,49,185,210,210,0,RB
2486,Madison Hedgecock,0,2,2,2010,29,NYG,4,3,0,0,,0,0,0,,2,2,8,4,0,2,100,4,1,50,2,0,8,8,0,FB
2487,Chris Henry,0,0,0,2010,25,SEA,1,0,0,0,,0,0,0,,0,0,0,,0,0,,,0,,0,0,0,0,0,RB
2488,Jacob Hester,26,22,48,2010,25,SDG,15,7,26,60,2.3,0,4,10,46.2,26,22,145,6.6,1,9.7,84.6,5.6,9,57.7,48,60,205,230,25,RB
2489,Tim Hightower,153,21,174,2010,24,ARI,16,13,153,736,4.8,5,46,32,40.5,42,21,136,6.5,0,8.5,50,3.2,7,21.4,174,736,872,872,0,RB
2490,Lex Hilliard,0,1,1,2010,26,MIA,16,0,0,0,,0,0,0,,2,1,3,3,0,0.2,50,1.5,0,0,1,0,3,3,0,RB
2491,Peyton Hillis,270,61,331,2010,24,CLE,16,14,270,1177,4.4,11,73.6,58,51.5,77,61,477,7.8,2,29.8,79.2,6.2,25,42.9,331,1190,1654,1654,0,RB
2492,Kareem Huggins,4,1,5,2010,24,TAM,3,0,4,11,2.8,0,3.7,0,50,2,1,7,7,0,2.3,50,3.5,1,50,5,11,18,18,0,RB
2493,Chris Ivory,137,1,138,2010,22,NOR,12,4,137,716,5.2,5,59.7,44,58.4,1,1,17,17,0,1.4,100,17,1,100,138,716,733,733,0,RB
2494,Brandon Jackson,190,43,233,2010,25,GNB,16,13,190,703,3.7,3,43.9,30,42.1,50,43,342,8,1,21.4,86,6.8,18,58,233,703,1045,1045,0,RB
2495,Fred Jackson,222,31,253,2010,29,BUF,16,13,222,927,4.2,5,57.9,40,46.8,54,31,215,6.9,2,13.4,57.4,4,9,25.9,253,927,1142,1142,0,RB
2496,Rashawn Jackson,0,0,0,2010,23,CAR,2,1,0,0,,0,0,0,,0,0,0,,0,0,,,0,,0,0,0,0,0,RB
2497,Steven Jackson,330,46,376,2010,27,STL,16,16,330,1241,3.8,6,77.6,60,39.7,62,46,383,8.3,0,23.9,74.2,6.2,14,41.9,376,1241,1624,1624,0,RB
2498,Brandon Jacobs,147,7,154,2010,28,NYG,16,5,147,823,5.6,9,51.4,38,51.7,13,7,59,8.4,0,3.7,53.8,4.5,2,38.5,154,823,882,882,0,RB
2499,Javarris James,46,9,55,2010,23,IND,10,0,46,112,2.4,6,11.2,9,43.5,11,9,63,7,0,6.3,81.8,5.7,3,45.5,55,112,175,191,16,RB
2500,Rashad Jennings,84,26,110,2010,25,JAX,13,3,84,459,5.5,4,35.3,24,53.6,35,26,223,8.6,0,17.2,74.3,6.4,8,37.1,110,459,682,682,0,RB
2501,Chris Johnson,316,44,360,2010,25,TEN,16,16,316,1364,4.3,11,85.3,57,37.3,57,44,245,5.6,1,15.3,77.2,4.3,9,29.8,360,1364,1609,1609,0,RB
2502,Gartrell Johnson,10,3,13,2010,24,ATL,9,0,10,36,3.6,0,4,2,20,5,3,6,2,0,0.7,60,1.2,1,0,13,36,42,42,0,RB
2503,Jerome Johnson,0,0,0,2010,25,ARI,1,0,0,0,,0,0,0,,1,0,0,,0,0,0,0,0,0,0,0,0,0,0,RB
2504,Larry Johnson,5,0,5,2010,31,WAS,2,0,5,2,0.4,0,1,0,0,0,0,0,,0,0,,,0,,5,2,2,2,0,RB
2505,Marquis Johnson,0,0,0,2010,22,STL,2,0,0,0,,0,0,0,,0,0,0,,0,0,,,0,,0,0,0,0,0,FB
2506,Quinn Johnson,0,3,3,2010,24,GNB,11,4,0,0,,0,0,0,,4,3,26,8.7,0,2.4,75,6.5,2,50,3,0,26,26,0,RB
2507,Felix Jones,185,48,233,2010,23,DAL,16,7,185,800,4.3,1,50,41,49.2,52,48,450,9.4,1,28.1,92.3,8.7,11,50,233,800,1250,1250,0,RB
2508,Greg Jones,2,11,13,2010,29,JAX,16,13,2,4,2,0,0.3,0,0,11,11,47,4.3,0,2.9,100,4.3,2,45.5,13,4,51,51,0,FB
2509,Julius Jones,60,17,77,2010,29,"NOR,SEA",12,2,60,223,3.7,0,18.6,9,31.7,22,17,59,3.5,0,4.9,77.3,2.7,3,31.8,77,223,282,282,0,RB
2510,Thomas Jones,245,14,259,2010,32,KAN,16,10,245,896,3.7,6,56,39,41.6,20,14,122,8.7,0,7.6,70,6.1,8,50,259,896,1018,1018,0,RB
2511,Deji Karim,35,3,38,2010,24,JAX,11,0,35,160,4.6,0,14.5,8,48.6,7,3,10,3.3,0,0.9,42.9,1.4,1,14.3,38,160,170,1418,1248,RB
2512,Mike Karney,6,5,11,2010,29,STL,12,5,6,12,2,0,1,3,66.7,5,5,14,2.8,0,1.2,100,2.8,1,40,11,12,26,43,17,FB
2513,Jim Kleinsasser,0,17,17,2010,33,MIN,16,7,0,0,,0,0,0,,21,17,148,8.7,0,9.3,81,7,6,57.1,17,0,148,148,0,FB
2514,John Kuhn,84,15,99,2010,28,GNB,16,2,84,281,3.3,4,17.6,26,58.3,18,15,97,6.5,2,6.1,83.3,5.4,6,55.6,99,281,378,386,8,FB
2515,Spencer Larsen,3,5,8,2010,26,DEN,11,5,3,18,6,0,1.6,3,100,5,5,51,10.2,1,4.6,100,10.2,3,80,8,18,69,113,44,FB
2516,Billy Latsko,0,0,0,2010,26,SDG,1,0,0,0,,0,0,0,,0,0,0,,0,0,,,0,,0,0,0,0,0,RB
2517,Vonta Leach,0,8,8,2010,29,HOU,16,5,0,0,,0,0,0,,15,8,91,11.4,0,5.7,53.3,6.1,3,46.7,8,0,91,131,40,FB
2518,Brian Leonard,9,20,29,2010,26,CIN,11,0,9,61,6.8,0,5.5,4,55.6,26,20,137,6.9,1,12.5,76.9,5.3,9,50,29,61,198,198,0,RB
2519,Stefan Logan,15,0,15,2010,29,DET,16,0,15,95,6.3,0,5.9,5,53.3,1,0,0,,0,0,0,0,0,0,15,95,95,1909,1810,RB
2520,Kregg Lumpkin,1,1,2,2010,26,TAM,11,0,1,0,0,0,0,0,0,1,1,12,12,0,1.1,100,12,1,100,2,0,12,12,0,RB
2521,Marshawn Lynch,202,22,224,2010,24,"BUF,SEA",16,14,202,737,3.6,6,46.1,38,44.1,26,22,145,6.6,0,9.1,84.6,5.6,5,65.4,224,737,882,882,0,RB
2522,Laurence Maroney,36,4,40,2010,25,DEN,4,3,36,74,2.1,0,18.5,1,27.8,7,4,50,12.5,0,12.5,57.1,7.1,2,42.9,40,74,124,124,0,RB
2523,Chris Massey,0,0,0,2010,31,STL,16,0,0,0,,0,0,0,,0,0,0,,0,0,,,0,,0,0,0,0,0,RB
2524,Ryan Mathews,158,22,180,2010,23,SDG,12,9,158,678,4.3,7,56.5,25,44.3,26,22,145,6.6,0,12.1,84.6,5.6,7,50,180,678,823,823,0,RB
2525,Reagan Maui'a,0,2,2,2010,26,ARI,15,4,0,0,,0,0,0,,6,2,20,10,0,1.3,33.3,3.3,1,16.7,2,0,20,20,0,RB
2526,Le'Ron McClain,28,21,49,2010,26,BAL,15,13,28,85,3,0,5.7,15,71.4,26,21,134,6.4,0,8.9,80.8,5.2,6,50,49,85,219,219,0,FB
2527,LeSean McCoy,207,78,285,2010,22,PHI,15,13,207,1080,5.2,7,72,46,46.4,91,78,592,7.6,2,39.5,85.7,6.5,29,59.3,285,1080,1672,1672,0,RB
2528,Darren McFadden,223,47,270,2010,23,OAK,13,13,223,1157,5.2,7,89,46,41.7,61,47,507,10.8,3,39,77,8.3,22,47.5,270,1157,1664,1657,0,RB
2529,Willis McGahee,100,14,114,2010,29,BAL,15,2,100,380,3.8,5,25.3,18,46,17,14,55,3.9,1,3.7,82.4,3.2,2,29.4,114,380,435,435,0,RB
2530,Corey McIntyre,4,4,8,2010,31,BUF,16,7,4,5,1.3,1,0.3,3,75,8,4,32,8,0,2,50,4,1,37.5,8,5,37,37,0,FB
2531,Joe McKnight,39,3,42,2010,22,NYJ,9,1,39,189,4.8,0,21,7,59,4,3,20,6.7,0,2.2,75,5,2,50,42,189,209,312,103,RB
2532,Rashard Mendenhall,324,23,347,2010,23,PIT,16,16,324,1273,3.9,13,79.6,61,40.4,34,23,167,7.3,0,10.4,67.6,4.9,6,47.1,347,1273,1440,1440,0,RB
2533,Garrett Mills,0,2,2,2010,27,PHI,7,3,0,0,,0,0,0,,3,2,19,9.5,0,2.7,66.7,6.3,1,33.3,2,0,19,19,0,FB
2534,Lonyae Miller,0,0,0,2010,22,DAL,4,0,0,0,,0,0,0,,0,0,0,,0,0,,,0,,0,0,0,0,0,RB
2535,Devin Moore,2,0,2,2010,25,IND,4,0,2,-2,-1,0,-0.5,0,0,0,0,0,,0,0,,,0,,2,-2,-2,255,257,RB
2536,Mewelde Moore,33,26,59,2010,28,PIT,15,0,33,99,3,0,6.6,4,21.2,31,26,205,7.9,0,13.7,83.9,6.6,10,48.4,59,99,304,351,47,RB
2537,Knowshon Moreno,182,37,219,2010,23,DEN,13,13,182,779,4.3,5,59.9,35,43.4,48,37,372,10.1,3,28.6,77.1,7.8,15,50,219,779,1151,1151,0,RB
2538,Maurice Morris,90,25,115,2010,31,DET,14,7,90,336,3.7,5,24,17,45.6,31,25,170,6.8,0,12.1,80.6,5.5,7,51.6,115,336,506,506,0,RB
2539,Sammy Morris,20,7,27,2010,33,NWE,16,0,20,56,2.8,0,3.5,6,50,12,7,77,11,0,4.8,58.3,6.4,4,41.7,27,56,133,199,66,RB
2540,Ovie Mughelli,13,13,26,2010,30,ATL,16,6,13,36,2.8,0,2.3,8,69.2,18,13,126,9.7,1,7.9,72.2,7,5,33.3,26,36,162,168,6,FB
2541,Dimitri Nance,36,3,39,2010,22,GNB,12,0,36,95,2.6,0,7.9,4,41.7,4,3,30,10,0,2.5,75,7.5,2,75,39,95,125,125,0,RB
2542,Moran Norris,3,4,7,2010,32,SFO,16,11,3,0,0,0,0,1,0,9,4,20,5,0,1.3,44.4,2.2,1,44.4,7,0,20,32,12,FB
2543,Jerious Norwood,2,1,3,2010,27,ATL,2,0,2,8,4,0,4,1,100,3,1,9,9,0,4.5,33.3,3,0,33.3,3,8,17,114,97,RB
2544,Montell Owens,0,0,0,2010,26,JAX,16,0,0,0,,0,0,0,,0,0,0,,0,0,,,0,,0,0,0,22,22,RB
2545,Jalen Parmele,0,0,0,2010,25,BAL,16,0,0,0,,0,0,0,,0,0,0,,0,0,,,0,,0,0,0,562,562,RB
2546,Cedric Peerman,2,1,3,2010,24,CIN,7,0,2,1,0.5,0,0.1,0,0,3,1,11,11,0,1.6,33.3,3.7,1,33.3,3,1,12,12,0,RB
2547,Adrian Peterson,283,36,319,2010,25,MIN,15,15,283,1298,4.6,12,86.5,71,45.6,50,36,341,9.5,1,22.7,72,6.8,17,48,319,1298,1639,1639,0,RB
2548,Lousaka Polite,26,12,38,2010,29,MIA,16,10,26,62,2.4,1,3.9,15,65.4,17,12,61,5.1,0,3.8,70.6,3.6,3,29.4,38,62,123,133,10,FB
2549,Clinton Portis,54,5,59,2010,29,WAS,5,5,54,227,4.2,2,45.4,12,48.1,9,5,55,11,0,11,55.6,6.1,4,44.4,59,227,282,282,0,RB
2550,Chris Pressley,1,1,2,2010,24,"CIN,TAM",7,0,1,0,0,0,0,0,0,1,1,6,6,0,0.9,100,6,0,0,2,0,6,6,0,RB
2551,Isaac Redman,52,9,61,2010,26,PIT,16,0,52,247,4.8,0,15.4,22,53.8,10,9,72,8,2,4.5,90,7.2,3,50,61,247,319,400,81,RB
2552,Marcel Reece,30,25,55,2010,25,OAK,16,10,30,122,4.1,1,7.6,9,50,43,25,333,13.3,3,20.8,58.1,7.7,12,37.2,55,122,455,462,7,FB
2553,Dominic Rhodes,37,1,38,2010,31,IND,3,0,37,172,4.6,0,57.3,8,43.2,4,1,4,4,0,1.3,25,1,0,0,38,172,176,428,252,RB
2554,Ray Rice,307,63,370,2010,23,BAL,16,14,307,1220,4,5,76.3,53,43.3,83,63,556,8.8,1,34.8,75.9,6.7,23,42.2,370,1220,1776,1776,0,RB
2555,Tony Richardson,5,5,10,2010,39,NYJ,16,10,5,13,2.6,0,0.8,3,80,5,5,31,6.2,0,1.9,100,6.2,1,40,10,13,44,44,0,FB
2556,Javon Ringer,51,7,58,2010,23,TEN,16,0,51,239,4.7,2,14.9,11,35.3,8,7,44,6.3,0,2.8,87.5,5.5,2,75,58,239,283,283,0,RB
2557,Michael Robinson,12,8,20,2010,27,SEA,11,4,12,77,6.4,0,7,9,83.3,13,8,37,4.6,0,3.4,61.5,2.8,0,30.8,20,105,114,114,0,FB
2558,Owen Schmitt,0,19,19,2010,25,PHI,15,5,0,0,,0,0,0,,24,19,136,7.2,1,9.1,79.2,5.7,8,50,19,0,136,154,18,FB
2559,Bernard Scott,61,11,72,2010,26,CIN,16,0,61,299,4.9,1,18.7,16,54.1,13,11,60,5.5,0,3.8,84.6,4.6,3,53.8,72,299,359,1616,1257,RB
2560,Mike Sellers,4,20,24,2010,35,WAS,16,8,4,2,0.5,0,0.1,1,25,40,20,224,11.2,0,14,50,5.6,9,40,24,2,226,308,82,FB
2561,Chad Simpson,0,0,0,2010,25,WAS,3,0,0,0,,0,0,0,,0,0,0,,0,0,,,0,,0,0,0,59,59,RB
2562,Steve Slaton,19,3,22,2010,24,HOU,12,1,19,93,4.9,0,7.8,4,47.4,4,3,11,3.7,0,0.9,75,2.8,1,25,22,93,104,871,767,RB
2563,Alfonso Smith,0,0,0,2010,23,ARI,1,0,0,0,,0,0,0,,0,0,0,,0,0,,,0,,0,0,0,0,0,RB
2564,Antone Smith,1,0,1,2010,25,ATL,9,0,1,-3,-3,0,-0.3,0,0,1,0,0,,0,0,0,0,0,0,1,-3,-3,-3,0,RB
2565,Clifton Smith,0,0,0,2010,25,"CLE,MIA",4,0,0,0,,0,0,0,,0,0,0,,0,0,,,0,,0,0,0,153,153,RB
2566,Kevin Smith,34,11,45,2010,24,DET,6,0,34,133,3.9,0,22.2,4,29.4,16,11,123,11.2,0,20.5,68.8,7.7,7,62.5,45,133,256,256,0,RB
2567,Jason Snelling,87,44,131,2010,27,ATL,14,0,87,324,3.7,2,23.1,20,42.5,51,44,303,6.9,3,21.6,86.3,5.9,13,39.2,131,324,627,627,0,RB
2568,C.J. Spiller,74,24,98,2010,23,BUF,14,1,74,283,3.8,0,20.2,10,41.9,30,24,157,6.5,1,11.2,80,5.2,7,43.3,98,283,440,1629,1189,RB
2569,Darren Sproles,50,59,109,2010,27,SDG,16,3,50,267,5.3,0,16.7,10,34,75,59,520,8.8,2,32.5,78.7,6.9,25,46.7,109,267,787,2210,1423,RB
2570,James Starks,29,2,31,2010,24,GNB,3,0,29,101,3.5,0,33.7,5,44.8,4,2,15,7.5,0,5,50,3.8,1,25,31,101,116,141,25,RB
2571,LaRod Stephens-Howling,23,16,39,2010,23,ARI,13,2,23,113,4.9,1,8.7,5,47.8,23,16,111,6.9,0,8.5,69.6,4.8,9,52.2,39,113,224,1772,1548,RB
2572,Jonathan Stewart,178,8,186,2010,23,CAR,14,7,178,770,4.3,2,55,32,36,14,8,103,12.9,1,7.4,57.1,7.4,2,35.7,186,770,873,873,0,RB
2573,Tyrell Sutton,13,12,25,2010,24,CAR,9,0,13,71,5.5,0,7.9,3,38.5,12,12,70,5.8,0,7.8,100,5.8,2,50,25,71,141,171,30,RB
2574,Naufahu Tahi,1,6,7,2010,29,MIN,15,7,1,1,1,0,0.1,1,100,6,6,39,6.5,1,2.6,100,6.5,3,83.3,7,1,40,40,0,FB
2575,Chester Taylor,112,20,132,2010,31,CHI,16,1,112,267,2.4,3,16.7,16,36.6,26,20,139,7,0,8.7,76.9,5.3,7,50,132,267,406,406,0,RB
2576,Fred Taylor,43,2,45,2010,34,NWE,7,0,43,155,3.6,0,22.1,9,39.5,3,2,6,3,0,0.9,66.7,2,0,33.3,45,155,161,161,0,RB
2577,Pierre Thomas,83,29,112,2010,26,NOR,6,3,83,269,3.2,2,44.8,19,49.4,29,29,201,6.9,0,33.5,100,6.9,10,58.6,112,269,470,624,154,RB
2578,Mike Tolbert,182,25,207,2010,25,SDG,15,4,182,735,4,11,49,43,49.5,29,25,216,8.6,0,14.4,86.2,7.4,8,62.1,207,735,951,951,0,RB
2579,LaDainian Tomlinson,219,52,271,2010,31,NYJ,15,13,219,914,4.2,6,60.9,43,43.4,79,52,368,7.1,0,24.5,65.8,4.7,19,45.6,271,914,1282,1282,0,RB
2580,Ryan Torain,164,18,182,2010,24,WAS,10,8,164,742,4.5,4,74.2,35,42.1,27,18,125,6.9,2,12.5,66.7,4.6,6,40.7,182,742,867,867,0,RB
2581,Keith Toston,19,2,21,2010,23,STL,16,0,19,54,2.8,0,3.4,2,31.6,2,2,29,14.5,0,1.8,100,14.5,1,100,21,54,83,158,75,RB
2582,Michael Turner,334,12,346,2010,28,ATL,16,15,334,1371,4.1,12,85.7,75,44,20,12,85,7.1,0,5.3,60,4.3,2,45,346,1371,1456,1456,0,RB
2583,Josh Vaughan,3,0,3,2010,24,CAR,3,0,3,7,2.3,1,2.3,1,66.7,0,0,0,,0,0,,,0,,3,7,7,7,0,RB
2584,Lawrence Vickers,5,4,9,2010,27,CLE,16,4,5,11,2.2,0,0.7,2,40,9,4,15,3.8,0,0.9,44.4,1.7,1,22.2,9,11,26,39,13,FB
2585,Derrick Ward,50,7,57,2010,30,HOU,16,0,50,315,6.3,4,19.7,17,58,11,7,61,8.7,0,3.8,63.6,5.5,2,36.4,57,315,376,376,0,RB
2586,Danny Ware,20,7,27,2010,25,NYG,14,0,20,73,3.7,0,5.2,7,65,9,7,67,9.6,0,4.8,77.8,7.4,2,44.4,27,73,140,572,432,RB
2587,Jeremy Ware,0,0,0,2010,24,OAK,8,0,0,0,,0,0,0,,0,0,0,,0,0,,,0,,0,0,0,0,0,FB
2588,Chauncey Washington,0,0,0,2010,25,STL,1,0,0,0,,0,0,0,,0,0,0,,0,0,,,0,,0,0,0,0,0,RB
2589,Leon Washington,27,9,36,2010,28,SEA,16,0,27,100,3.7,1,6.3,5,44.4,13,9,79,8.8,0,4.9,69.2,6.1,3,46.2,36,93,179,1889,1710,RB
2590,Leonard Weaver,1,0,1,2010,28,PHI,1,0,1,0,0,0,0,0,0,0,0,0,,0,0,,,0,,1,0,0,0,0,RB
2591,Beanie Wells,116,5,121,2010,22,ARI,13,2,116,397,3.4,2,30.5,18,43.1,8,5,74,14.8,0,5.7,62.5,9.3,3,62.5,121,397,471,471,0,RB
2592,Brian Westbrook,77,16,93,2010,31,SFO,14,5,77,340,4.4,4,24.3,16,44.2,24,16,150,9.4,1,10.7,66.7,6.3,5,33.3,93,340,490,490,0,RB
2593,Cadillac Williams,125,46,171,2010,28,TAM,16,9,125,437,3.5,2,27.3,19,34.4,64,46,355,7.7,1,22.2,71.9,5.5,19,39.1,171,437,792,792,0,RB
2594,DeAngelo Williams,87,11,98,2010,27,CAR,6,6,87,361,4.1,1,60.2,12,31,13,11,61,5.5,0,10.2,84.6,4.7,4,46.2,98,361,422,422,0,RB
2595,Keiland Williams,65,39,104,2010,24,WAS,15,3,65,261,4,3,17.4,14,52.3,58,39,309,7.9,2,20.6,67.2,5.3,11,34.5,104,261,570,570,0,RB
2596,Ricky Williams,159,19,178,2010,33,MIA,16,0,159,673,4.2,2,42.1,26,49.1,30,19,141,7.4,1,8.8,63.3,4.7,5,40,178,673,814,814,0,RB
2597,Garrett Wolfe,4,0,4,2010,26,CHI,16,0,4,8,2,0,0.5,0,0,0,0,0,,0,0,,,0,,4,8,8,8,0,RB
2598,Danny Woodhead,97,34,131,2010,25,"NWE,NYJ",15,3,97,547,5.6,5,36.5,24,53.6,44,34,379,11.1,1,25.3,77.3,8.6,15,47.7,131,547,926,926,0,RB
2599,Jason Wright,6,8,14,2010,28,ARI,15,1,6,28,4.7,0,1.9,3,50,16,8,42,5.3,0,2.8,50,2.6,1,31.3,14,28,70,78,8,RB
2600,DeShawn Wynn,0,0,0,2010,27,"NOR,SFO",7,0,0,0,,0,0,0,,0,0,0,,0,0,,,0,,0,0,0,0,0,RB
2601,Albert Young,13,2,15,2010,25,MIN,3,0,13,29,2.2,0,9.7,1,30.8,2,2,11,5.5,0,3.7,100,5.5,0,0,15,29,40,65,25,RB
2602,Joseph Addai,219,51,270,2009,26,IND,15,15,219,828,3.8,10,55.2,44,50.7,63,51,336,6.6,3,22.4,81,5.3,18,46,270,850,1164,1164,0,RB
2603,Deon Anderson,0,1,1,2009,26,DAL,16,9,0,0,,0,0,0,,3,1,5,5,0,0.3,33.3,1.7,0,0,1,0,5,20,15,FB
2604,B.J. Askew,1,2,3,2009,29,TAM,5,2,1,0,0,0,0,0,0,2,2,3,1.5,0,0.6,100,1.5,0,0,3,0,3,3,0,FB
2605,Marion Barber III,214,26,240,2009,26,DAL,15,15,214,932,4.4,7,62.1,60,50,36,26,221,8.5,0,14.7,72.2,6.1,10,47.2,240,932,1153,1153,0,RB
2606,Jackie Battle,7,2,9,2009,26,KAN,5,0,7,21,3,0,4.2,3,42.9,2,2,-3,-1.5,0,-0.6,100,-1.5,0,0,9,21,18,18,0,RB
2607,Kahlil Bell,40,1,41,2009,23,CHI,7,0,40,220,5.5,0,31.4,9,52.5,3,1,4,4,0,0.6,33.3,1.3,0,0,41,220,224,224,0,RB
2608,Mike Bell,172,4,176,2009,26,NOR,13,3,172,654,3.8,5,50.3,34,49.4,4,4,12,3,0,0.9,100,3,1,25,176,654,666,711,45,RB
2609,Michael Bennett,23,6,29,2009,31,SDG,6,0,23,65,2.8,0,10.8,3,30.4,7,6,65,10.8,0,10.8,85.7,9.3,2,57.1,29,65,130,130,0,RB
2610,Cedric Benson,301,17,318,2009,27,CIN,13,13,301,1251,4.2,6,96.2,57,41.9,24,17,111,6.5,0,8.5,70.8,4.6,5,58.3,318,1251,1362,1362,0,RB
2611,Ladell Betts,56,17,73,2009,30,WAS,10,2,56,210,3.8,2,21,7,39.3,21,17,179,10.5,0,17.9,81,8.5,9,57.1,73,210,389,418,29,RB
2612,Brock Bolen,0,0,0,2009,24,JAX,3,0,0,0,,0,0,0,,3,0,0,,0,0,0,0,0,0,0,0,0,0,0,RB
2613,Ahmad Bradshaw,163,21,184,2009,23,NYG,15,1,163,778,4.8,7,51.9,47,51.5,30,21,207,9.9,0,13.8,70,6.9,6,36.7,184,778,985,1039,55,RB
2614,Aaron Brown,27,9,36,2009,24,DET,15,2,27,131,4.9,0,8.7,7,48.1,15,9,84,9.3,1,5.6,60,5.6,5,40,36,131,215,1166,951,RB
2615,Chris Brown,79,16,95,2009,28,HOU,14,4,79,267,3.4,3,19.1,15,41.8,21,16,74,4.6,0,5.3,76.2,3.5,1,38.1,95,267,341,341,0,RB
2616,Donald Brown,78,11,89,2009,22,IND,11,1,78,281,3.6,3,25.5,15,43.6,14,11,169,15.4,0,15.4,78.6,12.1,7,64.3,89,281,450,471,21,RB
2617,Ronnie Brown,147,14,161,2009,28,MIA,9,9,147,648,4.4,8,72,32,50.3,20,14,98,7,0,10.9,70,4.9,5,50,161,661,746,746,0,RB
2618,Correll Buckhalter,120,31,151,2009,31,DEN,14,7,120,642,5.4,1,45.9,30,54.2,38,31,240,7.7,0,17.1,81.6,6.3,6,44.7,151,642,882,1066,184,RB
2619,Eldra Buckley,15,0,15,2009,24,PHI,16,0,15,44,2.9,1,2.8,4,53.3,0,0,0,,0,0,,,0,,15,44,44,44,0,RB
2620,Michael Bush,123,17,140,2009,25,OAK,16,7,123,589,4.8,3,36.8,22,45.5,19,17,105,6.2,0,6.6,89.5,5.5,3,57.9,140,589,694,694,0,RB
2621,Reggie Bush,70,47,117,2009,24,NOR,14,8,70,390,5.6,5,27.9,19,42.9,68,47,335,7.1,3,23.9,69.1,4.9,16,48.5,117,390,725,855,130,RB
2622,Rock Cartwright,64,27,91,2009,30,WAS,16,2,64,228,3.6,0,14.3,12,39.1,32,27,242,9,1,15.1,84.4,7.6,10,50,91,228,470,1338,868,FB
2623,Tim Castille,14,4,18,2009,25,KAN,7,0,14,55,3.9,0,7.9,3,35.7,6,4,37,9.3,1,5.3,66.7,6.2,1,33.3,18,55,92,92,0,RB
2624,Jamaal Charles,190,40,230,2009,23,KAN,15,10,190,1120,5.9,7,74.7,54,54.2,55,40,297,7.4,1,19.8,72.7,5.4,11,36.4,230,1120,1417,2342,925,RB
2625,Tashard Choice,64,15,79,2009,25,DAL,16,0,64,349,5.5,3,21.8,19,53.1,22,15,132,8.8,0,8.3,68.2,6,6,40.9,79,349,481,481,0,RB
2626,Patrick Cobbs,6,3,9,2009,26,MIA,5,0,6,36,6,0,7.2,2,66.7,4,3,23,7.7,0,4.6,75,5.8,1,75,9,36,59,420,361,RB
2627,Glen Coffee,83,11,94,2009,22,SFO,14,2,83,226,2.7,1,16.1,8,27.7,18,11,76,6.9,0,5.4,61.1,4.2,1,16.7,94,226,302,344,42,RB
2628,Mike Cox,3,10,13,2009,24,KAN,16,10,3,5,1.7,1,0.3,2,66.7,13,10,79,7.9,0,4.9,76.9,6.1,3,46.2,13,5,84,93,9,FB
2629,Kenneth Darby,27,18,45,2009,27,STL,16,1,27,152,5.6,0,9.5,5,40.7,24,18,96,5.3,0,6,75,4,6,29.2,45,152,248,302,54,RB
2630,Carey Davis,2,0,2,2009,28,PIT,6,0,2,15,7.5,0,2.5,1,50,0,0,0,,0,0,,,0,,2,15,15,28,13,RB
2631,James Davis,9,4,13,2009,23,CLE,2,0,9,15,1.7,0,7.5,0,0,5,4,5,1.3,0,2.5,80,1,0,0,13,15,20,20,0,RB
2632,Maurice Jones-Drew,312,53,365,2009,24,JAX,16,16,312,1391,4.5,15,86.9,69,48.1,71,53,374,7.1,1,23.4,74.6,5.3,16,46.5,365,1391,1765,1886,121,RB
2633,Kyle Eckel,2,2,4,2009,28,NOR,7,2,2,6,3,0,0.9,1,50,3,2,14,7,0,2,66.7,4.7,1,33.3,4,6,20,20,0,RB
2634,Heath Evans,5,10,15,2009,31,NOR,6,5,5,16,3.2,1,2.7,1,40,13,10,70,7,2,11.7,76.9,5.4,5,61.5,15,16,86,86,0,FB
2635,Justin Fargas,129,17,146,2009,29,OAK,12,4,129,491,3.8,3,40.9,25,38,21,17,113,6.6,0,9.4,81,5.4,5,42.9,146,491,604,604,0,FB
2636,Kevin Faulk,62,37,99,2009,33,NWE,15,7,62,335,5.4,2,22.3,18,54.8,53,37,301,8.1,1,20.1,69.8,5.7,13,45.3,99,335,636,811,175,RB
2637,Jerome Felton,15,13,28,2009,23,DET,13,8,15,46,3.1,0,3.5,7,66.7,17,13,133,10.2,0,10.2,76.5,7.8,5,47.1,28,46,179,179,0,FB
2638,Tony Fiammetta,0,0,0,2009,23,CAR,10,2,0,0,,0,0,0,,3,0,0,,0,0,0,0,0,0,0,0,0,0,0,RB
2639,Justin Forsett,114,41,155,2009,24,SEA,16,2,114,619,5.4,4,38.7,29,44.7,57,41,350,8.5,1,21.9,71.9,6.1,13,38.6,155,619,969,1493,524,RB
2640,Matt Forte,258,57,315,2009,24,CHI,16,16,258,929,3.6,4,58.1,41,41.1,72,57,471,8.3,0,29.4,79.2,6.5,17,37.5,315,929,1400,1400,0,RB
2641,Arian Foster,54,8,62,2009,23,HOU,6,1,54,257,4.8,3,42.8,15,53.7,9,8,93,11.6,0,15.5,88.9,10.3,4,88.9,62,257,350,350,0,RB
2642,Samkon Gado,14,3,17,2009,27,STL,15,0,14,26,1.9,0,1.7,4,35.7,3,3,25,8.3,0,1.7,100,8.3,0,66.7,17,26,51,74,23,RB
2643,Quinton Ganther,62,9,71,2009,25,WAS,8,4,62,201,3.2,3,25.1,12,48.4,10,9,99,11,0,12.4,90,9.9,4,60,71,201,300,325,25,RB
2644,Mike Goodson,22,2,24,2009,22,CAR,8,0,22,49,2.2,0,6.1,1,27.3,2,2,15,7.5,0,1.9,100,7.5,1,50,24,49,64,416,352,RB
2645,Frank Gore,229,52,281,2009,26,SFO,14,14,229,1120,4.9,10,80,47,39.3,75,52,406,7.8,3,29,69.3,5.4,14,45.3,281,1120,1526,1526,0,RB
2646,Earnest Graham,14,14,28,2009,29,TAM,13,6,14,66,4.7,0,5.1,5,50,22,14,109,7.8,0,8.4,63.6,5,3,50,28,66,175,213,38,RB
2647,Ryan Grant,282,25,307,2009,27,GNB,16,16,282,1253,4.4,11,78.3,64,46.5,30,25,197,7.9,0,12.3,83.3,6.6,9,56.7,307,1253,1450,1450,0,RB
2648,Ahman Green,41,3,44,2009,32,GNB,8,0,41,160,3.9,1,20,8,39,5,3,18,6,0,2.3,60,3.6,2,40,44,160,178,374,196,RB
2649,BenJarvus Green-Ellis,26,2,28,2009,24,NWE,12,0,26,114,4.4,0,9.5,6,57.7,5,2,11,5.5,0,0.9,40,2.2,0,20,28,114,125,125,0,RB
2650,Shonn Greene,108,0,108,2009,24,NYJ,14,0,108,540,5,2,38.6,24,45.4,5,0,0,,0,0,0,0,0,0,108,540,540,540,0,RB
2651,Justin Griffith,4,19,23,2009,29,SEA,13,11,4,6,1.5,0,0.5,2,50,26,19,118,6.2,1,9.1,73.1,4.5,4,42.3,23,6,124,124,0,FB
2652,Ahmard Hall,1,12,13,2009,30,TEN,16,7,1,5,5,0,0.3,0,100,16,12,79,6.6,0,4.9,75,4.9,3,50,13,5,84,96,12,FB
2653,Korey Hall,0,5,5,2009,26,GNB,11,5,0,0,,0,0,0,,7,5,41,8.2,0,3.7,71.4,5.9,2,71.4,5,0,41,41,0,FB
2654,Lynell Hamilton,35,5,40,2009,24,NOR,9,1,35,125,3.6,2,13.9,12,54.3,7,5,48,9.6,0,5.3,71.4,6.9,4,57.1,40,125,173,188,15,RB
2655,Jerome Harrison,194,34,228,2009,26,CLE,14,7,194,862,4.4,5,61.6,39,46.4,50,34,220,6.5,2,15.7,68,4.4,12,36,228,862,1082,1137,55,RB
2656,Mike Hart,26,5,31,2009,23,IND,9,0,26,70,2.7,1,7.8,4,50,8,5,54,10.8,0,6,62.5,6.8,3,50,31,70,124,124,0,RB
2657,Verron Haynes,0,3,3,2009,30,ATL,7,2,0,0,,0,0,0,,4,3,20,6.7,0,2.9,75,5,1,50,3,0,20,20,0,RB
2658,Madison Hedgecock,0,4,4,2009,28,NYG,16,9,0,0,,0,0,0,,9,4,23,5.8,1,1.4,44.4,2.6,1,44.4,4,0,23,31,8,FB
2659,Chris Henry,0,0,0,2009,24,TEN,2,0,0,0,,0,0,0,,0,0,0,,0,0,,,0,,0,0,0,0,0,RB
2660,Jacob Hester,21,9,30,2009,24,SDG,15,10,21,74,3.5,0,4.9,6,38.1,11,9,24,2.7,0,1.6,81.8,2.2,0,9.1,30,74,98,148,9,FB
2661,Tim Hightower,143,63,206,2009,23,ARI,16,16,143,598,4.2,8,37.4,33,39.9,80,63,428,6.8,0,26.8,78.8,5.4,22,45,206,598,1026,1020,0,RB
2662,Lex Hilliard,23,20,43,2009,25,MIA,16,0,23,89,3.9,1,5.6,5,34.8,20,20,158,7.9,2,9.9,100,7.9,6,60,43,89,247,247,0,RB
2663,Peyton Hillis,13,4,17,2009,23,DEN,14,2,13,54,4.2,1,3.9,4,53.8,6,4,19,4.8,0,1.4,66.7,3.2,0,33.3,17,54,73,207,134,RB
2664,Brad Hoover,20,4,24,2009,33,CAR,11,4,20,52,2.6,1,4.7,6,35,9,4,23,5.8,1,2.1,44.4,2.6,3,33.3,24,52,75,75,0,FB
2665,Kareem Huggins,0,0,0,2009,23,TAM,3,0,0,0,,0,0,0,,0,0,0,,0,0,,,0,,0,0,0,52,52,RB
2666,Brandon Jackson,37,21,58,2009,24,GNB,12,0,37,111,3,2,9.3,5,32.4,26,21,187,8.9,1,15.6,80.8,7.2,11,53.8,58,111,298,334,36,RB
2667,Fred Jackson,237,46,283,2009,28,BUF,16,11,237,1062,4.5,2,66.4,44,46.4,61,46,371,8.1,2,23.2,75.4,6.1,22,42.6,283,1089,1433,2516,1083,RB
2668,Steven Jackson,324,51,375,2009,26,STL,15,15,324,1416,4.4,4,94.4,59,45.4,75,51,322,6.3,0,21.5,68,4.3,16,34.7,375,1416,1738,1736,0,RB
2669,Brandon Jacobs,224,18,242,2009,27,NYG,15,15,224,835,3.7,5,55.7,44,44.2,31,18,184,10.2,1,12.3,58.1,5.9,5,35.5,242,835,1019,1019,0,RB
2670,Edgerrin James,46,3,49,2009,31,SEA,7,0,46,125,2.7,0,17.9,8,41.3,3,3,19,6.3,0,2.7,100,6.3,1,66.7,49,125,144,144,0,RB
2671,Chris Jennings,63,9,72,2009,24,CLE,9,1,63,220,3.5,1,24.4,10,39.7,13,9,56,6.2,0,6.2,69.2,4.3,3,46.2,72,220,276,276,0,RB
2672,Rashad Jennings,39,16,55,2009,24,JAX,15,0,39,202,5.2,1,13.5,8,43.6,18,16,101,6.3,0,6.7,88.9,5.6,4,44.4,55,202,303,359,56,RB
2673,Chris Johnson,358,50,408,2009,24,TEN,16,16,358,2006,5.6,14,125.4,80,43.6,71,50,503,10.1,2,31.4,70.4,7.1,18,39.4,408,2006,2509,2509,0,RB
2674,Gartrell Johnson,13,0,13,2009,23,NYG,10,0,13,43,3.3,0,4.3,3,23.1,1,0,0,,0,0,0,0,0,0,13,43,43,58,15,RB
2675,Jeremi Johnson,4,6,10,2009,29,CIN,16,8,4,8,2,0,0.5,1,50,12,6,41,6.8,0,2.6,50,3.4,1,41.7,10,8,49,49,0,FB
2676,Larry Johnson,178,15,193,2009,30,"CIN,KAN",14,7,178,581,3.3,0,41.5,28,38.2,21,15,80,5.3,0,5.7,71.4,3.8,5,28.6,193,581,661,661,0,RB
2677,Quinn Johnson,0,2,2,2009,23,GNB,9,0,0,0,,0,0,0,,4,2,4,2,0,0.4,50,1,0,0,2,0,4,4,0,RB
2678,Felix Jones,116,19,135,2009,22,DAL,14,1,116,685,5.9,3,48.9,24,45.7,22,19,119,6.3,0,8.5,86.4,5.4,5,50,135,685,804,1482,678,RB
2679,Greg Jones,4,5,9,2009,28,JAX,13,7,4,23,5.8,0,1.8,1,50,10,5,14,2.8,0,1.1,50,1.4,0,10,9,23,37,37,0,FB
2680,Julius Jones,177,35,212,2009,28,SEA,14,14,177,663,3.7,2,47.4,33,42.9,43,35,232,6.6,2,16.6,81.4,5.4,10,32.6,212,663,895,895,0,RB
2681,Thomas Jones,331,10,341,2009,31,NYJ,16,16,331,1402,4.2,14,87.6,66,42.6,18,10,58,5.8,0,3.6,55.6,3.2,4,27.8,341,1402,1460,1460,0,RB
2682,LaMont Jordan,25,0,25,2009,31,DEN,9,0,25,86,3.4,0,9.6,4,40,4,0,0,,0,0,0,0,0,0,25,86,86,92,6,RB
2683,Mike Karney,2,6,8,2009,28,STL,14,8,2,8,4,0,0.6,0,0,9,6,16,2.7,0,1.1,66.7,1.8,0,0,8,8,24,34,10,FB
2684,Dan Kreider,0,4,4,2009,32,ARI,14,3,0,0,,0,0,0,,6,4,20,5,0,1.4,66.7,3.3,0,0,4,0,20,20,0,FB
2685,John Kuhn,8,7,15,2009,27,GNB,14,6,8,18,2.3,1,1.3,2,37.5,7,7,47,6.7,2,3.4,100,6.7,3,71.4,15,18,65,65,0,FB
2686,Matt Lawrence,4,1,5,2009,24,BAL,8,0,4,0,0,0,0,0,0,1,1,4,4,0,0.5,100,4,0,0,5,0,4,4,0,RB
2687,Luke Lawton,0,7,7,2009,29,OAK,13,3,0,0,,0,0,0,,10,7,31,4.4,0,2.4,70,3.1,2,30,7,0,31,48,17,RB
2688,Vonta Leach,0,20,20,2009,28,HOU,16,4,0,0,,0,0,0,,26,20,155,7.8,1,9.7,76.9,6,5,57.7,20,0,155,178,23,RB
2689,Brian Leonard,27,30,57,2009,25,CIN,14,1,27,84,3.1,0,6,7,37,35,30,217,7.2,0,15.5,85.7,6.2,13,48.6,57,84,301,339,38,RB
2690,Jamal Lewis,143,8,151,2009,30,CLE,9,8,143,500,3.5,0,55.6,18,37.8,11,8,88,11,0,9.8,72.7,8,5,54.5,151,500,588,588,0,RB
2691,Stefan Logan,0,1,1,2009,28,PIT,16,1,0,0,,0,0,0,,1,1,5,5,0,0.3,100,5,0,0,1,0,5,1751,1746,RB
2692,Marshawn Lynch,120,28,148,2009,23,BUF,13,6,120,450,3.8,2,34.6,18,37.5,37,28,179,6.4,0,13.8,75.7,4.8,6,27,148,450,629,629,0,RB
2693,Marcus Mailei,0,0,0,2009,23,NOR,2,0,0,0,,0,0,0,,0,0,0,,0,0,,,0,,0,0,0,0,0,RB
2694,Laurence Maroney,194,14,208,2009,24,NWE,15,5,194,757,3.9,9,50.5,45,51.5,18,14,99,7.1,0,6.6,77.8,5.5,4,55.6,208,757,856,1135,279,RB
2695,Marcus Mason,32,6,38,2009,25,WAS,10,0,32,127,4,0,12.7,4,40.6,7,6,58,9.7,0,5.8,85.7,8.3,1,85.7,38,127,185,216,31,RB
2696,Chris Massey,0,0,0,2009,30,STL,7,0,0,0,,0,0,0,,0,0,0,,0,0,,,0,,0,0,0,0,0,RB
2697,Le'Ron McClain,46,21,67,2009,25,BAL,16,14,46,180,3.9,2,11.3,22,63,27,21,141,6.7,0,8.8,77.8,5.2,6,55.6,67,180,321,338,17,FB
2698,LeSean McCoy,155,40,195,2009,21,PHI,16,4,155,637,4.1,4,39.8,29,42.6,55,40,308,7.7,0,19.3,72.7,5.6,13,41.8,195,637,945,945,0,RB
2699,Darren McFadden,104,21,125,2009,22,OAK,12,7,104,357,3.4,1,29.8,13,36.5,36,21,245,11.7,0,20.4,58.3,6.8,10,50,125,357,602,602,0,RB
2700,Willis McGahee,109,15,124,2009,28,BAL,16,1,109,544,5,12,34,29,52.3,22,15,85,5.7,2,5.3,68.2,3.9,5,36.4,124,544,629,629,0,RB
2701,Corey McIntyre,5,7,12,2009,30,BUF,15,4,5,34,6.8,0,2.3,1,40,8,7,55,7.9,0,3.7,87.5,6.9,3,62.5,12,34,89,89,0,FB
2702,Jason McKie,0,5,5,2009,29,CHI,16,11,0,0,,0,0,0,,10,5,13,2.6,0,0.8,50,1.3,1,20,5,0,13,13,0,FB
2703,Rashard Mendenhall,242,25,267,2009,22,PIT,16,12,242,1108,4.6,7,69.3,50,45.5,32,25,261,10.4,1,16.3,78.1,8.2,13,56.3,267,1108,1369,1377,8,RB
2704,Ryan Moats,101,13,114,2009,27,HOU,14,2,101,390,3.9,4,27.9,25,54.5,15,13,106,8.2,1,7.6,86.7,7.1,7,60,114,390,496,496,0,RB
2705,Mewelde Moore,35,21,56,2009,27,PIT,16,0,35,118,3.4,0,7.4,7,37.1,31,21,153,7.3,2,9.6,67.7,4.9,9,41.9,56,124,271,318,47,RB
2706,Knowshon Moreno,247,28,275,2009,22,DEN,16,9,247,947,3.8,7,59.2,53,48.2,41,28,213,7.6,2,13.3,68.3,5.2,8,41.5,275,947,1160,1160,0,RB
2707,Maurice Morris,93,26,119,2009,30,DET,14,3,93,384,4.1,2,27.4,14,41.9,38,26,210,8.1,0,15,68.4,5.5,7,50,119,384,594,594,0,RB
2708,Sammy Morris,73,19,92,2009,32,NWE,12,5,73,319,4.4,2,26.6,19,47.9,27,19,180,9.5,0,15,70.4,6.7,11,48.1,92,319,499,499,0,RB
2709,Ovie Mughelli,4,7,11,2009,29,ATL,14,7,4,10,2.5,0,0.7,2,75,10,7,51,7.3,1,3.6,70,5.1,3,50,11,10,61,61,0,FB
2710,Moran Norris,14,7,21,2009,31,SFO,16,7,14,41,2.9,1,2.6,5,57.1,11,7,31,4.4,0,1.9,63.6,2.8,1,27.3,21,41,72,72,0,RB
2711,Jerious Norwood,76,19,95,2009,26,ATL,10,4,76,252,3.3,0,25.2,11,39.5,22,19,186,9.8,1,18.6,86.4,8.5,9,54.5,95,252,438,479,39,RB
2712,Chris Ogbonnaya,11,1,12,2009,23,STL,2,0,11,50,4.5,0,25,2,45.5,2,1,19,19,0,9.5,50,9.5,1,50,12,50,69,69,0,RB
2713,Xavier Omon,5,0,5,2009,24,BUF,5,0,5,22,4.4,0,4.4,0,0,1,0,0,,0,0,0,0,0,0,5,22,22,48,26,RB
2714,Oren O'Neal,1,0,1,2009,26,OAK,4,0,1,0,0,0,0,0,0,0,0,0,,0,0,,,0,,1,0,0,0,0,FB
2715,Montell Owens,2,0,2,2009,25,JAX,16,0,2,1,0.5,0,0.1,1,50,1,0,0,,0,0,0,0,0,0,2,1,1,50,49,RB
2716,Willie Parker,98,6,104,2009,29,PIT,14,3,98,389,4,0,27.8,19,44.9,7,6,64,10.7,1,4.6,85.7,9.1,2,57.1,104,389,453,453,0,RB
2717,Jalen Parmele,5,0,5,2009,24,BAL,7,0,5,17,3.4,0,2.4,0,0,0,0,0,,0,0,,,0,,5,17,17,300,283,RB
2718,Alvin Pearman,0,0,0,2009,27,TEN,5,0,0,0,,0,0,0,,0,0,0,,0,0,,,0,,0,0,0,286,286,RB
2719,Cedric Peerman,0,0,0,2009,23,DET,2,0,0,0,,0,0,0,,0,0,0,,0,0,,,0,,0,0,0,0,0,RB
2720,Adrian Peterson,7,2,9,2009,30,CHI,14,0,7,51,7.3,0,3.6,2,42.9,2,2,11,5.5,0,0.8,100,5.5,1,100,9,51,62,62,0,RB
2721,Adrian Peterson,314,43,357,2009,24,MIN,16,15,314,1383,4.4,18,86.4,76,44.6,57,43,436,10.1,0,27.3,75.4,7.6,16,47.4,357,1383,1819,1807,0,RB
2722,Lousaka Polite,37,11,48,2009,28,MIA,16,9,37,123,3.3,0,7.7,20,70.3,23,11,51,4.6,0,3.2,47.8,2.2,3,26.1,48,123,174,198,24,FB
2723,Clinton Portis,124,9,133,2009,28,WAS,8,8,124,494,4,1,61.8,20,41.1,12,9,57,6.3,1,7.1,75,4.8,2,50,133,494,551,551,0,RB
2724,Chris Pressley,1,1,2,2009,23,TAM,7,3,1,0,0,0,0,0,0,1,1,2,2,0,0.3,100,2,0,0,2,0,2,2,0,RB
2725,Louis Rankin,8,5,13,2009,24,"OAK,SEA",9,0,8,36,4.5,0,4,3,37.5,7,5,33,6.6,0,3.7,71.4,4.7,1,42.9,13,36,69,535,466,RB
2726,Isaac Redman,0,0,0,2009,25,PIT,1,0,0,0,,0,0,0,,0,0,0,,0,0,,,0,,0,0,0,0,0,RB
2727,Marcel Reece,0,2,2,2009,24,OAK,2,0,0,0,,0,0,0,,4,2,20,10,0,10,50,5,1,50,2,0,20,78,58,RB
2728,Ray Rice,254,78,332,2009,22,BAL,16,15,254,1339,5.3,7,83.7,53,48.8,101,78,702,9,1,43.9,77.2,7,27,46.5,332,1339,2041,2043,0,RB
2729,Tony Richardson,7,3,10,2009,38,NYJ,16,10,7,48,6.9,0,3,3,57.1,5,3,10,3.3,0,0.6,60,2,0,40,10,48,58,58,0,FB
2730,Javon Ringer,8,0,8,2009,22,TEN,7,0,8,48,6,0,6.9,3,50,0,0,0,,0,0,,,0,,8,48,48,229,181,RB
2731,Michael Robinson,3,6,9,2009,26,SFO,15,0,3,2,0.7,0,0.1,1,33.3,11,6,24,4,0,1.6,54.5,2.2,1,18.2,9,2,26,440,414,FB
2732,Gary Russell,3,12,15,2009,23,OAK,12,4,3,0,0,0,0,1,33.3,15,12,96,8,0,8,80,6.4,6,53.3,15,0,96,426,330,RB
2733,Dantrell Savage,10,7,17,2009,24,KAN,5,0,10,45,4.5,0,9,1,20,11,7,51,7.3,0,10.2,63.6,4.6,3,54.5,17,45,96,292,196,RB
2734,Owen Schmitt,0,6,6,2009,24,SEA,15,1,0,0,,0,0,0,,11,6,21,3.5,1,1.4,54.5,1.9,2,27.3,6,0,21,21,0,RB
2735,Bernard Scott,74,5,79,2009,25,CIN,13,2,74,321,4.3,0,24.7,15,41.9,8,5,67,13.4,0,5.2,62.5,8.4,3,37.5,79,321,388,892,504,RB
2736,Mike Sellers,0,17,17,2009,34,WAS,15,7,0,0,,0,0,0,,26,17,176,10.4,2,11.7,65.4,6.8,8,50,17,0,176,189,13,FB
2737,Kory Sheets,1,0,1,2009,24,MIA,2,0,1,5,5,0,2.5,1,100,0,0,0,,0,0,,,0,,1,5,5,5,0,RB
2738,Chad Simpson,15,3,18,2009,24,IND,14,0,15,102,6.8,2,7.3,5,46.7,4,3,1,0.3,0,0.1,75,0.3,0,0,18,102,103,1001,898,RB
2739,Steve Slaton,131,44,175,2009,23,HOU,11,10,131,437,3.3,3,39.7,27,33.6,55,44,417,9.5,4,37.9,80,7.6,20,60,175,437,854,854,0,RB
2740,Clifton Smith,4,2,6,2009,24,TAM,11,0,4,7,1.8,0,0.6,0,0,5,2,4,2,0,0.4,40,0.8,0,0,6,7,11,1139,1134,RB
2741,Kevin Smith,217,41,258,2009,23,DET,13,13,217,747,3.4,4,57.5,41,45.2,57,41,415,10.1,1,31.9,71.9,7.3,16,54.4,258,747,1162,1162,0,RB
2742,Kolby Smith,15,2,17,2009,25,KAN,4,0,15,33,2.2,0,8.3,1,13.3,2,2,9,4.5,0,2.3,100,4.5,0,50,17,33,42,42,0,RB
2743,Terrelle Smith,0,2,2,2009,31,DET,8,0,0,0,,0,0,0,,4,2,7,3.5,0,0.9,50,1.8,0,0,2,0,7,7,0,FB
2744,Jason Snelling,142,30,172,2009,26,ATL,14,2,142,613,4.3,4,43.8,39,46.5,39,30,259,8.6,1,18.5,76.9,6.6,13,43.6,172,613,872,872,0,RB
2745,Darren Sproles,93,45,138,2009,26,SDG,16,2,93,343,3.7,3,21.4,15,39.8,57,45,497,11,4,31.1,78.9,8.7,20,50.9,138,343,840,2323,1483,RB
2746,Aaron Stecker,5,5,10,2009,34,ATL,9,0,5,15,3,0,1.7,0,20,5,5,34,6.8,0,3.8,100,6.8,1,20,10,15,49,103,54,RB
2747,LaRod Stephens-Howling,6,10,16,2009,22,ARI,16,2,6,15,2.5,0,0.9,0,16.7,18,10,83,8.3,1,5.2,55.6,4.6,3,27.8,16,15,98,1355,1257,RB
2748,Jonathan Stewart,221,18,239,2009,22,CAR,16,3,221,1133,5.1,10,70.8,54,48.9,26,18,139,7.7,1,8.7,69.2,5.3,7,46.2,239,1133,1272,1289,17,RB
2749,Frank Summers,0,0,0,2009,24,PIT,2,1,0,0,,0,0,0,,0,0,0,,0,0,,,0,,0,0,0,0,0,RB
2750,Tyrell Sutton,12,6,18,2009,23,CAR,7,1,12,68,5.7,0,9.7,3,50,11,6,62,10.3,0,8.9,54.5,5.6,4,36.4,18,68,130,432,302,RB
2751,Naufahu Tahi,3,10,13,2009,28,MIN,15,2,3,5,1.7,0,0.3,1,100,12,10,67,6.7,1,4.5,83.3,5.6,4,50,13,5,72,72,0,RB
2752,Chester Taylor,94,44,138,2009,30,MIN,16,0,94,338,3.6,1,21.1,12,29.8,59,44,389,8.8,1,24.3,74.6,6.6,18,39,138,338,727,727,0,RB
2753,Fred Taylor,63,2,65,2009,33,NWE,6,1,63,269,4.3,4,44.8,13,54,3,2,17,8.5,0,2.8,66.7,5.7,1,66.7,65,269,286,286,0,RB
2754,Pierre Thomas,147,39,186,2009,25,NOR,14,6,147,793,5.4,6,56.6,37,54.4,45,39,302,7.7,2,21.6,86.7,6.7,12,48.9,186,793,1095,1114,19,RB
2755,Mike Tolbert,25,17,42,2009,24,SDG,16,3,25,148,5.9,1,9.3,10,64,22,17,192,11.3,3,12,77.3,8.7,9,54.5,42,148,340,340,0,RB
2756,LaDainian Tomlinson,223,20,243,2009,30,SDG,14,14,223,730,3.3,12,52.1,40,42.2,30,20,154,7.7,0,11,66.7,5.1,8,33.3,243,730,884,884,0,RB
2757,Michael Turner,178,5,183,2009,27,ATL,11,11,178,871,4.9,10,79.2,43,48.9,7,5,35,7,0,3.2,71.4,5,2,71.4,183,871,906,906,0,RB
2758,Lawrence Vickers,0,8,8,2009,26,CLE,16,9,0,0,,0,0,0,,18,8,27,3.4,1,1.7,44.4,1.5,3,27.8,8,0,27,27,0,FB
2759,Delanie Walker,3,21,24,2009,25,SFO,16,8,3,34,11.3,0,2.1,1,100,33,21,233,11.1,0,14.6,63.6,7.1,10,42.4,24,34,267,352,85,FB
2760,Derrick Ward,114,20,134,2009,29,TAM,14,1,114,409,3.6,1,29.2,13,33.3,24,20,150,7.5,2,10.7,83.3,6.3,7,54.2,134,409,559,559,0,RB
2761,Danny Ware,13,3,16,2009,24,NYG,8,0,13,73,5.6,1,9.1,5,46.2,4,3,15,5,0,1.9,75,3.8,0,25,16,73,88,125,37,RB
2762,Chauncey Washington,0,0,0,2009,24,DAL,2,0,0,0,,0,0,0,,0,0,0,,0,0,,,0,,0,0,0,0,0,RB
2763,Leon Washington,72,15,87,2009,27,NYJ,7,0,72,331,4.6,0,47.3,9,33.3,26,15,131,8.7,0,18.7,57.7,5,4,23.1,87,331,462,863,401,RB
2764,Leonard Weaver,70,15,85,2009,27,PHI,16,8,70,323,4.6,2,20.2,16,48.6,26,15,140,9.3,2,8.8,57.7,5.4,6,38.5,85,323,463,496,33,FB
2765,Beanie Wells,176,12,188,2009,21,ARI,16,0,176,793,4.5,7,49.6,39,51.1,16,12,143,11.9,0,8.9,75,8.9,5,62.5,188,793,936,932,0,RB
2766,Brian Westbrook,61,25,86,2009,30,PHI,8,7,61,274,4.5,1,34.3,12,47.5,34,25,181,7.2,1,22.6,73.5,5.3,8,41.2,86,274,455,455,0,RB
2767,LenDale White,64,3,67,2009,25,TEN,13,0,64,222,3.5,2,17.1,11,43.8,5,3,14,4.7,0,1.1,60,2.8,0,40,67,222,236,236,0,RB
2768,Cadillac Williams,211,28,239,2009,27,TAM,16,15,211,823,3.9,4,51.4,43,38.4,39,28,217,7.8,3,13.6,71.8,5.6,10,46.2,239,823,1040,1040,0,RB
2769,DeAngelo Williams,216,29,245,2009,26,CAR,13,13,216,1117,5.2,7,85.9,51,44,41,29,252,8.7,0,19.4,70.7,6.1,14,58.5,245,1117,1369,1369,0,RB
2770,Javarris Williams,6,0,6,2009,23,KAN,4,0,6,6,1,0,1.5,0,0,1,0,0,,0,0,0,0,0,0,6,6,6,6,0,RB
2771,Ricky Williams,241,35,276,2009,32,MIA,16,7,241,1121,4.7,11,70.1,55,53.9,53,35,264,7.5,2,16.5,66,5,9,41.5,276,1121,1385,1385,0,RB
2772,Garrett Wolfe,22,2,24,2009,25,CHI,8,0,22,120,5.5,1,15,6,54.5,3,2,12,6,0,1.5,66.7,4,0,0,24,120,132,132,0,RB
2773,Danny Woodhead,15,8,23,2009,24,NYJ,10,0,15,64,4.3,0,6.4,2,40,14,8,87,10.9,0,8.7,57.1,6.2,4,35.7,23,64,151,167,16,RB
2774,Jason Wright,3,9,12,2009,27,ARI,16,0,3,17,5.7,0,1.1,1,100,11,9,53,5.9,2,3.3,81.8,4.8,3,63.6,12,17,70,97,27,RB
2775,DeShawn Wynn,6,2,8,2009,26,GNB,4,0,6,19,3.2,0,4.8,0,16.7,7,2,19,9.5,0,4.8,28.6,2.7,1,14.3,8,19,38,38,0,RB
2776,Albert Young,12,0,12,2009,24,MIN,7,0,12,53,4.4,0,7.6,3,50,0,0,0,,0,0,,,0,,12,53,53,53,0,RB
2777,Joseph Addai,155,25,180,2008,25,IND,12,12,155,544,3.5,5,45.3,34,47.1,39,25,206,8.2,2,17.2,64.1,5.3,9,38.5,180,544,750,750,0,RB
2778,Shaun Alexander,11,1,12,2008,31,WAS,4,0,11,24,2.2,0,6,0,0,1,1,9,9,0,2.3,100,9,0,0,12,24,33,33,0,RB
2779,Charles Ali,0,4,4,2008,24,CLE,15,4,0,0,,0,0,0,,6,4,13,3.3,0,0.9,66.7,2.2,1,16.7,4,0,13,23,10,RB
2780,Deon Anderson,2,2,4,2008,25,DAL,14,5,2,3,1.5,0,0.2,0,0,3,2,7,3.5,1,0.5,66.7,2.3,1,66.7,4,3,10,19,9,FB
2781,J.J. Arrington,31,29,60,2008,25,ARI,11,3,31,187,6,1,17,9,41.9,40,29,255,8.8,1,23.2,72.5,6.4,15,55,60,187,442,1365,923,RB
2782,B.J. Askew,7,13,20,2008,28,TAM,10,4,7,14,2,2,1.4,6,85.7,18,13,66,5.1,0,6.6,72.2,3.7,3,33.3,20,14,80,80,0,FB
2783,Lance Ball,13,1,14,2008,23,IND,1,0,13,83,6.4,0,83,5,76.9,1,1,5,5,0,5,100,5,0,0,14,83,88,88,0,RB
2784,Marion Barber III,238,52,290,2008,25,DAL,15,13,238,885,3.7,7,59,57,39.5,61,52,417,8,2,27.8,85.2,6.8,18,49.2,290,885,1302,1302,0,RB
2785,Darian Barnes,0,2,2,2008,28,"BUF,DET,NOR",9,2,0,0,,0,0,0,,3,2,34,17,0,3.8,66.7,11.3,1,66.7,2,0,34,34,0,FB
2786,Jackie Battle,0,1,1,2008,25,KAN,9,0,0,0,,0,0,0,,1,1,-2,-2,0,-0.2,100,-2,0,0,1,0,-2,-2,0,RB
2787,Mike Bell,13,1,14,2008,25,NOR,4,0,13,42,3.2,1,10.5,4,38.5,2,1,14,14,0,3.5,50,7,1,50,14,42,56,56,0,RB
2788,Tatum Bell,44,10,54,2008,27,DEN,7,3,44,249,5.7,2,35.6,10,45.5,14,10,57,5.7,0,8.1,71.4,4.1,3,35.7,54,249,306,314,8,RB
2789,Michael Bennett,7,1,8,2008,30,"SDG,TAM",5,0,7,12,1.7,0,2.4,0,0,1,1,2,2,0,0.4,100,2,0,0,8,12,14,14,0,RB
2790,Cedric Benson,214,20,234,2008,26,CIN,12,10,214,747,3.5,2,62.3,36,39.3,26,20,185,9.3,0,15.4,76.9,7.1,6,38.5,234,747,932,932,0,RB
2791,Ladell Betts,61,22,83,2008,29,WAS,13,0,61,206,3.4,1,15.8,15,42.6,35,22,200,9.1,0,15.4,62.9,5.7,5,31.4,83,206,406,406,0,RB
2792,Lorenzo Booker,20,6,26,2008,24,PHI,10,1,20,53,2.7,0,5.3,2,35,10,6,11,1.8,0,1.1,60,1.1,1,10,26,53,64,64,0,RB
2793,Cory Boyd,0,0,0,2008,23,DEN,1,0,0,0,,0,0,0,,0,0,0,,0,0,,,0,,0,0,0,0,0,RB
2794,Ahmad Bradshaw,67,5,72,2008,22,NYG,15,0,67,355,5.3,1,23.7,14,43.3,6,5,42,8.4,1,2.8,83.3,7,2,50,72,355,397,1270,873,RB
2795,Ronnie Brown,214,33,247,2008,27,MIA,16,13,214,916,4.3,10,57.3,49,47.2,43,33,254,7.7,0,15.9,76.7,5.9,12,44.2,247,949,1170,1170,0,RB
2796,Correll Buckhalter,76,26,102,2008,30,PHI,14,2,76,369,4.9,2,26.4,18,48.7,32,26,324,12.5,2,23.1,81.3,10.1,15,65.6,102,369,693,707,14,RB
2797,Michael Bush,95,19,114,2008,24,OAK,15,0,95,421,4.4,3,28.1,15,36.8,30,19,162,8.5,0,10.8,63.3,5.4,6,46.7,114,429,583,597,14,RB
2798,Reggie Bush,106,52,158,2008,23,NOR,10,9,106,404,3.8,2,40.4,20,45.3,73,52,440,8.5,4,44,71.2,6,22,47.9,158,404,844,1114,270,RB
2799,Rock Cartwright,5,1,6,2008,29,WAS,16,0,5,14,2.8,0,0.9,0,0,1,1,-7,-7,0,-0.4,100,-7,0,0,6,14,7,1314,1307,FB
2800,Aveion Cason,4,4,8,2008,29,DET,7,0,4,7,1.8,0,1,0,0,4,4,27,6.8,0,3.9,100,6.8,0,0,8,7,34,807,773,RB
2801,Tim Castille,0,4,4,2008,24,ARI,14,0,0,0,,0,0,0,,4,4,11,2.8,0,0.8,100,2.8,0,0,4,0,11,11,0,RB
2802,Jamaal Charles,67,27,94,2008,22,KAN,16,2,67,357,5.3,0,22.3,18,52.2,39,27,272,10.1,1,17,69.2,7,9,25.6,94,357,629,950,321,RB
2803,Jesse Chatman,5,2,7,2008,29,NYJ,3,0,5,8,1.6,0,2.7,1,20,2,2,5,2.5,0,1.7,100,2.5,0,0,7,8,13,13,0,RB
2804,Tashard Choice,92,21,113,2008,24,DAL,16,3,92,472,5.1,2,29.5,25,45.7,30,21,185,8.8,0,11.6,70,6.2,6,46.7,113,472,657,657,0,RB
2805,Patrick Cobbs,12,19,31,2008,25,MIA,16,2,12,88,7.3,1,5.5,4,33.3,27,19,275,14.5,2,17.2,70.4,10.2,11,55.6,31,88,363,552,189,RB
2806,Alonzo Coleman,0,0,0,2008,24,DAL,1,0,0,0,,0,0,0,,0,0,0,,0,0,,,0,,0,0,0,0,0,RB
2807,Jameel Cook,0,3,3,2008,29,TAM,10,1,0,0,,0,0,0,,5,3,24,8,0,2.4,60,4.8,2,40,3,0,24,24,0,FB
2808,Mike Cox,1,8,9,2008,23,KAN,16,5,1,-2,-2,0,-0.1,0,0,13,8,19,2.4,0,1.2,61.5,1.5,0,0,9,-2,17,29,11,FB
2809,Kenneth Darby,32,19,51,2008,26,STL,10,0,32,140,4.4,0,14,9,40.6,21,19,183,9.6,0,18.3,90.5,8.7,8,66.7,51,140,323,496,173,RB
2810,Najeh Davenport,10,4,14,2008,29,"IND,PIT",6,0,10,31,3.1,0,5.2,3,60,4,4,54,13.5,0,9,100,13.5,2,75,14,31,85,409,324,RB
2811,Carey Davis,12,5,17,2008,27,PIT,14,3,12,35,2.9,0,2.5,2,16.7,6,5,27,5.4,0,1.9,83.3,4.5,1,50,17,35,62,168,106,RB
2812,Jason Davis,1,1,2,2008,25,"CHI,OAK",6,3,1,0,0,0,0,0,0,3,1,12,12,0,2,33.3,4,1,33.3,2,0,12,12,0,RB
2813,Clifton Dawson,0,0,0,2008,25,IND,2,0,0,0,,0,0,0,,0,0,0,,0,0,,,0,,0,0,0,0,0,RB
2814,De Dorsey,5,2,7,2008,24,CIN,4,0,5,8,1.6,0,2,0,20,2,2,49,24.5,0,12.3,100,24.5,2,100,7,8,57,57,0,RB
2815,Maurice Jones-Drew,197,62,259,2008,23,JAX,16,3,197,824,4.2,12,51.5,49,46.2,75,62,565,9.1,2,35.3,82.7,7.5,28,56,259,824,1389,1739,350,RB
2816,Reuben Droughns,0,0,0,2008,30,NYG,12,0,0,0,,0,0,0,,0,0,0,,0,0,,,0,,0,0,0,34,34,RB
2817,T.J. Duckett,62,0,62,2008,27,SEA,16,0,62,172,2.8,8,10.8,26,54.8,1,0,0,,0,0,0,0,0,0,62,172,172,193,21,RB
2818,Warrick Dunn,186,47,233,2008,33,TAM,15,6,186,786,4.2,2,52.4,31,44.6,68,47,330,7,0,22,69.1,4.9,11,47.1,233,786,1116,1116,0,RB
2819,Kyle Eckel,24,0,24,2008,27,PHI,5,0,24,79,3.3,0,15.8,6,50,0,0,0,,0,0,,,0,,24,79,79,79,0,RB
2820,Heath Evans,11,3,14,2008,30,NWE,16,4,11,23,2.1,0,1.4,4,36.4,4,3,59,19.7,0,3.7,75,14.8,3,75,14,23,82,82,0,FB
2821,Justin Fargas,218,10,228,2008,28,OAK,14,14,218,853,3.9,1,60.9,33,43.1,15,10,52,5.2,0,3.7,66.7,3.5,2,26.7,228,853,905,893,0,RB
2822,Kevin Faulk,83,58,141,2008,32,NWE,15,3,83,507,6.1,3,33.8,24,55.4,74,58,486,8.4,3,32.4,78.4,6.6,23,58.1,141,505,993,1161,168,RB
2823,Jerome Felton,2,9,11,2008,22,DET,13,6,2,4,2,0,0.3,0,50,9,9,53,5.9,0,4.1,100,5.9,4,55.6,11,4,57,57,0,FB
2824,Justin Forsett,0,0,0,2008,23,"IND,SEA",14,0,0,0,,0,0,0,,0,0,0,,0,0,,,0,,0,0,0,685,685,RB
2825,Matt Forte,316,63,379,2008,23,CHI,16,16,316,1238,3.9,8,77.4,65,40.5,76,63,477,7.6,4,29.8,82.9,6.3,23,60.5,379,1238,1715,1715,0,RB
2826,DeShaun Foster,76,16,92,2008,28,SFO,16,2,76,234,3.1,1,14.6,13,39.5,20,16,133,8.3,1,8.3,80,6.7,6,55,92,234,367,367,0,RB
2827,Samkon Gado,2,1,3,2008,26,STL,1,0,2,4,2,0,4,0,0,1,1,-1,-1,0,-1,100,-1,0,0,3,4,3,3,0,RB
2828,Quinton Ganther,9,6,15,2008,24,TEN,13,0,9,61,6.8,0,4.7,3,66.7,6,6,43,7.2,0,3.3,100,7.2,3,50,15,61,104,104,0,RB
2829,Nick Goings,9,3,12,2008,30,CAR,16,0,9,10,1.1,0,0.6,0,0,3,3,1,0.3,0,0.1,100,0.3,0,0,12,10,11,11,0,RB
2830,Frank Gore,240,43,283,2008,25,SFO,14,14,240,1036,4.3,6,74,44,45.8,66,43,373,8.7,2,26.6,65.2,5.7,13,45.5,283,1036,1409,1409,0,RB
2831,Earnest Graham,132,23,155,2008,28,TAM,10,10,132,563,4.3,4,56.3,26,47.7,33,23,174,7.6,0,17.4,69.7,5.3,6,45.5,155,566,737,737,0,RB
2832,Ryan Grant,312,18,330,2008,26,GNB,16,14,312,1203,3.9,4,75.2,54,44.6,22,18,116,6.4,1,7.3,81.8,5.3,3,45.5,330,1203,1319,1319,0,RB
2833,Ahman Green,74,11,85,2008,31,HOU,8,1,74,294,4,3,36.8,23,55.4,14,11,32,2.9,0,4,78.6,2.3,0,21.4,85,294,326,326,0,RB
2834,BenJarvus Green-Ellis,74,3,77,2008,23,NWE,9,3,74,275,3.7,5,30.6,23,54.1,6,3,37,12.3,0,4.1,50,6.2,2,50,77,275,312,312,0,RB
2835,Justin Griffith,2,9,11,2008,28,OAK,7,3,2,2,1,0,0.3,1,50,13,9,85,9.4,1,12.1,69.2,6.5,4,53.8,11,2,87,87,0,FB
2836,Ahmard Hall,8,13,21,2008,29,TEN,16,11,8,21,2.6,0,1.3,3,62.5,18,13,138,10.6,2,8.6,72.2,7.7,5,44.4,21,21,159,180,21,FB
2837,Andre Hall,35,3,38,2008,26,DEN,8,0,35,144,4.1,0,18,7,51.4,3,3,25,8.3,0,3.1,100,8.3,2,100,38,144,169,638,469,RB
2838,Korey Hall,0,7,7,2008,25,GNB,11,5,0,0,,0,0,0,,7,7,38,5.4,1,3.5,100,5.4,3,85.7,7,0,38,38,0,FB
2839,Justin Hamilton,0,0,0,2008,26,WAS,2,0,0,0,,0,0,0,,0,0,0,,0,0,,,0,,0,0,0,0,0,RB
2840,Lynell Hamilton,0,0,0,2008,23,NOR,1,0,0,0,,0,0,0,,0,0,0,,0,0,,,0,,0,0,0,0,0,RB
2841,Jerome Harrison,34,12,46,2008,25,CLE,15,0,34,246,7.2,1,16.4,11,52.9,18,12,116,9.7,1,7.7,66.7,6.4,5,44.4,46,246,362,362,0,RB
2842,Mike Hart,2,1,3,2008,22,IND,5,0,2,9,4.5,0,1.8,2,100,1,1,18,18,0,3.6,100,18,1,100,3,9,27,27,0,RB
2843,Madison Hedgecock,1,8,9,2008,27,NYG,16,10,1,0,0,0,0,0,0,15,8,52,6.5,1,3.3,53.3,3.5,4,53.3,9,0,52,52,0,FB
2844,Chris Henry,1,0,1,2008,23,TEN,1,0,1,3,3,0,3,0,0,0,0,0,,0,0,,,0,,1,3,3,3,0,RB
2845,Jacob Hester,19,12,31,2008,23,SDG,16,3,19,95,5,1,5.9,5,36.8,13,12,91,7.6,1,5.7,92.3,7,4,76.9,31,95,186,228,42,RB
2846,Maurice Hicks,0,0,0,2008,30,MIN,11,0,0,0,,0,0,0,,0,0,0,,0,0,,,0,,0,0,0,690,690,RB
2847,Tim Hightower,143,34,177,2008,22,ARI,16,7,143,399,2.8,10,24.9,34,36.4,50,34,237,7,0,14.8,68,4.7,11,38,177,399,636,636,0,RB
2848,Peyton Hillis,68,14,82,2008,22,DEN,12,6,68,343,5,5,28.6,25,63.2,19,14,179,12.8,1,14.9,73.7,9.4,9,68.4,82,343,522,587,65,RB
2849,Brad Hoover,9,6,15,2008,32,CAR,16,11,9,18,2,0,1.1,5,55.6,11,6,39,6.5,0,2.4,54.5,3.5,1,45.5,15,18,57,69,12,FB
2850,Tony Hunt,4,6,10,2008,23,PHI,6,2,4,9,2.3,1,1.5,2,75,6,6,42,7,0,7,100,7,3,66.7,10,9,51,51,0,RB
2851,Brandon Jackson,45,30,75,2008,23,GNB,13,0,45,248,5.5,1,19.1,15,51.1,39,30,185,6.2,0,14.2,76.9,4.7,6,33.3,75,248,433,433,0,RB
2852,Fred Jackson,130,37,167,2008,27,BUF,16,3,130,571,4.4,3,35.7,33,48.5,45,37,317,8.6,0,19.8,82.2,7,12,44.4,167,571,888,1185,297,RB
2853,Steven Jackson,253,40,293,2008,25,STL,12,11,253,1042,4.1,7,86.8,57,44.3,62,40,379,9.5,1,31.6,64.5,6.1,15,43.5,293,1042,1421,1421,0,RB
2854,Brandon Jacobs,219,6,225,2008,26,NYG,13,13,219,1089,5,15,83.8,58,50.2,12,6,36,6,0,2.8,50,3,0,33.3,225,1089,1125,1125,0,RB
2855,Edgerrin James,133,12,145,2008,30,ARI,13,7,133,514,3.9,3,39.5,25,41.4,18,12,85,7.1,0,6.5,66.7,4.7,4,38.9,145,514,599,599,0,RB
2856,Chris Johnson,251,43,294,2008,23,TEN,15,14,251,1228,4.9,9,81.9,54,42.6,62,43,260,6,1,17.3,69.4,4.2,11,37.1,294,1228,1488,1505,17,RB
2857,James Johnson,9,6,15,2008,24,CIN,4,0,9,29,3.2,0,7.3,2,44.4,7,6,47,7.8,0,11.8,85.7,6.7,3,57.1,15,29,76,89,13,RB
2858,Larry Johnson,193,12,205,2008,29,KAN,12,12,193,874,4.5,5,72.8,44,43.5,17,12,74,6.2,0,6.2,70.6,4.4,3,29.4,205,878,948,948,0,RB
2859,Rudi Johnson,76,12,88,2008,29,DET,14,4,76,237,3.1,1,16.9,11,28.9,14,12,88,7.3,1,6.3,85.7,6.3,4,42.9,88,237,325,325,0,RB
2860,Felix Jones,30,2,32,2008,21,DAL,6,0,30,266,8.9,3,44.3,14,70,2,2,10,5,0,1.7,100,5,0,50,32,266,276,710,434,RB
2861,Greg Jones,2,13,15,2008,27,JAX,12,7,2,13,6.5,0,1.1,1,50,16,13,116,8.9,1,9.7,81.3,7.3,6,68.8,15,13,129,148,19,FB
2862,Julius Jones,158,14,172,2008,27,SEA,15,10,158,698,4.4,2,46.5,30,39.2,25,14,66,4.7,0,4.4,56,2.6,4,28,172,698,764,764,0,RB
2863,Kevin Jones,34,2,36,2008,26,CHI,11,0,34,109,3.2,0,9.9,7,29.4,2,2,5,2.5,0,0.5,100,2.5,0,0,36,109,114,114,0,RB
2864,Thomas Jones,290,36,326,2008,30,NYJ,16,14,290,1312,4.5,13,82,63,51.4,42,36,207,5.8,2,12.9,85.7,4.9,13,57.1,326,1312,1519,1519,0,RB
2865,LaMont Jordan,80,0,80,2008,30,NWE,8,0,80,363,4.5,4,45.4,20,57.5,0,0,0,,0,0,,,0,,80,363,363,363,0,RB
2866,Mike Karney,8,9,17,2008,27,NOR,12,8,8,10,1.3,2,0.8,5,75,12,9,18,2,0,1.5,75,1.5,1,33.3,17,10,28,28,0,FB
2867,David Kirtman,0,0,0,2008,25,SFO,1,0,0,0,,0,0,0,,0,0,0,,0,0,,,0,,0,0,0,0,0,RB
2868,Dan Kreider,1,0,1,2008,31,STL,11,4,1,0,0,0,0,0,0,5,0,0,,0,0,0,0,0,0,1,0,0,0,0,FB
2869,John Kuhn,8,4,12,2008,26,GNB,16,3,8,10,1.3,1,0.6,5,62.5,7,4,21,5.3,2,1.3,57.1,3,3,42.9,12,10,31,31,0,FB
2870,Luke Lawton,0,6,6,2008,28,OAK,16,7,0,0,,0,0,0,,11,6,30,5,0,1.9,54.5,2.7,3,36.4,6,0,30,59,29,FB
2871,Vonta Leach,1,12,13,2008,27,HOU,16,12,1,1,1,1,0.1,1,100,18,12,103,8.6,0,6.4,66.7,5.7,2,50,13,1,104,138,34,FB
2872,Brian Leonard,2,0,2,2008,24,STL,2,0,2,7,3.5,0,3.5,0,0,0,0,0,,0,0,,,0,,2,7,7,7,0,RB
2873,Jamal Lewis,279,23,302,2008,29,CLE,16,16,279,1002,3.6,4,62.6,43,38.7,32,23,178,7.7,0,11.1,71.9,5.6,8,50,302,1002,1180,1180,0,RB
2874,Kregg Lumpkin,1,3,4,2008,24,GNB,2,0,1,19,19,0,9.5,1,100,3,3,22,7.3,0,11,100,7.3,1,66.7,4,19,41,41,0,RB
2875,Marshawn Lynch,250,47,297,2008,22,BUF,15,15,250,1036,4.1,8,69.1,53,46.8,67,47,300,6.4,1,20,70.1,4.5,15,35.8,297,1036,1336,1336,0,RB
2876,Laurence Maroney,28,0,28,2008,23,NWE,3,3,28,93,3.3,0,31,4,50,0,0,0,,0,0,,,0,,28,93,93,93,0,RB
2877,Chris Massey,0,0,0,2008,29,STL,16,0,0,0,,0,0,0,,0,0,0,,0,0,,,0,,0,0,0,0,0,RB
2878,Reagan Maui'a,0,0,0,2008,24,CIN,2,2,0,0,,0,0,0,,0,0,0,,0,0,,,0,,0,0,0,0,0,RB
2879,Deuce McAllister,107,18,125,2008,30,NOR,13,6,107,418,3.9,5,32.2,24,55.1,23,18,128,7.1,1,9.8,78.3,5.6,5,52.2,125,418,546,546,0,RB
2880,Le'Ron McClain,232,19,251,2008,24,BAL,16,16,232,902,3.9,10,56.4,53,45.7,30,19,123,6.5,1,7.7,63.3,4.1,7,26.7,251,902,1025,1025,0,FB
2881,Darren McFadden,113,29,142,2008,21,OAK,13,5,113,499,4.4,4,38.4,25,37.2,39,29,285,9.8,0,21.9,74.4,7.3,13,51.3,142,494,784,784,0,RB
2882,Willis McGahee,170,24,194,2008,27,BAL,13,8,170,671,3.9,7,51.6,36,43.5,32,24,173,7.2,0,13.3,75,5.4,8,37.5,194,671,844,844,0,RB
2883,Sean McHugh,0,3,3,2008,26,PIT,15,3,0,0,,0,0,0,,4,3,24,8,0,1.6,75,6,1,50,3,0,24,24,0,FB
2884,Corey McIntyre,0,2,2,2008,29,BUF,11,2,0,0,,0,0,0,,3,2,-1,-0.5,0,-0.1,66.7,-0.3,0,0,2,0,-1,17,18,FB
2885,Jason McKie,11,11,22,2008,28,CHI,11,8,11,26,2.4,2,2.4,5,54.5,15,11,64,5.8,1,5.8,73.3,4.3,3,53.3,22,26,90,128,38,FB
2886,Rashard Mendenhall,19,2,21,2008,21,PIT,4,1,19,58,3.1,0,14.5,3,26.3,3,2,17,8.5,0,4.3,66.7,5.7,1,33.3,21,58,75,190,115,RB
2887,Garrett Mills,0,5,5,2008,25,MIN,8,0,0,0,,0,0,0,,11,5,65,13,0,8.1,45.5,5.9,3,45.5,5,0,65,65,0,FB
2888,Travis Minor,13,5,18,2008,29,STL,13,0,13,29,2.2,0,2.2,3,23.1,6,5,35,7,0,2.7,83.3,5.8,2,50,18,29,64,219,155,RB
2889,Ryan Moats,26,3,29,2008,26,HOU,9,0,26,94,3.6,1,10.4,6,46.2,5,3,14,4.7,0,1.6,60,2.8,0,20,29,94,108,320,212,RB
2890,Mewelde Moore,140,40,180,2008,26,PIT,16,4,140,588,4.2,5,36.8,36,50,53,40,320,8,1,20,75.5,6,17,47.2,180,588,908,1114,206,RB
2891,Maurice Morris,132,19,151,2008,29,SEA,13,6,132,574,4.3,0,44.2,29,43.9,27,19,136,7.2,2,10.5,70.4,5,5,55.6,151,574,710,710,0,RB
2892,Sammy Morris,156,17,173,2008,31,NWE,13,7,156,727,4.7,7,55.9,46,49.4,24,17,161,9.5,0,12.4,70.8,6.7,5,54.2,173,727,888,925,37,RB
2893,Ovie Mughelli,5,8,13,2008,28,ATL,16,13,5,16,3.2,0,1,4,80,10,8,57,7.1,0,3.6,80,5.7,2,40,13,16,73,90,17,FB
2894,Lorenzo Neal,12,7,19,2008,38,BAL,16,5,12,25,2.1,0,1.6,6,50,15,7,35,5,0,2.2,46.7,2.3,2,20,19,25,60,62,2,FB
2895,Moran Norris,1,4,5,2008,30,DET,11,8,1,1,1,0,0.1,0,0,7,4,16,4,0,1.5,57.1,2.3,0,0,5,1,17,17,0,FB
2896,Jerious Norwood,95,36,131,2008,25,ATL,16,0,95,489,5.1,4,30.6,22,42.1,54,36,338,9.4,2,21.1,66.7,6.3,12,33.3,131,489,827,2138,1311,RB
2897,Xavier Omon,6,0,6,2008,23,BUF,2,0,6,5,0.8,0,2.5,1,16.7,0,0,0,,0,0,,,0,,6,5,5,5,0,RB
2898,Montell Owens,2,2,4,2008,24,JAX,16,0,2,43,21.5,2,2.7,2,100,3,2,17,8.5,0,1.1,66.7,5.7,1,66.7,4,43,60,108,30,RB
2899,Willie Parker,210,3,213,2008,28,PIT,11,11,210,791,3.8,5,71.9,29,41,10,3,13,4.3,0,1.2,30,1.3,0,0,213,791,804,804,0,RB
2900,Jalen Parmele,2,0,2,2008,23,BAL,1,0,2,27,13.5,0,27,1,50,0,0,0,,0,0,,,0,,2,27,27,27,0,RB
2901,Alvin Pearman,0,1,1,2008,26,JAX,1,0,0,0,,0,0,0,,1,1,23,23,1,23,100,23,1,100,1,0,23,23,0,RB
2902,Chris Perry,104,20,124,2008,27,CIN,13,6,104,269,2.6,2,20.7,11,29.8,34,20,71,3.6,0,5.5,58.8,2.1,5,20.6,124,269,340,340,0,RB
2903,Adrian Peterson,20,6,26,2008,29,CHI,15,0,20,100,5,0,6.7,4,45,10,6,45,7.5,0,3,60,4.5,1,20,26,100,145,156,11,RB
2904,Adrian Peterson,363,21,384,2008,23,MIN,16,15,363,1760,4.8,10,110,82,45.5,39,21,125,6,0,7.8,53.8,3.2,4,25.6,384,1760,1885,1901,16,RB
2905,Antonio Pittman,79,18,97,2008,23,STL,12,5,79,296,3.7,0,24.7,16,43,27,18,132,7.3,0,11,66.7,4.9,5,40.7,97,296,428,428,0,FB
2906,Michael Pittman,76,10,86,2008,33,DEN,8,3,76,320,4.2,4,40,24,56.6,13,10,112,11.2,0,14,76.9,8.6,1,23.1,86,320,432,432,0,RB
2907,Lousaka Polite,23,6,29,2008,27,MIA,11,5,23,85,3.7,0,7.7,15,78.3,8,6,24,4,0,2.2,75,3,1,50,29,85,109,109,0,FB
2908,P.J. Pope,17,3,20,2008,24,DEN,5,1,17,130,7.6,0,26,6,64.7,4,3,24,8,1,4.8,75,6,2,50,20,130,154,154,0,RB
2909,Clinton Portis,342,28,370,2008,27,WAS,16,16,342,1487,4.3,9,92.9,78,46.8,35,28,218,7.8,0,13.6,80,6.2,11,48.6,370,1487,1705,1705,0,RB
2910,Dominic Rhodes,152,45,197,2008,29,IND,15,4,152,538,3.5,6,35.9,27,47.4,59,45,302,6.7,3,20.1,76.3,5.1,15,42.4,197,538,840,840,0,RB
2911,Ray Rice,107,33,140,2008,21,BAL,13,4,107,454,4.2,0,34.9,21,41.1,43,33,273,8.3,0,21,76.7,6.3,12,48.8,140,454,727,888,161,RB
2912,Tony Richardson,10,1,11,2008,37,NYJ,16,7,10,65,6.5,0,4.1,6,70,7,1,4,4,0,0.3,14.3,0.6,0,0,11,65,69,69,0,FB
2913,Michael Robinson,19,17,36,2008,25,SFO,16,1,19,50,2.6,0,3.1,6,52.6,20,17,202,11.9,0,12.6,85,10.1,9,65,36,50,252,387,135,FB
2914,Gary Russell,28,1,29,2008,22,PIT,12,0,28,77,2.8,3,6.4,11,53.6,2,1,-2,-2,0,-0.2,50,-1,0,0,29,77,75,446,371,RB
2915,B.J. Sams,0,0,0,2008,28,KAN,3,0,0,0,,0,0,0,,0,0,0,,0,0,,,0,,0,0,0,238,238,RB
2916,Cecil Sapp,2,0,2,2008,30,HOU,12,0,2,-3,-1.5,0,-0.3,0,0,0,0,0,,0,0,,,0,,2,-3,-3,4,7,RB
2917,Dantrell Savage,15,2,17,2008,23,KAN,8,0,15,53,3.5,0,6.6,4,46.7,2,2,0,0,0,0,100,0,0,0,17,53,53,703,650,RB
2918,Owen Schmitt,5,6,11,2008,23,SEA,15,1,5,21,4.2,0,1.4,1,20,8,6,29,4.8,0,1.9,75,3.6,1,50,11,21,50,50,0,RB
2919,Mike Sellers,6,12,18,2008,33,WAS,16,6,6,24,4,0,1.5,1,16.7,15,12,98,8.2,1,6.1,80,6.5,5,40,18,24,122,154,32,FB
2920,Chad Simpson,15,3,18,2008,23,IND,11,0,15,45,3,1,4.1,6,60,4,3,30,10,0,2.7,75,7.5,1,75,18,45,75,419,344,RB
2921,Steve Slaton,268,50,318,2008,22,HOU,16,15,268,1282,4.8,9,80.1,62,43.3,59,50,377,7.5,1,23.6,84.7,6.4,14,39,318,1282,1659,1659,0,RB
2922,Clifton Smith,8,4,12,2008,23,TAM,9,0,8,40,5,0,4.4,3,75,5,4,24,6,0,2.7,80,4.8,1,40,12,40,64,1380,1316,RB
2923,Kevin Smith,238,39,277,2008,22,DET,16,12,238,976,4.1,8,61,51,44.1,54,39,286,7.3,0,17.9,72.2,5.3,9,35.2,277,976,1262,1262,0,RB
2924,Kolby Smith,35,10,45,2008,24,KAN,7,3,35,100,2.9,1,14.3,5,40,11,10,52,5.2,0,7.4,90.9,4.7,0,45.5,45,100,152,152,0,RB
2925,Terrelle Smith,0,2,2,2008,30,ARI,15,6,0,0,,0,0,0,,6,2,24,12,0,1.6,33.3,4,1,33.3,2,0,24,24,0,FB
2926,Jason Snelling,15,8,23,2008,25,ATL,16,1,15,62,4.1,0,3.9,5,46.7,11,8,89,11.1,0,5.6,72.7,8.1,3,27.3,23,62,151,151,0,RB
2927,Olaniyi Sobomehin,0,2,2,2008,24,NOR,1,0,0,0,,0,0,0,,3,2,8,4,0,8,66.7,2.7,1,33.3,2,0,8,8,0,RB
2928,Darren Sproles,61,29,90,2008,25,SDG,16,0,61,330,5.4,1,20.6,15,45.9,34,29,342,11.8,5,21.4,85.3,10.1,14,67.6,90,330,672,2295,1625,RB
2929,Aaron Stecker,8,9,17,2008,33,NOR,6,0,8,43,5.4,0,7.2,2,25,12,9,52,5.8,1,8.7,75,4.3,3,50,17,43,95,105,10,RB
2930,Jonathan Stewart,184,8,192,2008,21,CAR,16,0,184,836,4.5,10,52.3,42,41.8,17,8,47,5.9,0,2.9,47.1,2.8,2,23.5,192,836,883,1232,349,RB
2931,Byron Storer,0,0,0,2008,24,TAM,6,3,0,0,,0,0,0,,0,0,0,,0,0,,,0,,0,0,0,0,0,RB
2932,Naufahu Tahi,0,16,16,2008,27,MIN,16,5,0,0,,0,0,0,,21,16,37,2.3,0,2.3,76.2,1.8,2,14.3,16,0,37,68,31,FB
2933,Thomas Tapeh,0,1,1,2008,28,MIN,2,1,0,0,,0,0,0,,3,1,7,7,0,3.5,33.3,2.3,0,0,1,0,7,7,0,FB
2934,Chester Taylor,101,45,146,2008,29,MIN,16,1,101,399,4,4,24.9,19,42.6,55,45,399,8.9,2,24.9,81.8,7.3,17,43.6,146,403,798,1032,234,RB
2935,Chris Taylor,14,0,14,2008,25,HOU,3,0,14,37,2.6,0,12.3,1,21.4,0,0,0,,0,0,,,0,,14,37,37,54,17,RB
2936,Fred Taylor,143,16,159,2008,32,JAX,13,13,143,556,3.9,1,42.8,24,38.5,22,16,98,6.1,0,7.5,72.7,4.5,2,50,159,556,654,654,0,RB
2937,Marcus Thomas,0,0,0,2008,24,DET,3,0,0,0,,0,0,0,,0,0,0,,0,0,,,0,,0,0,0,93,93,RB
2938,Pierre Thomas,129,31,160,2008,24,NOR,15,5,129,625,4.8,9,41.7,43,58.9,41,31,284,9.2,3,18.9,75.6,6.9,15,61,160,625,909,1702,793,RB
2939,Mike Tolbert,13,13,26,2008,23,SDG,13,7,13,37,2.8,0,2.8,4,53.8,15,13,171,13.2,1,13.2,86.7,11.4,8,66.7,26,37,208,208,0,FB
2940,LaDainian Tomlinson,292,52,344,2008,29,SDG,16,16,292,1110,3.8,11,69.4,52,43.2,77,52,426,8.2,1,26.6,67.5,5.5,18,44.2,344,1110,1536,1536,0,RB
2941,Ryan Torain,15,0,15,2008,22,DEN,2,1,15,69,4.6,1,34.5,4,60,0,0,0,,0,0,,,0,,15,69,69,69,0,RB
2942,Michael Turner,376,6,382,2008,26,ATL,16,16,376,1699,4.5,17,106.2,85,46.5,9,6,41,6.8,0,2.6,66.7,4.6,2,44.4,382,1699,1740,1740,0,RB
2943,Lawrence Vickers,10,10,20,2008,25,CLE,12,8,10,31,3.1,0,2.6,6,70,15,10,78,7.8,0,6.5,66.7,5.2,4,40,20,31,109,109,0,FB
2944,Derrick Ward,182,41,223,2008,28,NYG,16,3,182,1025,5.6,2,64.1,53,50,55,41,384,9.4,0,24,74.5,7,14,41.8,223,1025,1409,1430,21,RB
2945,Danny Ware,2,0,2,2008,23,NYG,6,0,2,15,7.5,0,2.5,1,100,0,0,0,,0,0,,,0,,2,15,15,15,0,RB
2946,Chauncey Washington,4,1,5,2008,23,JAX,6,0,4,9,2.3,0,1.5,1,50,1,1,9,9,0,1.5,100,9,1,100,5,9,18,18,0,RB
2947,Leon Washington,76,47,123,2008,26,NYJ,16,1,76,448,5.9,6,28,17,50,61,47,355,7.6,2,22.2,77,5.8,17,42.6,123,448,803,2332,1534,RB
2948,Kenny Watson,13,3,16,2008,30,CIN,10,0,13,55,4.2,0,5.5,2,38.5,9,3,4,1.3,0,0.4,33.3,0.4,0,0,16,55,59,122,63,RB
2949,Leonard Weaver,30,20,50,2008,26,SEA,14,7,30,130,4.3,0,9.3,9,46.7,32,20,222,11.1,2,15.9,62.5,6.9,6,31.3,50,130,352,352,0,FB
2950,Brian Westbrook,233,54,287,2008,29,PHI,14,14,233,936,4,9,66.9,49,45.9,74,54,402,7.4,5,28.7,73,5.4,19,44.6,287,936,1338,1337,0,RB
2951,LenDale White,200,5,205,2008,24,TEN,16,2,200,773,3.9,15,48.3,43,50,10,5,16,3.2,0,1,50,1.6,1,20,205,773,789,789,0,RB
2952,Cadillac Williams,63,7,70,2008,26,TAM,6,1,63,233,3.7,4,38.8,18,46,7,7,43,6.1,0,7.2,100,6.1,2,42.9,70,233,276,276,0,RB
2953,DeAngelo Williams,273,22,295,2008,25,CAR,16,16,273,1515,5.5,18,94.7,65,44.3,30,22,121,5.5,2,7.6,73.3,4,8,26.7,295,1515,1636,1636,0,RB
2954,Ricky Williams,160,29,189,2008,31,MIA,16,3,160,659,4.1,4,41.2,36,45.6,39,29,219,7.6,1,13.7,74.4,5.6,10,38.5,189,659,878,878,0,RB
2955,Garrett Wolfe,15,0,15,2008,24,CHI,13,0,15,69,4.6,0,5.3,3,20,0,0,0,,0,0,,,0,,15,69,69,167,98,RB
2956,Jason Wright,23,22,45,2008,26,CLE,15,0,23,85,3.7,0,5.7,7,39.1,37,22,156,7.1,1,10.4,59.5,4.2,8,35.1,45,85,241,241,0,RB
2957,DeShawn Wynn,8,3,11,2008,25,GNB,5,0,8,110,13.8,1,22,2,62.5,3,3,30,10,0,6,100,10,1,33.3,11,110,140,140,0,RB
2958,Selvin Young,61,3,64,2008,25,DEN,8,5,61,303,5,1,37.9,11,47.5,8,3,16,5.3,0,2,37.5,2,0,25,64,303,319,495,176,RB
2959,Joseph Addai,261,41,302,2007,24,IND,15,15,261,1072,4.1,12,71.5,66,51.3,48,41,364,8.9,3,24.3,85.4,7.6,16,58.3,302,1072,1436,1436,0,RB
2960,Rich Alexis,0,0,0,2007,26,STL,1,0,0,0,,0,0,0,,0,0,0,,0,0,,,0,,0,0,0,0,0,RB
2961,Shaun Alexander,207,14,221,2007,30,SEA,13,10,207,716,3.5,4,55.1,39,35.3,25,14,76,5.4,1,5.8,56,3,4,20,221,716,792,792,0,RB
2962,Charles Ali,0,0,0,2007,23,CLE,13,0,0,0,,0,0,0,,0,0,0,,0,0,,,0,,0,0,0,0,0,RB
2963,Deon Anderson,0,6,6,2007,24,DAL,8,4,0,0,,0,0,0,,6,6,55,9.2,0,6.9,100,9.2,3,83.3,6,0,55,65,10,FB
2964,Mike Anderson,15,4,19,2007,34,BAL,8,0,15,62,4.1,0,7.8,3,40,4,4,26,6.5,0,3.3,100,6.5,1,75,19,62,88,98,10,RB
2965,J.J. Arrington,26,29,55,2007,24,ARI,16,0,26,78,3,0,4.9,3,26.9,39,29,241,8.3,1,15.1,74.4,6.2,9,33.3,55,78,319,570,251,RB
2966,B.J. Askew,0,18,18,2007,27,TAM,13,9,0,0,,0,0,0,,21,18,175,9.7,0,13.5,85.7,8.3,8,61.9,18,0,175,175,0,FB
2967,Marion Barber III,204,44,248,2007,24,DAL,16,0,204,975,4.8,10,60.9,54,47.5,54,44,282,6.4,2,17.6,81.5,5.2,17,50,248,975,1257,1257,0,RB
2968,Chris Barclay,1,2,3,2007,24,"NOR,TEN",5,0,1,3,3,0,0.6,0,0,3,2,13,6.5,0,2.6,66.7,4.3,0,0,3,3,16,452,436,RB
2969,Darian Barnes,0,0,0,2007,27,NYJ,5,3,0,0,,0,0,0,,0,0,0,,0,0,,,0,,0,0,0,0,0,FB
2970,Jackie Battle,14,1,15,2007,24,KAN,3,0,14,47,3.4,1,15.7,3,42.9,5,1,4,4,0,1.3,20,0.8,0,20,15,47,51,51,0,RB
2971,Mike Bell,6,1,7,2007,24,DEN,5,0,6,3,0.5,0,0.6,2,33.3,1,1,7,7,0,1.4,100,7,0,100,7,3,10,10,0,RB
2972,Tatum Bell,44,14,58,2007,26,DET,5,5,44,182,4.1,1,36.4,7,45.5,21,14,63,4.5,0,12.6,66.7,3,2,23.8,58,182,245,245,0,RB
2973,Michael Bennett,61,15,76,2007,29,"KAN,TAM",14,1,61,241,4,1,17.2,9,37.7,22,15,101,6.7,1,7.2,68.2,4.6,4,40.9,76,241,342,342,0,RB
2974,Cedric Benson,196,17,213,2007,25,CHI,11,11,196,674,3.4,4,61.3,34,39.3,27,17,123,7.2,0,11.2,63,4.6,6,40.7,213,674,797,797,0,RB
2975,Ladell Betts,93,21,114,2007,28,WAS,16,0,93,335,3.6,1,20.9,15,44.1,32,21,174,8.3,1,10.9,65.6,5.4,7,37.5,114,335,509,617,108,RB
2976,Lorenzo Booker,28,28,56,2007,23,MIA,7,1,28,125,4.5,0,17.9,8,57.1,36,28,237,8.5,0,33.9,77.8,6.6,12,63.9,56,125,362,362,0,RB
2977,Ahmad Bradshaw,23,2,25,2007,21,NYG,12,0,23,190,8.3,1,15.8,6,56.5,5,2,12,6,0,1,40,2.4,1,20,25,190,202,1124,922,RB
2978,Jon Bradley,5,2,7,2007,26,DET,15,6,5,9,1.8,0,0.6,3,60,4,2,10,5,0,0.7,50,2.5,0,25,7,9,19,19,0,FB
2979,Jamaal Branch,0,0,0,2007,26,NOR,4,0,0,0,,0,0,0,,0,0,0,,0,0,,,0,,0,0,0,0,0,RB
2980,Chris Brown,102,19,121,2007,26,TEN,12,1,102,462,4.5,5,38.5,28,55.9,21,19,128,6.7,0,10.7,90.5,6.1,8,52.4,121,462,590,590,0,RB
2981,Ronnie Brown,119,39,158,2007,26,MIA,7,7,119,602,5.1,4,86,39,51.3,46,39,389,10,1,55.6,84.8,8.5,17,58.7,158,602,991,991,0,RB
2982,Correll Buckhalter,62,12,74,2007,29,PHI,14,2,62,313,5,4,22.4,17,48.4,21,12,87,7.3,0,6.2,57.1,4.1,7,47.6,74,313,400,1198,798,RB
2983,Reggie Bush,157,73,230,2007,22,NOR,12,10,157,581,3.7,4,48.4,37,45.2,98,73,417,5.7,2,34.8,74.5,4.3,23,44.9,230,581,998,994,12,RB
2984,Brian Calhoun,7,5,12,2007,23,DET,4,0,7,35,5,0,8.8,2,42.9,5,5,35,7,0,8.8,100,7,1,80,12,35,70,291,221,RB
2985,Rock Cartwright,2,0,2,2007,28,WAS,15,0,2,0,0,0,0,0,0,0,0,0,,0,0,,,0,,2,0,0,1339,1339,FB
2986,Aveion Cason,11,14,25,2007,28,DET,12,0,11,38,3.5,0,3.2,2,45.5,16,14,129,9.2,0,10.8,87.5,8.1,5,62.5,25,38,167,1208,1041,RB
2987,Jesse Chatman,128,27,155,2007,28,MIA,14,6,128,515,4,1,36.8,26,41.4,37,27,161,6,0,11.5,73,4.4,8,48.6,155,515,676,707,31,RB
2988,Patrick Cobbs,15,2,17,2007,24,MIA,14,0,15,47,3.1,1,3.4,3,46.7,6,2,20,10,0,1.4,33.3,3.3,0,50,17,47,67,111,44,RB
2989,Jameel Cook,8,8,16,2007,28,HOU,16,0,8,24,3,0,1.5,2,25,8,8,40,5,0,2.5,100,5,2,75,16,24,64,97,33,FB
2990,Zack Crockett,1,0,1,2007,35,TAM,1,0,1,0,0,0,0,0,0,0,0,0,,0,0,,,0,,1,0,0,0,0,FB
2991,Kenneth Darby,2,2,4,2007,25,TAM,1,0,2,9,4.5,0,9,1,50,3,2,16,8,0,16,66.7,5.3,0,66.7,4,9,25,36,11,RB
2992,Najeh Davenport,107,18,125,2007,28,PIT,15,1,107,499,4.7,5,33.3,37,52.3,27,18,184,10.2,2,12.3,66.7,6.8,5,29.6,125,499,683,806,123,RB
2993,Carey Davis,17,12,29,2007,26,PIT,16,7,17,68,4,0,4.3,1,23.5,14,12,49,4.1,0,3.1,85.7,3.5,2,35.7,29,68,117,117,0,FB
2994,Clifton Dawson,30,2,32,2007,24,"CIN,IND",13,0,30,64,2.1,1,4.9,3,33.3,9,2,15,7.5,0,1.2,22.2,1.7,1,22.2,32,64,79,79,0,RB
2995,Ron Dayne,194,17,211,2007,29,HOU,13,8,194,773,4,6,59.5,44,44.8,26,17,112,6.6,0,8.6,65.4,4.3,4,42.3,211,773,885,885,0,RB
2996,De Dorsey,21,4,25,2007,23,CIN,12,2,21,183,8.7,0,15.3,9,61.9,6,4,19,4.8,0,1.6,66.7,3.2,1,33.3,25,183,202,222,20,RB
2997,Robert Douglas,0,0,0,2007,25,NYG,1,0,0,0,,0,0,0,,0,0,0,,0,0,,,0,,0,0,0,0,0,RB
2998,Maurice Jones-Drew,167,40,207,2007,22,JAX,15,0,167,768,4.6,9,51.2,47,44.3,55,40,407,10.2,0,27.1,72.7,7.4,22,52.7,207,768,1175,2014,839,RB
2999,Reuben Droughns,85,7,92,2007,29,NYG,16,1,85,275,3.2,6,17.2,27,44.7,15,7,49,7,0,3.1,46.7,3.3,1,20,92,275,324,761,437,RB
3000,T.J. Duckett,65,4,69,2007,26,DET,12,1,65,335,5.2,3,27.9,16,40,7,4,54,13.5,0,4.5,57.1,7.7,4,57.1,69,335,389,389,0,RB
3001,Warrick Dunn,227,37,264,2007,32,ATL,16,15,227,720,3.2,4,45,36,35.7,59,37,238,6.4,0,14.9,62.7,4,5,27.1,264,720,958,958,0,RB
3002,Adimchinobe Echemandu,20,2,22,2007,27,"HOU,OAK",9,0,20,85,4.3,0,9.4,3,30,2,2,11,5.5,0,1.2,100,5.5,0,50,22,85,96,96,0,RB
3003,Kyle Eckel,33,1,34,2007,26,NWE,12,0,33,90,2.7,2,7.5,5,27.3,1,1,6,6,0,0.5,100,6,0,100,34,90,96,96,0,RB
3004,Heath Evans,34,4,38,2007,29,NWE,16,1,34,121,3.6,3,7.6,13,67.6,6,4,43,10.8,0,2.7,66.7,7.2,2,50,38,121,164,177,13,FB
3005,Justin Fargas,222,23,245,2007,27,OAK,14,7,222,1009,4.5,4,72.1,52,45.9,32,23,188,8.2,0,13.4,71.9,5.9,12,46.9,245,1009,1197,1197,0,RB
3006,Kevin Faulk,62,47,109,2007,31,NWE,16,8,62,265,4.3,0,16.6,15,53.2,61,47,383,8.1,1,23.9,77,6.3,20,59,109,265,648,695,47,RB
3007,Casey Fitzsimmons,0,8,8,2007,27,DET,16,5,0,0,,0,0,0,,10,8,85,10.6,1,5.3,80,8.5,6,80,8,0,85,147,62,FB
3008,DeShaun Foster,247,25,272,2007,27,CAR,16,16,247,876,3.5,3,54.8,43,40.1,36,25,182,7.3,1,11.4,69.4,5.1,6,38.9,272,876,1058,1058,0,RB
3009,Samkon Gado,53,12,65,2007,25,"HOU,MIA",8,2,53,150,2.8,4,18.8,9,34,13,12,106,8.8,0,13.3,92.3,8.2,3,46.2,65,150,256,256,0,RB
3010,Quinton Ganther,0,0,0,2007,23,TEN,2,0,0,0,,0,0,0,,1,0,0,,0,0,0,0,0,0,0,0,0,0,0,RB
3011,Lionel Gates,0,0,0,2007,25,TAM,1,0,0,0,,0,0,0,,0,0,0,,0,0,,,0,,0,0,0,0,0,RB
3012,Nick Goings,0,0,0,2007,29,CAR,4,0,0,0,,0,0,0,,0,0,0,,0,0,,,0,,0,0,0,174,174,RB
3013,Frank Gore,260,53,313,2007,24,SFO,15,15,260,1102,4.2,5,73.5,42,41.5,69,53,436,8.2,1,29.1,76.8,6.3,20,55.1,313,1102,1538,1538,0,RB
3014,Earnest Graham,222,49,271,2007,27,TAM,15,10,222,898,4,10,59.9,47,50,69,49,324,6.6,0,21.6,71,4.7,13,46.4,271,898,1222,1312,90,RB
3015,Ryan Grant,188,30,218,2007,25,GNB,15,7,188,956,5.1,8,63.7,38,45.2,37,30,145,4.8,0,9.7,81.1,3.9,9,43.2,218,956,1101,1101,0,RB
3016,Ahman Green,70,14,84,2007,30,HOU,6,5,70,260,3.7,2,43.3,17,40,18,14,123,8.8,0,20.5,77.8,6.8,2,22.2,84,260,383,383,0,RB
3017,Justin Green,0,2,2,2007,25,BAL,15,0,0,0,,0,0,0,,2,2,16,8,0,1.1,100,8,1,100,2,0,16,16,0,FB
3018,Justin Griffith,7,26,33,2007,27,OAK,16,11,7,27,3.9,0,1.7,0,42.9,36,26,165,6.3,1,10.3,72.2,4.6,7,55.6,33,27,192,203,11,FB
3019,Ahmard Hall,1,9,10,2007,28,TEN,11,4,1,8,8,0,0.7,1,100,12,9,60,6.7,0,5.5,75,5,3,33.3,10,8,68,68,0,RB
3020,Andre Hall,44,2,46,2007,25,DEN,10,1,44,216,4.9,2,21.6,10,31.8,2,2,69,34.5,0,6.9,100,34.5,1,50,46,216,285,760,475,RB
3021,Korey Hall,0,8,8,2007,24,GNB,14,10,0,0,,0,0,0,,11,8,49,6.1,0,3.5,72.7,4.5,3,54.5,8,0,49,49,0,FB
3022,Gilbert Harris,9,3,12,2007,23,KAN,4,0,9,9,1,0,2.3,1,11.1,4,3,38,12.7,0,9.5,75,9.5,1,75,12,9,47,47,0,RB
3023,Jerome Harrison,23,2,25,2007,24,CLE,8,0,23,142,6.2,0,17.8,8,69.6,2,2,19,9.5,0,2.4,100,9.5,1,50,25,142,161,161,0,RB
3024,Alex Haynes,3,3,6,2007,25,CAR,10,0,3,3,1,0,0.3,0,0,3,3,14,4.7,0,1.4,100,4.7,2,66.7,6,3,17,17,0,RB
3025,Verron Haynes,0,1,1,2007,28,PIT,1,0,0,0,,0,0,0,,2,1,12,12,0,12,50,6,1,50,1,0,12,12,0,RB
3026,Madison Hedgecock,0,7,7,2007,26,"NYG,STL",16,9,0,0,,0,0,0,,12,7,52,7.4,0,3.3,58.3,4.3,0,0,7,0,52,52,0,FB
3027,Chris Henry,31,6,37,2007,22,TEN,7,0,31,119,3.8,2,17,5,25.8,7,6,53,8.8,0,7.6,85.7,7.6,2,71.4,37,119,172,444,272,RB
3028,Travis Henry,167,7,174,2007,29,DEN,12,7,167,691,4.1,4,57.6,37,46.1,14,7,65,9.3,0,5.4,50,4.6,2,35.7,174,691,756,756,0,RB
3029,Maurice Hicks,21,14,35,2007,29,SFO,16,0,21,117,5.6,1,7.3,3,33.3,16,14,86,6.1,0,5.4,87.5,5.4,3,37.5,35,117,203,1705,1502,RB
3030,Priest Holmes,46,5,51,2007,34,KAN,4,2,46,137,3,0,34.3,6,37,10,5,17,3.4,0,4.3,50,1.7,0,30,51,137,154,154,0,RB
3031,Brad Hoover,12,10,22,2007,31,CAR,16,12,12,39,3.3,0,2.4,4,50,14,10,58,5.8,0,3.6,71.4,4.1,2,35.7,22,39,97,97,0,FB
3032,Oliver Hoyte,0,1,1,2007,23,DAL,10,9,0,0,,0,0,0,,4,1,2,2,0,0.2,25,0.5,1,25,1,0,2,2,0,FB
3033,Tony Hunt,10,0,10,2007,22,PHI,8,0,10,16,1.6,1,2,5,60,0,0,0,,0,0,,,0,,10,16,16,16,0,RB
3034,Brandon Jackson,75,16,91,2007,22,GNB,11,3,75,267,3.6,1,24.3,9,44,22,16,130,8.1,0,11.8,72.7,5.9,6,36.4,91,267,397,397,0,RB
3035,Fred Jackson,58,22,80,2007,26,BUF,8,1,58,300,5.2,0,37.5,12,46.6,30,22,190,8.6,0,23.8,73.3,6.3,8,43.3,80,300,490,536,46,RB
3036,Steven Jackson,237,38,275,2007,24,STL,12,12,237,1002,4.2,5,83.5,37,43.9,52,38,271,7.1,1,22.6,73.1,5.2,13,34.6,275,1004,1273,1273,0,RB
3037,Brandon Jacobs,202,23,225,2007,25,NYG,11,9,202,1009,5,4,91.7,52,55.9,38,23,174,7.6,2,15.8,60.5,4.6,7,36.8,225,1009,1183,1183,0,RB
3038,Edgerrin James,324,24,348,2007,29,ARI,16,16,324,1222,3.8,7,76.4,57,44.8,39,24,204,8.5,0,12.8,61.5,5.2,9,43.6,348,1222,1426,1426,0,RB
3039,Jeremi Johnson,7,6,13,2007,27,CIN,16,9,7,25,3.6,0,1.6,1,14.3,7,6,32,5.3,1,2,85.7,4.6,3,42.9,13,25,57,57,0,FB
3040,Kyle Johnson,0,0,0,2007,29,DEN,1,0,0,0,,0,0,0,,0,0,0,,0,0,,,0,,0,0,0,0,0,RB
3041,Larry Johnson,158,30,188,2007,28,KAN,8,8,158,559,3.5,3,69.9,24,38.6,41,30,186,6.2,1,23.3,73.2,4.5,9,36.6,188,559,745,745,0,RB
3042,Rudi Johnson,170,13,183,2007,28,CIN,11,9,170,497,2.9,3,45.2,27,40,15,13,110,8.5,1,10,86.7,7.3,3,53.3,183,497,607,607,0,RB
3043,Greg Jones,42,11,53,2007,26,JAX,16,11,42,119,2.8,2,7.4,7,47.6,19,11,99,9,2,6.2,57.9,5.2,8,47.4,53,119,218,218,0,FB
3044,Julius Jones,164,23,187,2007,26,DAL,16,16,164,588,3.6,2,36.8,24,36,26,23,203,8.8,0,12.7,88.5,7.8,10,61.5,187,588,791,791,0,RB
3045,Kevin Jones,153,32,185,2007,25,DET,13,10,153,581,3.8,8,44.7,35,45.1,44,32,197,6.2,0,15.2,72.7,4.5,7,43.2,185,581,778,778,0,RB
3046,Thomas Jones,310,28,338,2007,29,NYJ,16,14,310,1119,3.6,1,69.9,57,42.3,34,28,217,7.8,1,13.6,82.4,6.4,8,47.1,338,1119,1336,1336,0,RB
3047,LaMont Jordan,144,28,172,2007,29,OAK,12,7,144,549,3.8,3,45.8,25,36.1,34,28,247,8.8,0,20.6,82.4,7.3,11,58.8,172,549,796,800,0,RB
3048,Mike Karney,11,13,24,2007,26,NOR,16,9,11,17,1.5,2,1.1,4,45.5,19,13,78,6,0,4.9,68.4,4.1,3,52.6,24,17,95,95,0,FB
3049,Kenton Keith,121,13,134,2007,27,IND,16,1,121,533,4.4,3,33.3,42,55.4,23,13,77,5.9,1,4.8,56.5,3.3,3,34.8,134,533,610,625,15,RB
3050,David Kirtman,0,0,0,2007,24,SEA,6,0,0,0,,0,0,0,,0,0,0,,0,0,,,0,,0,0,0,0,0,RB
3051,Dan Kreider,1,1,2,2007,30,PIT,10,4,1,2,2,0,0.2,0,0,3,1,15,15,0,1.5,33.3,5,1,33.3,2,2,17,17,0,FB
3052,John Kuhn,0,2,2,2007,25,GNB,16,1,0,0,,0,0,0,,3,2,7,3.5,0,0.4,66.7,2.3,2,66.7,2,0,7,7,0,FB
3053,Luke Lawton,5,4,9,2007,27,IND,11,0,5,13,2.6,0,1.2,1,40,4,4,29,7.3,1,2.6,100,7.3,2,75,9,13,42,137,95,RB
3054,Vonta Leach,2,25,27,2007,26,HOU,16,12,2,2,1,1,0.1,1,50,33,25,108,4.3,2,6.8,75.8,3.3,6,39.4,27,2,110,136,26,FB
3055,Brian Leonard,86,30,116,2007,23,STL,16,7,86,303,3.5,0,18.9,14,40.7,39,30,183,6.1,0,11.4,76.9,4.7,8,38.5,116,303,486,486,0,FB
3056,Jamal Lewis,298,30,328,2007,28,CLE,15,15,298,1304,4.4,9,86.9,59,42.6,39,30,248,8.3,2,16.5,76.9,6.4,8,53.8,328,1304,1552,1552,0,RB
3057,Marshawn Lynch,280,18,298,2007,21,BUF,13,13,280,1115,4,7,85.8,55,44.3,26,18,184,10.2,0,14.2,69.2,7.1,11,57.7,298,1123,1299,1299,0,RB
3058,Reno Mahe,0,1,1,2007,27,PHI,15,0,0,0,,0,0,0,,1,1,11,11,0,0.7,100,11,1,100,1,0,11,279,268,RB
3059,Laurence Maroney,185,4,189,2007,22,NWE,13,6,185,835,4.5,6,64.2,48,54.6,8,4,116,29,0,8.9,50,14.5,4,50,189,835,951,951,0,RB
3060,Chris Massey,0,0,0,2007,28,STL,16,0,0,0,,0,0,0,,0,0,0,,0,0,,,0,,0,0,0,0,0,RB
3061,Reagan Maui'a,4,2,6,2007,23,MIA,16,9,4,5,1.3,0,0.3,0,0,3,2,5,2.5,0,0.3,66.7,1.7,0,0,6,5,10,14,4,FB
3062,Deuce McAllister,24,4,28,2007,29,NOR,3,3,24,92,3.8,0,30.7,3,41.7,5,4,15,3.8,0,5,80,3,0,40,28,92,107,107,0,RB
3063,Le'Ron McClain,8,9,17,2007,23,BAL,16,11,8,18,2.3,0,1.1,2,25,13,9,55,6.1,1,3.4,69.2,4.2,1,38.5,17,18,73,73,0,FB
3064,Fred McCrary,0,0,0,2007,35,SEA,6,0,0,0,,0,0,0,,0,0,0,,0,0,,,0,,0,0,0,0,0,FB
3065,Willis McGahee,294,43,337,2007,26,BAL,15,15,294,1207,4.1,7,80.5,57,41.5,49,43,231,5.4,1,15.4,87.8,4.7,10,44.9,337,1207,1438,1428,0,RB
3066,Corey McIntyre,0,0,0,2007,28,ATL,14,0,0,0,,0,0,0,,0,0,0,,0,0,,,0,,0,0,0,0,0,FB
3067,Jason McKie,6,9,15,2007,27,CHI,16,11,6,17,2.8,1,1.1,3,66.7,15,9,33,3.7,0,2.1,60,2.2,2,40,15,17,50,50,0,FB
3068,Garrett Mills,0,2,2,2007,24,MIN,1,0,0,0,,0,0,0,,3,2,26,13,0,26,66.7,8.7,2,66.7,2,0,26,26,0,FB
3069,Travis Minor,17,12,29,2007,28,STL,14,0,17,68,4,0,4.9,3,35.3,17,12,86,7.2,0,6.1,70.6,5.1,5,47.1,29,68,154,178,24,RB
3070,Mewelde Moore,20,6,26,2007,25,MIN,12,0,20,113,5.7,0,9.4,6,50,8,6,48,8,0,4,75,6,1,50,26,113,161,311,150,RB
3071,Vernand Morency,29,30,59,2007,27,GNB,13,0,29,108,3.7,0,8.3,5,31,39,30,199,6.6,0,15.3,76.9,5.1,10,41,59,108,307,307,0,RB
3072,Maurice Morris,140,23,163,2007,28,SEA,14,6,140,628,4.5,4,44.9,33,47.1,32,23,213,9.3,1,15.2,71.9,6.7,8,43.8,163,628,841,841,0,RB
3073,Sammy Morris,85,6,91,2007,30,NWE,6,2,85,384,4.5,3,64,24,54.1,8,6,35,5.8,0,5.8,75,4.4,1,37.5,91,384,419,419,0,RB
3074,Ovie Mughelli,6,6,12,2007,27,ATL,16,7,6,7,1.2,1,0.4,2,33.3,10,6,36,6,0,2.3,60,3.6,1,30,12,7,43,71,28,FB
3075,Lorenzo Neal,13,8,21,2007,37,SDG,13,8,13,32,2.5,0,2.5,5,46.2,11,8,23,2.9,1,1.8,72.7,2.1,1,36.4,21,32,55,59,4,FB
3076,Moran Norris,7,6,13,2007,29,SFO,16,5,7,17,2.4,0,1.1,4,57.1,11,6,38,6.3,0,2.4,54.5,3.5,2,27.3,13,17,55,55,0,RB
3077,Jerious Norwood,103,28,131,2007,24,ATL,15,2,103,613,6,1,40.9,25,47.6,39,28,277,9.9,0,18.5,71.8,7.1,12,51.3,131,613,890,2207,1317,RB
3078,Oren O'Neal,0,1,1,2007,24,OAK,14,1,0,0,,0,0,0,,1,1,1,1,0,0.1,100,1,0,0,1,0,1,1,0,FB
3079,Montell Owens,0,0,0,2007,23,JAX,16,0,0,0,,0,0,0,,0,0,0,,0,0,,,0,,0,0,0,0,0,RB
3080,Willie Parker,321,23,344,2007,27,PIT,15,15,321,1316,4.1,2,87.7,48,39.9,31,23,164,7.1,0,10.9,74.2,5.3,7,48.4,344,1316,1480,1480,0,RB
3081,Patrick Pass,0,0,0,2007,29,NYG,1,0,0,0,,0,0,0,,1,0,0,,0,0,0,0,0,0,0,0,0,0,0,FB
3082,Alvin Pearman,0,1,1,2007,25,SEA,3,0,0,0,,0,0,0,,1,1,1,1,0,0.3,100,1,0,0,1,0,1,72,71,RB
3083,Adrian Peterson,151,51,202,2007,28,CHI,16,5,151,510,3.4,3,31.9,28,37.7,65,51,420,8.2,0,26.3,78.5,6.5,15,50.8,202,519,930,945,17,RB
3084,Adrian Peterson,238,19,257,2007,22,MIN,14,9,238,1341,5.6,12,95.8,63,45,28,19,268,14.1,1,19.1,67.9,9.6,14,57.1,257,1341,1609,2021,412,RB
3085,Andrew Pinnock,4,1,5,2007,27,SDG,10,3,4,1,0.3,0,0.1,0,0,4,1,5,5,0,0.5,25,1.3,0,0,5,1,6,6,0,FB
3086,Artose Pinner,5,0,5,2007,29,ATL,7,0,5,46,9.2,0,6.6,2,40,0,0,0,,0,0,,,0,,5,46,46,46,0,RB
3087,Antonio Pittman,38,3,41,2007,22,STL,11,0,38,139,3.7,0,12.6,7,36.8,9,3,15,5,0,1.4,33.3,1.7,0,11.1,41,139,154,154,0,RB
3088,Michael Pittman,68,26,94,2007,32,TAM,10,3,68,286,4.2,0,28.6,14,41.2,39,26,191,7.3,0,19.1,66.7,4.9,10,33.3,94,286,477,477,0,RB
3089,Lousaka Polite,0,0,0,2007,26,CHI,5,0,0,0,,0,0,0,,0,0,0,,0,0,,,0,,0,0,0,0,0,RB
3090,Clinton Portis,325,47,372,2007,26,WAS,16,16,325,1262,3.9,11,78.9,61,45.2,60,47,389,8.3,0,24.3,78.3,6.5,19,50,372,1275,1651,1640,0,RB
3091,Dominic Rhodes,75,11,86,2007,28,OAK,10,2,75,302,4,1,30.2,18,50.7,18,11,70,6.4,0,7,61.1,3.9,1,27.8,86,302,372,684,312,RB
3092,Tony Richardson,7,11,18,2007,36,MIN,14,3,7,13,1.9,0,0.9,3,57.1,16,11,89,8.1,0,6.4,68.8,5.6,4,56.3,18,13,102,102,0,FB
3093,Michael Robinson,26,11,37,2007,24,SFO,15,1,26,121,4.7,0,8.1,7,38.5,13,11,73,6.6,0,4.9,84.6,5.6,4,46.2,37,121,194,245,51,FB
3094,Cory Ross,12,0,12,2007,25,BAL,6,0,12,72,6,1,12,3,25,0,0,0,,0,0,,,0,,12,72,72,256,184,RB
3095,Gary Russell,7,0,7,2007,21,PIT,3,0,7,21,3,0,7,1,42.9,0,0,0,,0,0,,,0,,7,21,21,21,0,RB
3096,B.J. Sams,0,0,0,2007,27,BAL,1,0,0,0,,0,0,0,,0,0,0,,0,0,,,0,,0,0,0,177,177,RB
3097,Cecil Sapp,18,14,32,2007,29,DEN,16,8,18,59,3.3,2,3.7,5,44.4,20,14,51,3.6,1,3.2,70,2.6,3,25,32,59,110,140,30,FB
3098,Josh Scobey,0,0,0,2007,28,"BUF,SEA",7,0,0,0,,0,0,0,,0,0,0,,0,0,,,0,,0,0,0,112,112,RB
3099,Mike Sellers,26,17,43,2007,32,WAS,14,12,26,78,3,2,5.6,9,61.5,24,17,117,6.9,1,8.4,70.8,4.9,8,37.5,43,78,195,195,0,FB
3100,Marcel Shipp,15,4,19,2007,29,ARI,16,0,15,41,2.7,1,2.6,5,40,15,4,25,6.3,0,1.6,26.7,1.7,0,20,19,41,66,66,0,RB
3101,Kolby Smith,112,22,134,2007,23,KAN,16,6,112,407,3.6,2,25.4,27,49.1,30,22,148,6.7,0,9.3,73.3,4.9,7,40,134,407,555,555,0,FB
3102,Musa Smith,75,27,102,2007,25,BAL,16,1,75,264,3.5,2,16.5,15,29.3,34,27,192,7.1,0,12,79.4,5.6,8,44.1,102,264,456,545,89,RB
3103,Paul Smith,0,0,0,2007,29,DEN,14,0,0,0,,0,0,0,,1,0,0,,0,0,0,0,0,0,0,0,0,0,0,RB
3104,Terrelle Smith,1,7,8,2007,29,ARI,16,10,1,3,3,0,0.2,0,0,11,7,59,8.4,0,3.7,63.6,5.4,4,45.5,8,3,62,62,0,FB
3105,Jason Snelling,13,0,13,2007,24,ATL,7,0,13,43,3.3,1,6.1,6,53.8,0,0,0,,0,0,,,0,,13,43,43,43,0,RB
3106,Darren Sproles,37,10,47,2007,24,SDG,15,0,37,164,4.4,2,10.9,6,40.5,12,10,31,3.1,0,2.1,83.3,2.6,3,25,47,164,195,1432,1237,RB
3107,Aaron Stecker,115,36,151,2007,32,NOR,16,6,115,448,3.9,5,28,28,47.8,43,36,211,5.9,0,13.2,83.7,4.9,12,51.2,151,448,659,796,137,RB
3108,Byron Storer,0,2,2,2007,23,TAM,9,3,0,0,,0,0,0,,3,2,3,1.5,0,0.3,66.7,1,0,0,2,0,3,3,0,RB
3109,Mack Strong,4,9,13,2007,36,SEA,5,2,4,19,4.8,0,3.8,1,25,12,9,72,8,0,14.4,75,6,5,75,13,19,91,91,0,FB
3110,Naufahu Tahi,6,1,7,2007,26,MIN,10,0,6,15,2.5,0,1.5,0,0,1,1,7,7,0,0.7,100,7,0,0,7,15,22,22,0,RB
3111,Thomas Tapeh,5,8,13,2007,27,PHI,16,8,5,18,3.6,0,1.1,3,60,11,8,50,6.3,0,3.1,72.7,4.5,1,36.4,13,18,68,68,0,FB
3112,Chester Taylor,157,29,186,2007,28,MIN,14,8,157,844,5.4,7,60.3,36,43.9,43,29,281,9.7,0,20.1,67.4,6.5,12,39.5,186,844,1125,1125,0,RB
3113,Fred Taylor,223,9,232,2007,31,JAX,15,15,223,1202,5.4,5,80.1,45,44.4,14,9,58,6.4,0,3.9,64.3,4.1,2,35.7,232,1202,1260,1260,0,RB
3114,Anthony Thomas,36,15,51,2007,30,BUF,10,2,36,89,2.5,0,8.9,4,44.4,20,15,95,6.3,1,9.5,75,4.8,3,40,51,89,184,210,26,RB
3115,Pierre Thomas,52,17,69,2007,23,NOR,12,1,52,252,4.8,1,21,15,53.8,23,17,151,8.9,1,12.6,73.9,6.6,10,65.2,69,252,403,1273,865,RB
3116,Tyson Thompson,14,0,14,2007,26,DAL,8,0,14,54,3.9,0,6.8,3,21.4,0,0,0,,0,0,,,0,,14,54,54,525,471,RB
3117,LaBrandon Toefield,13,1,14,2007,27,JAX,2,1,13,27,2.1,1,13.5,2,23.1,1,1,4,4,0,2,100,4,0,100,14,27,31,88,57,RB
3118,LaDainian Tomlinson,315,60,375,2007,28,SDG,16,16,315,1474,4.7,15,92.1,75,44.1,86,60,475,7.9,3,29.7,69.8,5.5,20,38.4,375,1491,1949,1949,0,RB
3119,Michael Turner,71,4,75,2007,25,SDG,16,0,71,316,4.5,1,19.8,11,28.2,7,4,16,4,0,1,57.1,2.3,1,28.6,75,316,332,471,139,RB
3120,Stacy Tutt,0,0,0,2007,25,NYJ,9,0,0,0,,0,0,0,,1,0,0,,0,0,0,0,0,0,0,0,0,0,0,RB
3121,Lawrence Vickers,15,13,28,2007,24,CLE,16,14,15,43,2.9,0,2.7,10,73.3,24,13,91,7,2,5.7,54.2,3.8,7,45.8,28,43,134,134,0,FB
3122,Darius Walker,58,13,71,2007,22,HOU,4,2,58,264,4.6,1,66,14,44.8,15,13,81,6.2,0,20.3,86.7,5.4,5,66.7,71,264,345,345,0,RB
3123,Derrick Ward,125,26,151,2007,27,NYG,8,5,125,602,4.8,3,75.3,29,46.4,40,26,179,6.9,1,22.4,65,4.5,7,37.5,151,602,781,781,0,RB
3124,Danny Ware,0,0,0,2007,22,NYG,1,0,0,0,,0,0,0,,0,0,0,,0,0,,,0,,0,0,0,0,0,RB
3125,Leon Washington,71,36,107,2007,25,NYJ,16,4,71,353,5,3,22.1,12,36.6,51,36,213,5.9,0,13.3,70.6,4.2,15,43.1,107,389,566,2040,1474,RB
3126,Kenny Watson,178,52,230,2007,29,CIN,16,5,178,763,4.3,7,47.7,42,55.1,67,52,374,7.2,0,23.4,77.6,5.6,13,40.3,230,763,1137,1137,0,FB
3127,Leonard Weaver,33,39,72,2007,25,SEA,16,4,33,146,4.4,1,9.1,13,60.6,52,39,313,8,0,19.6,75,6,15,46.2,72,146,459,459,0,RB
3128,Brian Westbrook,278,90,368,2007,28,PHI,15,15,278,1333,4.8,7,88.9,74,51.1,118,90,771,8.6,5,51.4,76.3,6.5,32,50,368,1333,2104,2183,79,RB
3129,LenDale White,303,20,323,2007,23,TEN,16,16,303,1110,3.7,7,69.4,60,44.6,31,20,114,5.7,0,7.1,64.5,3.7,7,38.7,323,1110,1224,1224,0,RB
3130,Cadillac Williams,54,3,57,2007,25,TAM,4,4,54,208,3.9,3,52,12,51.9,5,3,17,5.7,0,4.3,60,3.4,0,40,57,208,225,225,0,RB
3131,DeAngelo Williams,144,23,167,2007,24,CAR,16,0,144,717,5,4,44.8,30,39.6,38,23,175,7.6,1,10.9,60.5,4.6,5,34.2,167,717,892,1123,231,RB
3132,Ricky Williams,6,0,6,2007,30,MIA,1,0,6,15,2.5,0,15,2,50,0,0,0,,0,0,,,0,,6,15,15,15,0,RB
3133,Kris Wilson,3,24,27,2007,26,KAN,16,12,3,7,2.3,0,0.4,1,33.3,50,24,180,7.5,1,11.3,48,3.6,8,28,27,7,187,187,0,FB
3134,Quincy Wilson,0,0,0,2007,26,CIN,1,0,0,0,,0,0,0,,0,0,0,,0,0,,,0,,0,0,0,0,0,RB
3135,Garrett Wolfe,31,9,40,2007,23,CHI,13,0,31,85,2.7,0,6.5,5,22.6,13,9,117,13,0,9,69.2,9,4,46.2,40,85,202,229,27,RB
3136,Dwayne Wright,29,3,32,2007,24,BUF,15,0,29,94,3.2,0,6.3,6,44.8,3,3,17,5.7,0,1.1,100,5.7,1,66.7,32,94,111,111,0,RB
3137,Jason Wright,60,24,84,2007,25,CLE,16,1,60,277,4.6,1,17.3,19,50,37,24,233,9.7,0,14.6,64.9,6.3,14,48.6,84,277,510,559,49,RB
3138,DeShawn Wynn,50,9,59,2007,24,GNB,7,4,50,203,4.1,4,29,10,36,14,9,73,8.1,0,10.4,64.3,5.2,4,42.9,59,203,276,291,15,RB
3139,Selvin Young,140,35,175,2007,24,DEN,15,8,140,729,5.2,1,48.6,24,42.1,43,35,231,6.6,0,15.4,81.4,5.4,9,44.2,175,729,960,1016,56,RB
3140,Joseph Addai,226,40,266,2006,23,IND,16,0,226,1081,4.8,7,67.6,67,60.2,50,40,325,8.1,1,20.3,80,6.5,20,62,266,1078,1406,1404,0,RB
3141,Rich Alexis,3,0,3,2006,25,JAX,1,0,3,5,1.7,0,5,0,0,0,0,0,,0,0,,,0,,3,5,5,5,0,RB
3142,Shaun Alexander,252,12,264,2006,29,SEA,10,10,252,896,3.6,7,89.6,54,40.9,16,12,48,4,0,4.8,75,3,4,31.3,264,896,944,944,0,RB
3143,Mike Alstott,60,21,81,2006,33,TAM,16,15,60,171,2.9,3,10.7,17,48.3,38,21,85,4,0,5.3,55.3,2.2,7,23.7,81,171,256,256,0,FB
3144,Mike Anderson,39,9,48,2006,33,BAL,16,0,39,183,4.7,1,11.4,10,41,14,9,54,6,0,3.4,64.3,3.9,2,14.3,48,183,237,237,0,RB
3145,J.J. Arrington,14,8,22,2006,23,ARI,16,0,14,19,1.4,0,1.2,0,7.1,10,8,58,7.3,0,3.6,80,5.8,4,50,22,19,77,1597,1520,RB
3146,B.J. Askew,6,9,15,2006,26,NYJ,13,5,6,11,1.8,0,0.8,1,33.3,12,9,50,5.6,0,3.8,75,4.2,4,41.7,15,11,61,61,0,FB
3147,Obafemi Ayanbadejo,9,17,26,2006,31,ARI,14,0,9,37,4.1,0,2.6,5,66.7,19,17,139,8.2,0,9.9,89.5,7.3,7,47.4,26,37,176,176,0,RB
3148,Marion Barber III,135,23,158,2006,23,DAL,16,1,135,654,4.8,14,40.9,45,55.6,32,23,196,8.5,2,12.3,71.9,6.1,8,37.5,158,654,850,850,0,RB
3149,Tiki Barber,327,58,385,2006,31,NYG,16,16,327,1662,5.1,5,103.9,79,47.1,75,58,465,8,0,29.1,77.3,6.2,24,53.3,385,1662,2127,2127,0,RB
3150,Kevan Barlow,131,7,138,2006,27,NYJ,12,3,131,370,2.8,6,30.8,21,42,10,7,21,3,0,1.8,70,2.1,1,30,138,370,391,391,0,RB
3151,Darian Barnes,0,3,3,2006,26,MIA,16,6,0,0,,0,0,0,,7,3,22,7.3,0,1.4,42.9,3.1,1,14.3,3,0,22,22,0,FB
3152,Mike Bell,157,20,177,2006,23,DEN,15,3,157,677,4.3,8,45.1,43,49.7,27,20,158,7.9,0,10.5,74.1,5.9,5,29.6,177,677,835,932,97,RB
3153,Tatum Bell,233,24,257,2006,25,DEN,13,13,233,1025,4.4,2,78.8,47,39.5,31,24,115,4.8,0,8.8,77.4,3.7,5,29,257,1025,1140,1140,0,RB
3154,Michael Bennett,36,9,45,2006,28,KAN,11,0,36,200,5.6,0,18.2,8,50,12,9,77,8.6,0,7,75,6.4,1,50,45,200,277,277,0,RB
3155,Cedric Benson,157,8,165,2006,24,CHI,15,0,157,647,4.1,6,43.1,35,43.3,10,8,54,6.8,0,3.6,80,5.4,2,50,165,647,701,701,0,RB
3156,Ladell Betts,245,53,298,2006,27,WAS,16,9,245,1154,4.7,4,72.1,60,46.5,64,53,445,8.4,1,27.8,82.8,7,22,43.8,298,1154,1599,1626,27,RB
3157,Derrick Blaylock,25,5,30,2006,27,NYJ,4,2,25,44,1.8,0,11,0,20,9,5,29,5.8,0,7.3,55.6,3.2,1,33.3,30,44,73,73,0,RB
3158,Jamaal Branch,10,5,15,2006,25,NOR,1,0,10,29,2.9,0,29,2,30,6,5,14,2.8,1,14,83.3,2.3,1,16.7,15,29,43,43,0,RB
3159,Nehemiah Broughton,0,0,0,2006,24,WAS,2,0,0,0,,0,0,0,,0,0,0,,0,0,,,0,,0,0,0,0,0,FB
3160,Chris Brown,41,2,43,2006,25,TEN,5,3,41,156,3.8,0,31.2,8,41.5,9,2,4,2,0,0.8,22.2,0.4,0,0,43,156,160,160,0,RB
3161,Dee Brown,10,1,11,2006,28,KAN,15,0,10,24,2.4,0,1.6,1,20,1,1,5,5,0,0.3,100,5,0,0,11,24,29,29,0,RB
3162,Ronnie Brown,241,33,274,2006,25,MIA,13,12,241,1008,4.2,5,77.5,50,44.8,38,33,276,8.4,0,21.2,86.8,7.3,12,52.6,274,1008,1284,1268,0,RB
3163,Shawn Bryson,2,8,10,2006,30,DET,6,1,2,1,0.5,0,0.2,0,0,9,8,98,12.3,1,16.3,88.9,10.9,5,66.7,10,1,99,99,0,RB
3164,Correll Buckhalter,83,24,107,2006,28,PHI,16,1,83,345,4.2,2,21.6,16,54.2,28,24,256,10.7,1,16,85.7,9.1,11,57.1,107,345,601,601,0,RB
3165,Reggie Bush,155,88,243,2006,21,NOR,16,8,155,565,3.6,6,35.3,28,43.9,121,88,742,8.4,2,46.4,72.7,6.1,34,43.8,243,565,1307,1523,216,RB
3166,Brian Calhoun,7,2,9,2006,22,DET,7,0,7,19,2.7,0,2.7,0,14.3,2,2,20,10,0,2.9,100,10,1,50,9,19,39,39,0,RB
3167,Ran Carthon,3,0,3,2006,25,IND,3,0,3,4,1.3,1,1.3,1,33.3,0,0,0,,0,0,,,0,,3,4,4,25,21,RB
3168,Rock Cartwright,5,0,5,2006,27,WAS,16,0,5,15,3,0,0.9,0,0,0,0,0,,0,0,,,0,,5,15,15,1556,1541,FB
3169,Aveion Cason,24,5,29,2006,27,DET,6,2,24,94,3.9,0,15.7,4,45.8,10,5,26,5.2,0,4.3,50,2.6,1,10,29,94,120,230,110,RB
3170,Cedric Cobbs,3,0,3,2006,25,DEN,2,0,3,9,3,0,4.5,0,0,0,0,0,,0,0,,,0,,3,9,9,9,0,RB
3171,Patrick Cobbs,0,0,0,2006,23,MIA,3,0,0,0,,0,0,0,,0,0,0,,0,0,,,0,,0,0,0,0,0,RB
3172,Jameel Cook,3,18,21,2006,27,HOU,11,6,3,18,6,0,1.6,2,66.7,26,18,107,5.9,0,9.7,69.2,4.1,6,42.3,21,18,125,127,2,FB
3173,Zack Crockett,39,10,49,2006,34,OAK,16,9,39,163,4.2,0,10.2,14,64.1,17,10,53,5.3,0,3.3,58.8,3.1,1,35.3,49,163,216,209,0,FB
3174,Ronnie Cruz,5,2,7,2006,25,KAN,5,3,5,19,3.8,0,3.8,0,60,5,2,20,10,0,4,40,4,2,40,7,19,39,46,7,RB
3175,Najeh Davenport,60,15,75,2006,27,PIT,13,0,60,221,3.7,1,17,10,31.7,21,15,193,12.9,1,14.8,71.4,9.2,9,47.6,75,221,414,862,448,RB
3176,Stephen Davis,40,12,52,2006,32,STL,15,0,40,177,4.4,0,11.8,10,47.5,17,12,90,7.5,1,6,70.6,5.3,5,41.2,52,177,267,267,0,RB
3177,Ron Dayne,151,14,165,2006,28,HOU,11,6,151,612,4.1,5,55.6,40,52.3,18,14,77,5.5,0,7,77.8,4.3,3,38.9,165,612,689,689,0,RB
3178,Corey Dillon,199,15,214,2006,32,NWE,16,13,199,812,4.1,13,50.8,49,49.2,16,15,147,9.8,0,9.2,93.8,9.2,5,62.5,214,812,959,959,0,RB
3179,De Dorsey,0,0,0,2006,22,IND,13,0,0,0,,0,0,0,,0,0,0,,0,0,,,0,,0,0,0,4,4,RB
3180,Maurice Jones-Drew,166,46,212,2006,21,JAX,16,1,166,941,5.7,13,58.8,46,48.8,62,46,436,9.5,2,27.3,74.2,7,17,43.5,212,941,1377,2250,873,RB
3181,Reuben Droughns,220,27,247,2006,28,CLE,14,12,220,758,3.4,4,54.1,38,40.9,33,27,169,6.3,0,12.1,81.8,5.1,10,48.5,247,758,927,927,0,RB
3182,T.J. Duckett,38,2,40,2006,25,WAS,10,0,38,132,3.5,2,13.2,9,36.8,2,2,16,8,0,1.6,100,8,1,50,40,132,148,148,0,RB
3183,Kevin Dudley,0,0,0,2006,24,ATL,1,0,0,0,,0,0,0,,0,0,0,,0,0,,,0,,0,0,0,0,0,RB
3184,Jeff Dugan,0,8,8,2006,25,MIN,7,7,0,0,,0,0,0,,13,8,40,5,1,5.7,61.5,3.1,5,46.2,8,0,40,40,0,FB
3185,Warrick Dunn,286,22,308,2006,31,ATL,16,16,286,1140,4,4,71.3,48,38.8,28,22,170,7.7,1,10.6,78.6,6.1,10,50,308,1140,1310,1310,0,RB
3186,Adimchinobe Echemandu,0,0,0,2006,26,OAK,4,0,0,0,,0,0,0,,0,0,0,,0,0,,,0,,0,0,0,0,0,RB
3187,Heath Evans,27,7,34,2006,28,NWE,16,3,27,117,4.3,0,7.3,9,51.9,9,7,34,4.9,1,2.1,77.8,3.8,2,22.2,34,117,151,151,0,FB
3188,Justin Fargas,178,13,191,2006,26,OAK,16,6,178,659,3.7,1,41.2,29,39.3,21,13,91,7,0,5.7,61.9,4.3,3,42.9,191,659,750,743,0,RB
3189,Ciatrick Fason,18,3,21,2006,24,MIN,5,0,18,99,5.5,1,19.8,6,50,5,3,19,6.3,0,3.8,60,3.8,1,40,21,99,118,118,0,RB
3190,Kevin Faulk,25,43,68,2006,30,NWE,15,1,25,123,4.9,1,8.2,6,44,56,43,356,8.3,2,23.7,76.8,6.4,15,50,68,123,479,1173,694,RB
3191,Jim Finn,2,8,10,2006,30,NYG,16,11,2,14,7,0,0.9,0,0,13,8,54,6.8,0,3.4,61.5,4.2,4,53.8,10,14,68,68,0,FB
3192,Tony Fisher,6,14,20,2006,27,STL,8,0,6,9,1.5,0,1.1,0,16.7,18,14,159,11.4,0,19.9,77.8,8.8,5,27.8,20,9,168,333,165,RB
3193,J.P. Foschi,0,0,0,2006,24,OAK,1,0,0,0,,0,0,0,,0,0,0,,0,0,,,0,,0,0,0,0,0,FB
3194,DeShaun Foster,227,32,259,2006,26,CAR,14,14,227,897,4,3,64.1,49,45.4,46,32,159,5,0,11.4,69.6,3.5,3,26.1,259,897,1056,1058,0,RB
3195,Samkon Gado,56,17,73,2006,24,"GNB,HOU",9,1,56,210,3.8,1,23.3,11,35.7,23,17,85,5,0,9.4,73.9,3.7,3,26.1,73,210,295,352,57,RB
3196,Quinton Ganther,0,0,0,2006,22,TEN,2,0,0,0,,0,0,0,,0,0,0,,0,0,,,0,,0,0,0,0,0,RB
3197,Nick Goings,11,10,21,2006,28,CAR,11,0,11,52,4.7,0,4.7,2,18.2,15,10,107,10.7,1,9.7,66.7,7.1,4,53.3,21,52,159,377,218,RB
3198,Lamar Gordon,1,0,1,2006,26,DET,1,0,1,2,2,0,2,0,0,0,0,0,,0,0,,,0,,1,2,2,2,0,RB
3199,Frank Gore,312,61,373,2006,23,SFO,16,16,312,1695,5.4,8,105.9,67,46.5,86,61,485,8,1,30.3,70.9,5.6,23,48.8,373,1695,2180,2180,0,RB
3200,Earnest Graham,11,1,12,2006,26,TAM,16,0,11,59,5.4,0,3.7,2,54.5,4,1,4,4,0,0.3,25,1,0,25,12,59,63,76,13,RB
3201,Ahman Green,266,46,312,2006,29,GNB,14,14,266,1059,4,5,75.6,55,40.6,63,46,373,8.1,1,26.6,73,5.9,14,42.9,312,1059,1432,1432,0,RB
3202,Justin Green,0,4,4,2006,24,BAL,12,3,0,0,,0,0,0,,4,4,17,4.3,0,1.4,100,4.3,1,25,4,0,17,17,0,FB
3203,Justin Griffith,19,23,42,2006,26,ATL,16,11,19,106,5.6,1,6.6,2,52.6,28,23,168,7.3,3,10.5,82.1,6,12,53.6,42,106,274,274,0,FB
3204,Ahmard Hall,7,15,22,2006,27,TEN,14,7,7,21,3,0,1.5,3,57.1,21,15,138,9.2,0,9.9,71.4,6.6,6,42.9,22,21,159,159,0,FB
3205,Justin Hamilton,0,0,0,2006,24,CLE,10,0,0,0,,0,0,0,,0,0,0,,0,0,,,0,,0,0,0,0,0,RB
3206,Arlen Harris,49,18,67,2006,26,DET,10,3,49,158,3.2,1,15.8,8,38.8,25,18,132,7.3,0,13.2,72,5.3,4,44,67,158,290,290,0,RB
3207,Jerome Harrison,20,9,29,2006,23,CLE,10,1,20,60,3,0,6,4,30,14,9,47,5.2,0,4.7,64.3,3.4,1,35.7,29,60,107,107,0,RB
3208,Kay-Jay Harris,3,1,4,2006,27,STL,7,0,3,9,3,0,1.3,0,0,1,1,10,10,0,1.4,100,10,1,100,4,9,19,95,76,RB
3209,Verron Haynes,15,18,33,2006,27,PIT,7,0,15,78,5.2,0,11.1,4,60,22,18,95,5.3,0,13.6,81.8,4.3,4,27.3,33,78,173,173,0,RB
3210,Madison Hedgecock,1,7,8,2006,25,STL,16,9,1,2,2,0,0.1,1,100,10,7,29,4.1,0,1.8,70,2.9,1,50,8,2,31,31,0,FB
3211,William Henderson,0,12,12,2006,35,GNB,14,9,0,0,,0,0,0,,18,12,62,5.2,0,4.4,66.7,3.4,3,38.9,12,0,62,103,41,FB
3212,Travis Henry,270,18,288,2006,28,TEN,14,13,270,1211,4.5,7,86.5,50,42.6,25,18,78,4.3,0,5.6,72,3.1,2,20,288,1211,1289,1289,0,RB
3213,Noah Herron,37,29,66,2006,24,GNB,16,0,37,150,4.1,1,9.4,7,48.6,35,29,211,7.3,2,13.2,82.9,6,12,51.4,66,150,361,504,143,RB
3214,Chris Hetherington,0,2,2,2006,34,SFO,3,2,0,0,,0,0,0,,2,2,0,0,0,0,100,0,0,0,2,0,0,0,0,FB
3215,Maurice Hicks,29,13,42,2006,28,SFO,16,0,29,82,2.8,0,5.1,4,41.4,15,13,137,10.5,1,8.6,86.7,9.1,6,60,42,82,219,1647,1428,RB
3216,James Hodgins,0,2,2,2006,29,NYJ,6,0,0,0,,0,0,0,,5,2,9,4.5,0,1.5,40,1.8,0,0,2,0,9,26,17,FB
3217,Brad Hoover,22,20,42,2006,30,CAR,16,12,22,73,3.3,1,4.6,10,54.5,29,20,122,6.1,0,7.6,69,4.2,4,34.5,42,73,195,232,37,FB
3218,Cedric Houston,113,7,120,2006,24,NYJ,8,1,113,374,3.3,5,46.8,21,44.2,8,7,43,6.1,0,5.4,87.5,5.4,1,37.5,120,374,417,417,0,RB
3219,Oliver Hoyte,0,2,2,2006,22,DAL,12,5,0,0,,0,0,0,,2,2,10,5,0,0.8,100,5,0,0,2,0,10,10,0,FB
3220,Marlion Jackson,1,0,1,2006,29,ATL,1,0,1,2,2,0,2,0,0,0,0,0,,0,0,,,0,,1,2,2,2,0,RB
3221,Steven Jackson,346,90,436,2006,23,STL,16,16,346,1528,4.4,13,95.5,73,46.5,110,90,806,9,3,50.4,81.8,7.3,32,51.8,436,1528,2334,2334,0,RB
3222,Brandon Jacobs,96,11,107,2006,24,NYG,15,0,96,423,4.4,9,28.2,32,57.3,14,11,149,13.5,0,9.9,78.6,10.6,3,50,107,423,572,630,58,RB
3223,Edgerrin James,337,38,375,2006,28,ARI,16,16,337,1159,3.4,6,72.4,61,45.1,61,38,217,5.7,0,13.6,62.3,3.6,10,39.3,375,1159,1376,1376,0,RB
3224,Jeremi Johnson,15,6,21,2006,26,CIN,16,11,15,56,3.7,1,3.5,3,53.3,9,6,37,6.2,0,2.3,66.7,4.1,2,22.2,21,56,93,93,0,FB
3225,Kyle Johnson,5,7,12,2006,28,DEN,14,7,5,30,6,0,2.1,1,40,11,7,37,5.3,1,2.6,63.6,3.4,2,36.4,12,30,67,81,14,FB
3226,Larry Johnson,416,41,457,2006,27,KAN,16,16,416,1789,4.3,17,111.8,91,44.7,66,41,410,10,2,25.6,62.1,6.2,21,37.9,457,1789,2199,2199,0,RB
3227,Rudi Johnson,341,23,364,2006,27,CIN,16,15,341,1309,3.8,12,81.8,70,42.5,31,23,124,5.4,0,7.8,74.2,4,5,48.4,364,1309,1433,1433,0,RB
3228,Julius Jones,267,9,276,2006,25,DAL,16,16,267,1084,4.1,4,67.8,48,44.9,15,9,142,15.8,0,8.9,60,9.5,7,60,276,1084,1226,1226,0,RB
3229,Kevin Jones,181,61,242,2006,24,DET,12,12,181,689,3.8,6,57.4,31,39.2,78,61,520,8.5,2,43.3,78.2,6.7,26,59,242,689,1209,1209,0,RB
3230,Thomas Jones,296,36,332,2006,28,CHI,16,16,296,1210,4.1,6,75.6,63,47.3,47,36,154,4.3,0,9.6,76.6,3.3,6,31.9,332,1205,1364,1364,0,RB
3231,LaMont Jordan,114,10,124,2006,28,OAK,9,8,114,434,3.8,2,48.2,18,35.1,16,10,74,7.4,0,8.2,62.5,4.6,4,37.5,124,434,508,508,0,RB
3232,Keith Joseph,0,0,0,2006,25,NOR,1,0,0,0,,0,0,0,,0,0,0,,0,0,,,0,,0,0,0,0,0,RB
3233,Mike Karney,11,15,26,2006,25,NOR,15,7,11,33,3,1,2.2,7,72.7,20,15,96,6.4,2,6.4,75,4.8,6,65,26,33,129,139,10,FB
3234,Keylon Kincade,4,0,4,2006,24,DAL,1,0,4,9,2.3,0,9,0,0,0,0,0,,0,0,,,0,,4,9,9,9,0,RB
3235,Dan Kreider,1,8,9,2006,29,PIT,16,12,1,5,5,0,0.3,0,100,13,8,62,7.8,0,3.9,61.5,4.8,2,46.2,9,5,67,67,0,FB
3236,John Kuhn,2,1,3,2006,24,PIT,9,0,2,18,9,0,2,1,50,1,1,15,15,0,1.7,100,15,1,100,3,18,33,33,0,FB
3237,Vonta Leach,0,6,6,2006,25,"GNB,HOU",12,5,0,0,,0,0,0,,7,6,61,10.2,1,5.1,85.7,8.7,5,71.4,6,0,61,61,0,RB
3238,ReShard Lee,21,20,41,2006,26,OAK,16,3,21,72,3.4,2,4.5,7,52.4,25,20,138,6.9,0,8.6,80,5.5,8,48,41,72,210,259,49,RB
3239,Jamal Lewis,314,18,332,2006,27,BAL,16,16,314,1132,3.6,9,70.8,48,39.8,26,18,115,6.4,0,7.2,69.2,4.4,5,42.3,332,1132,1247,1247,0,RB
3240,Wali Lundy,124,33,157,2006,23,HOU,14,8,124,476,3.8,4,34,29,39.5,39,33,204,6.2,0,14.6,84.6,5.2,7,38.5,157,467,680,747,67,RB
3241,Reno Mahe,4,5,9,2006,26,PHI,12,1,4,18,4.5,0,1.5,0,25,6,5,23,4.6,0,1.9,83.3,3.8,1,33.3,9,18,41,877,836,RB
3242,Laurence Maroney,175,22,197,2006,21,NWE,14,0,175,745,4.3,6,53.2,42,43.4,30,22,194,8.8,1,13.9,73.3,6.5,11,50,197,745,939,1722,783,RB
3243,Jamar Martin,0,0,0,2006,26,NYJ,2,0,0,0,,0,0,0,,0,0,0,,0,0,,,0,,0,0,0,0,0,FB
3244,Chris Massey,0,0,0,2006,27,STL,16,0,0,0,,0,0,0,,0,0,0,,0,0,,,0,,0,0,0,0,0,RB
3245,Fred McAfee,3,0,3,2006,38,NOR,4,0,3,12,4,1,3,1,33.3,0,0,0,,0,0,,,0,,3,12,12,32,20,RB
3246,Deuce McAllister,244,30,274,2006,28,NOR,15,13,244,1057,4.3,10,70.5,53,49.6,36,30,198,6.6,0,13.2,83.3,5.5,9,50,274,1057,1255,1259,0,RB
3247,Fred McCrary,0,3,3,2006,34,ATL,15,0,0,0,,0,0,0,,4,3,13,4.3,1,0.9,75,3.3,2,75,3,0,13,30,17,FB
3248,Willis McGahee,259,18,277,2006,25,BUF,14,14,259,990,3.8,6,70.7,50,45.2,28,18,156,8.7,0,11.1,64.3,5.6,4,39.3,277,990,1146,1146,0,RB
3249,Sean McHugh,0,3,3,2006,24,DET,6,2,0,0,,0,0,0,,5,3,25,8.3,0,4.2,60,5,2,60,3,0,25,25,0,FB
3250,Corey McIntyre,0,1,1,2006,27,NOR,4,0,0,0,,0,0,0,,2,1,10,10,0,2.5,50,5,1,50,1,0,10,10,0,FB
3251,Jason McKie,8,25,33,2006,26,CHI,15,12,8,18,2.3,0,1.2,0,25,38,25,162,6.5,0,10.8,65.8,4.3,7,39.5,33,18,180,191,11,FB
3252,Travis Minor,19,3,22,2006,27,MIA,16,0,19,74,3.9,0,4.6,3,36.8,3,3,2,0.7,0,0.1,100,0.7,0,0,22,74,76,93,17,RB
3253,Brandon Miree,0,9,9,2006,25,GNB,10,3,0,0,,0,0,0,,13,9,57,6.3,0,5.7,69.2,4.4,3,38.5,9,0,57,57,0,RB
3254,Ryan Moats,22,0,22,2006,24,PHI,8,0,22,69,3.1,0,8.6,5,45.5,1,0,0,,0,0,0,0,0,0,22,69,69,112,43,RB
3255,Mewelde Moore,24,46,70,2006,24,MIN,16,0,24,131,5.5,0,8.2,4,33.3,62,46,468,10.2,1,29.3,74.2,7.5,15,29,70,146,599,995,390,RB
3256,Vernand Morency,96,17,113,2006,26,"GNB,HOU",14,2,96,434,4.5,2,31,26,37.5,19,17,118,6.9,0,8.4,89.5,6.2,5,52.6,113,434,552,1222,670,RB
3257,Maurice Morris,161,11,172,2006,27,SEA,16,8,161,604,3.8,0,37.8,34,36.6,20,11,46,4.2,0,2.9,55,2.3,2,30,172,604,650,650,0,RB
3258,Sammy Morris,92,21,113,2006,29,MIA,12,4,92,400,4.3,1,33.3,17,41.3,35,21,162,7.7,0,13.5,60,4.6,8,34.3,113,400,562,562,0,RB
3259,Chad Morton,1,0,1,2006,29,NYG,15,0,1,22,22,0,1.5,1,100,0,0,0,,0,0,,,0,,1,22,22,960,938,RB
3260,Ovie Mughelli,12,21,33,2006,26,BAL,16,8,12,50,4.2,0,3.1,4,58.3,24,21,182,8.7,2,11.4,87.5,7.6,7,62.5,33,50,232,232,0,FB
3261,Damien Nash,18,4,22,2006,24,DEN,3,0,18,66,3.7,0,22,2,33.3,7,4,41,10.3,0,13.7,57.1,5.9,2,42.9,22,66,107,107,0,RB
3262,Lorenzo Neal,29,17,46,2006,36,SDG,16,11,29,140,4.8,1,8.8,21,75.9,26,17,83,4.9,0,5.2,65.4,3.2,3,34.6,46,140,223,234,11,FB
3263,Moran Norris,2,5,7,2006,28,SFO,14,7,2,8,4,0,0.6,1,100,7,5,36,7.2,2,2.6,71.4,5.1,3,42.9,7,8,44,45,1,FB
3264,Jerious Norwood,99,12,111,2006,23,ATL,14,0,99,633,6.4,2,45.2,27,47.5,15,12,102,8.5,0,7.3,80,6.8,4,53.3,111,633,735,1055,320,RB
3265,Montell Owens,0,0,0,2006,22,JAX,14,0,0,0,,0,0,0,,0,0,0,,0,0,,,0,,0,0,0,4,4,RB
3266,Willie Parker,337,31,368,2006,26,PIT,16,16,337,1494,4.4,13,93.4,72,44.5,42,31,222,7.2,3,13.9,73.8,5.3,12,35.7,368,1494,1716,1716,0,RB
3267,Josh Parry,0,1,1,2006,28,SEA,8,0,0,0,,0,0,0,,2,1,11,11,0,1.4,50,5.5,1,50,1,0,11,11,0,RB
3268,Patrick Pass,6,2,8,2006,28,NWE,3,0,6,21,3.5,0,7,1,83.3,2,2,24,12,0,8,100,12,1,50,8,21,45,45,0,FB
3269,Alvin Pearman,19,2,21,2006,24,JAX,13,0,19,89,4.7,1,6.8,6,57.9,3,2,12,6,0,0.9,66.7,4,2,66.7,21,89,101,440,339,RB
3270,Bruce Perry,0,0,0,2006,25,PHI,3,0,0,0,,0,0,0,,0,0,0,,0,0,,,0,,0,0,0,57,57,RB
3271,Chris Perry,10,9,19,2006,25,CIN,6,1,10,57,5.7,0,9.5,3,60,11,9,42,4.7,0,7,81.8,3.8,3,45.5,19,57,99,511,412,RB
3272,Adrian Peterson,10,6,16,2006,27,CHI,16,0,10,41,4.1,2,2.6,6,50,6,6,88,14.7,0,5.5,100,14.7,2,50,16,41,129,178,49,RB
3273,Andrew Pinnock,4,0,4,2006,26,SDG,3,0,4,25,6.3,0,8.3,1,75,0,0,0,,0,0,,,0,,4,25,25,25,0,FB
3274,Artose Pinner,43,2,45,2006,28,MIN,12,1,43,190,4.4,3,15.8,13,48.8,4,2,15,7.5,0,1.3,50,3.8,0,50,45,190,205,281,76,RB
3275,Michael Pittman,50,47,97,2006,31,TAM,16,3,50,245,4.9,1,15.3,12,38,76,47,405,8.6,0,25.3,61.8,5.3,16,40.8,97,245,650,1517,867,RB
3276,Lousaka Polite,7,2,9,2006,25,DAL,12,0,7,18,2.6,0,1.5,1,28.6,8,2,21,10.5,0,1.8,25,2.6,2,25,9,18,39,39,0,RB
3277,P.J. Pope,0,0,0,2006,22,GNB,1,0,0,0,,0,0,0,,0,0,0,,0,0,,,0,,0,0,0,0,0,RB
3278,Clinton Portis,127,17,144,2006,25,WAS,8,7,127,523,4.1,7,65.4,31,43.3,26,17,170,10,0,21.3,65.4,6.5,4,34.6,144,523,693,693,0,RB
3279,Dominic Rhodes,187,36,223,2006,27,IND,16,16,187,641,3.4,5,40.1,40,45.5,47,36,251,7,0,15.7,76.6,5.3,9,53.2,223,641,892,892,0,RB
3280,Tony Richardson,5,13,18,2006,35,MIN,9,7,5,12,2.4,0,1.3,2,40,14,13,111,8.5,0,12.3,92.9,7.9,8,57.1,18,12,123,123,0,FB
3281,Jamal Robertson,0,0,0,2006,29,ATL,1,0,0,0,,0,0,0,,0,0,0,,0,0,,,0,,0,0,0,0,0,RB
3282,Michael Robinson,38,9,47,2006,23,SFO,16,0,38,116,3.1,2,7.3,6,34.2,12,9,47,5.2,0,2.9,75,3.9,3,50,47,116,163,236,73,FB
3283,Cory Ross,0,0,0,2006,24,BAL,4,0,0,0,,0,0,0,,1,0,0,,0,0,0,0,0,0,0,0,0,231,231,RB
3284,Derrick Ross,3,0,3,2006,23,KAN,7,0,3,8,2.7,0,1.1,0,0,0,0,0,,0,0,,,0,,3,8,8,8,0,RB
3285,J.D. Runnels,0,0,0,2006,22,CHI,2,0,0,0,,0,0,0,,0,0,0,,0,0,,,0,,0,0,0,0,0,RB
3286,B.J. Sams,0,0,0,2006,26,BAL,12,0,0,0,,0,0,0,,0,0,0,,0,0,,,0,,0,0,0,1079,1079,RB
3287,Cecil Sapp,10,8,18,2006,28,DEN,11,1,10,80,8,0,7.3,4,50,10,8,34,4.3,0,3.1,80,3.4,1,40,18,80,114,209,95,RB
3288,Cory Schlesinger,0,8,8,2006,34,DET,14,5,0,0,,0,0,0,,11,8,36,4.5,0,2.6,72.7,3.3,0,0,8,0,36,36,0,FB
3289,Josh Scobey,0,0,0,2006,27,SEA,12,0,0,0,,0,0,0,,0,0,0,,0,0,,,0,,0,0,0,315,315,RB
3290,Mike Sellers,12,18,30,2006,31,WAS,16,6,12,51,4.3,0,3.2,7,91.7,21,18,105,5.8,1,6.6,85.7,5,6,47.6,30,51,156,209,53,FB
3291,Daimon Shelton,0,7,7,2006,34,BUF,14,10,0,0,,0,0,0,,10,7,35,5,0,2.5,70,3.5,2,30,7,0,35,35,0,FB
3292,Eric Shelton,8,1,9,2006,23,CAR,9,0,8,23,2.9,0,2.6,1,25,1,1,6,6,0,0.7,100,6,1,100,9,23,29,29,0,RB
3293,Marcel Shipp,17,6,23,2006,28,ARI,15,0,17,41,2.4,4,2.7,8,47.1,11,6,60,10,0,4,54.5,5.5,3,27.3,23,41,101,101,0,RB
3294,James Sims,0,0,0,2006,23,NYG,2,0,0,0,,0,0,0,,0,0,0,,0,0,,,0,,0,0,0,0,0,RB
3295,Musa Smith,36,22,58,2006,24,BAL,12,0,36,153,4.3,0,12.8,7,38.9,23,22,135,6.1,0,11.3,95.7,5.9,6,30.4,58,153,288,315,27,RB
3296,Paul Smith,0,0,0,2006,28,STL,10,3,0,0,,0,0,0,,2,0,0,,0,0,0,0,0,0,0,0,0,3,3,RB
3297,Terrelle Smith,8,8,16,2006,28,CLE,16,8,8,14,1.8,0,0.9,1,12.5,11,8,21,2.6,0,1.3,72.7,1.9,0,18.2,16,14,35,35,0,FB
3298,Jerald Sowell,0,1,1,2006,32,TAM,11,0,0,0,,0,0,0,,1,1,6,6,0,0.5,100,6,0,0,1,0,6,17,11,FB
3299,Duce Staley,0,0,0,2006,31,PIT,1,0,0,0,,0,0,0,,0,0,0,,0,0,,,0,,0,0,0,0,0,RB
3300,Aaron Stecker,4,19,23,2006,31,NOR,12,1,4,11,2.8,0,0.9,0,25,28,19,190,10,0,15.8,67.9,6.8,9,50,23,11,201,417,216,RB
3301,Mack Strong,33,29,62,2006,35,SEA,16,10,33,149,4.5,1,9.3,12,39.4,44,29,159,5.5,0,9.9,65.9,3.6,4,31.8,62,149,308,308,0,FB
3302,Lee Suggs,6,0,6,2006,26,MIA,4,0,6,26,4.3,0,6.5,0,0,1,0,13,,0,3.3,0,13,0,0,6,26,39,39,0,RB
3303,Thomas Tapeh,5,16,21,2006,26,PHI,16,8,5,9,1.8,0,0.6,2,60,21,16,85,5.3,1,5.3,76.2,4,3,28.6,21,9,94,94,0,FB
3304,Chester Taylor,303,42,345,2006,27,MIN,15,15,303,1216,4,6,81.1,54,43.6,51,42,288,6.9,0,19.2,82.4,5.6,17,51,345,1216,1504,1504,0,RB
3305,Chris Taylor,28,3,31,2006,23,HOU,4,0,28,123,4.4,1,30.8,7,42.9,3,3,40,13.3,0,10,100,13.3,1,66.7,31,123,163,163,0,RB
3306,Fred Taylor,231,23,254,2006,30,JAX,15,15,231,1146,5,5,76.4,47,42.9,28,23,242,10.5,1,16.1,82.1,8.6,8,60.7,254,1146,1388,1388,0,RB
3307,Anthony Thomas,107,22,129,2006,29,BUF,16,2,107,378,3.5,2,23.6,15,35.5,24,22,139,6.3,0,8.7,91.7,5.8,6,58.3,129,378,517,517,0,RB
3308,Tyson Thompson,13,0,13,2006,25,DAL,7,0,13,30,2.3,1,4.3,1,23.1,0,0,0,,0,0,,,0,,13,30,30,576,546,RB
3309,LaBrandon Toefield,10,0,10,2006,26,JAX,4,0,10,22,2.2,0,5.5,1,40,0,0,0,,0,0,,,0,,10,22,22,31,9,RB
3310,LaDainian Tomlinson,348,56,404,2006,27,SDG,16,16,348,1815,5.2,28,113.4,83,47.7,80,56,508,9.1,3,31.8,70,6.4,23,48.8,404,1835,2323,2323,0,RB
3311,Michael Turner,80,3,83,2006,24,SDG,13,0,80,502,6.3,2,38.6,25,52.5,3,3,47,15.7,0,3.6,100,15.7,2,66.7,83,502,549,1503,954,RB
3312,Stacy Tutt,0,0,0,2006,24,NYJ,2,0,0,0,,0,0,0,,2,0,0,,0,0,0,0,0,0,0,0,0,0,0,RB
3313,Lawrence Vickers,3,6,9,2006,23,CLE,16,1,3,2,0.7,0,0.1,0,0,7,6,60,10,0,3.8,85.7,8.6,2,85.7,9,2,62,146,84,FB
3314,Derrick Ward,0,0,0,2006,26,NYG,8,0,0,0,,0,0,0,,0,0,0,,0,0,,,0,,0,0,0,466,466,RB
3315,Leon Washington,151,25,176,2006,24,NYJ,16,8,151,650,4.3,4,40.6,32,47,31,25,270,10.8,0,16.9,80.6,8.7,7,48.4,176,650,920,1096,176,RB
3316,Kenny Watson,25,23,48,2006,28,CIN,16,0,25,138,5.5,1,8.6,5,48,32,23,213,9.3,0,13.3,71.9,6.7,12,50,48,138,351,557,198,RB
3317,Marquis Weeks,3,0,3,2006,26,SEA,10,0,3,8,2.7,0,0.8,0,0,0,0,0,,0,0,,,0,,3,8,8,11,3,RB
3318,Brian Westbrook,240,77,317,2006,27,PHI,15,14,240,1217,5.1,7,81.1,60,47.5,105,77,699,9.1,4,46.6,73.3,6.7,30,53.3,317,1217,1916,1955,39,RB
3319,LenDale White,61,14,75,2006,22,TEN,13,0,61,244,4,0,18.8,13,36.1,20,14,60,4.3,0,4.6,70,3,1,15,75,244,304,318,14,RB
3320,Cadillac Williams,225,30,255,2006,24,TAM,14,14,225,798,3.5,1,57,32,39.1,44,30,196,6.5,0,14,68.2,4.5,4,50,255,798,994,994,0,RB
3321,DeAngelo Williams,121,33,154,2006,23,CAR,13,2,121,501,4.1,1,38.5,31,45.5,36,33,313,9.5,1,24.1,91.7,8.7,11,52.8,154,501,814,1437,623,RB
3322,Shaud Williams,2,0,2,2006,26,BUF,5,0,2,2,1,0,0.4,0,0,0,0,0,,0,0,,,0,,2,2,2,19,17,RB
3323,Kris Wilson,0,15,15,2006,25,KAN,16,10,0,0,,0,0,0,,24,15,132,8.8,3,8.3,62.5,5.5,11,50,15,0,132,132,0,FB
3324,Quincy Wilson,2,0,2,2006,25,CIN,3,0,2,2,1,0,0.7,0,0,0,0,0,,0,0,,,0,,2,2,2,2,0,RB
3325,Derrick Wimbush,1,4,5,2006,26,JAX,12,6,1,3,3,0,0.3,0,0,5,4,23,5.8,0,1.9,80,4.6,0,0,5,3,26,207,181,FB
3326,Jason Wright,62,6,68,2006,24,CLE,13,3,62,189,3,0,14.5,8,37.1,11,6,82,13.7,0,6.3,54.5,7.5,2,27.3,68,189,271,271,0,RB
3327,Rich Alexis,0,0,0,2005,24,JAX,2,0,0,0,,0,0,0,,0,0,0,,0,0,,,0,,0,0,0,31,31,RB
3328,Shaun Alexander,370,15,385,2005,28,SEA,16,16,370,1880,5.1,27,117.5,109,52.7,29,15,78,5.2,1,4.9,51.7,2.7,3,34.5,385,1880,1958,1958,0,RB
3329,David Allen,0,0,0,2005,27,STL,4,0,0,0,,0,0,0,,0,0,0,,0,0,,,0,,0,0,0,510,510,RB
3330,Mike Alstott,34,25,59,2005,32,TAM,16,7,34,80,2.4,6,5,12,55.9,38,25,222,8.9,1,13.9,65.8,5.8,11,50,59,80,302,304,2,FB
3331,Damien Anderson,2,0,2,2005,26,ARI,5,0,2,7,3.5,0,1.4,0,0,0,0,0,,0,0,,,0,,2,7,7,14,7,RB
3332,Jason Anderson,0,0,0,2005,25,HOU,1,0,0,0,,0,0,0,,0,0,0,,0,0,,,0,,0,0,0,0,0,RB
3333,Mike Anderson,239,18,257,2005,32,DEN,15,15,239,1014,4.2,12,67.6,61,48.1,21,18,212,11.8,1,14.1,85.7,10.1,6,61.9,257,1014,1226,1244,18,RB
3334,J.J. Arrington,112,25,137,2005,22,ARI,15,5,112,370,3.3,2,24.7,16,38.4,34,25,139,5.6,0,9.3,73.5,4.1,6,32.4,137,370,509,509,0,RB
3335,B.J. Askew,13,1,14,2005,25,NYJ,10,1,13,59,4.5,0,5.9,3,46.2,1,1,11,11,0,1.1,100,11,1,100,14,59,70,70,0,FB
3336,Obafemi Ayanbadejo,22,34,56,2005,30,ARI,16,2,22,46,2.1,0,2.9,5,40.9,45,34,231,6.8,0,14.4,75.6,5.1,12,35.6,56,46,277,293,16,RB
3337,Marion Barber III,138,18,156,2005,22,DAL,13,2,138,538,3.9,5,41.4,31,37.7,25,18,115,6.4,0,8.8,72,4.6,6,40,156,535,653,706,58,RB
3338,Tiki Barber,357,54,411,2005,30,NYG,16,16,357,1860,5.2,9,116.3,74,47.9,70,54,530,9.8,2,33.1,77.1,7.6,22,55.7,411,1860,2390,2390,0,RB
3339,Kevan Barlow,176,31,207,2005,26,SFO,12,12,176,581,3.3,3,48.4,20,27.8,42,31,241,7.8,0,20.1,73.8,5.7,7,31,207,581,822,822,0,RB
3340,Darian Barnes,0,0,0,2005,25,MIA,9,6,0,0,,0,0,0,,4,0,0,,0,0,0,0,0,0,0,0,0,0,0,FB
3341,Jarrod Baxter,0,1,1,2005,26,ARI,8,2,0,0,,0,0,0,,3,1,4,4,0,0.5,33.3,1.3,0,0,1,0,4,4,0,FB
3342,Fred Beasley,0,2,2,2005,31,SFO,9,7,0,0,,0,0,0,,3,2,12,6,0,1.3,66.7,4,0,0,2,0,12,12,0,FB
3343,Tatum Bell,173,18,191,2005,24,DEN,15,1,173,921,5.3,8,61.4,42,39.9,28,18,104,5.8,0,6.9,64.3,3.7,5,35.7,191,921,1025,1025,0,RB
3344,Michael Bennett,126,27,153,2005,27,MIN,16,6,126,473,3.8,3,29.6,21,38.9,31,27,124,4.6,2,7.8,87.1,4,8,32.3,153,473,597,597,0,RB
3345,Cedric Benson,67,1,68,2005,23,CHI,9,1,67,272,4.1,0,30.2,12,35.8,1,1,3,3,0,0.3,100,3,0,0,68,272,275,275,0,RB
3346,Jerome Bettis,110,4,114,2005,33,PIT,12,0,110,368,3.3,9,30.7,30,50,4,4,40,10,0,3.3,100,10,2,100,114,368,408,408,0,RB
3347,Ladell Betts,89,10,99,2005,26,WAS,12,0,89,338,3.8,1,28.2,17,38.2,17,10,78,7.8,1,6.5,58.8,4.6,4,29.4,99,338,416,1037,621,RB
3348,Derrick Blaylock,17,3,20,2005,26,NYJ,7,1,17,53,3.1,0,7.6,3,41.2,4,3,17,5.7,0,2.4,75,4.3,0,0,20,53,70,87,17,RB
3349,Nehemiah Broughton,1,0,1,2005,23,WAS,4,0,1,3,3,0,0.8,0,0,0,0,0,,0,0,,,0,,1,3,3,8,5,FB
3350,Chris Brown,224,25,249,2005,24,TEN,15,14,224,851,3.8,5,56.7,37,40.6,37,25,327,13.1,2,21.8,67.6,8.8,13,48.6,249,851,1178,1178,0,RB
3351,Dee Brown,7,3,10,2005,27,KAN,8,0,7,21,3,0,2.6,0,28.6,3,3,23,7.7,1,2.9,100,7.7,2,100,10,21,44,44,0,RB
3352,Ronnie Brown,207,32,239,2005,24,MIA,15,14,207,907,4.4,4,60.5,42,44.9,47,32,232,7.3,1,15.5,68.1,4.9,12,48.9,239,907,1139,1139,0,RB
3353,Shawn Bryson,64,37,101,2005,29,DET,16,2,64,306,4.8,1,19.1,12,35.9,47,37,284,7.7,0,17.8,78.7,6,12,36.2,101,306,590,645,55,RB
3354,Joe Burns,0,1,1,2005,26,BUF,16,0,0,0,,0,0,0,,1,1,19,19,1,1.2,100,19,1,100,1,0,19,65,46,RB
3355,Terry Butler,0,0,0,2005,23,NYJ,1,0,0,0,,0,0,0,,0,0,0,,0,0,,,0,,0,0,0,0,0,RB
3356,Ran Carthon,13,1,14,2005,24,IND,6,0,13,18,1.4,1,3,3,46.2,1,1,10,10,0,1.7,100,10,1,100,14,18,28,120,92,RB
3357,Rock Cartwright,27,2,29,2005,26,WAS,16,0,27,199,7.4,2,12.4,10,55.6,4,2,23,11.5,0,1.4,50,5.8,1,25,29,199,222,304,82,FB
3358,Aveion Cason,10,1,11,2005,26,STL,2,0,10,65,6.5,1,32.5,3,60,1,1,11,11,0,5.5,100,11,1,100,11,65,76,124,48,RB
3359,Kory Chapman,0,0,0,2005,25,IND,3,0,0,0,,0,0,0,,0,0,0,,0,0,,,0,,0,0,0,0,0,RB
3360,Mike Cloud,24,0,24,2005,30,"NWE,NYG",7,0,24,59,2.5,0,8.4,1,25,2,0,0,,0,0,0,0,0,0,24,59,59,74,15,RB
3361,DeAndra Cobb,0,0,0,2005,24,ATL,3,0,0,0,,0,0,0,,0,0,0,,0,0,,,0,,0,0,0,367,367,RB
3362,Jameel Cook,0,7,7,2005,26,TAM,16,0,0,0,,0,0,0,,10,7,43,6.1,1,2.7,70,4.3,3,50,7,0,43,43,0,FB
3363,Zack Crockett,60,13,73,2005,33,OAK,16,10,60,208,3.5,1,13,11,40,18,13,111,8.5,0,6.9,72.2,6.2,3,61.1,73,208,319,319,0,FB
3364,Ronnie Cruz,0,1,1,2005,24,KAN,14,0,0,0,,0,0,0,,1,1,15,15,0,1.1,100,15,1,100,1,0,15,15,0,RB
3365,Najeh Davenport,30,2,32,2005,26,GNB,5,1,30,105,3.5,2,21,9,43.3,2,2,3,1.5,0,0.6,100,1.5,0,0,32,105,108,297,189,RB
3366,Domanick Williams,230,39,269,2005,25,HOU,11,11,230,976,4.2,2,88.7,39,43.5,48,39,337,8.6,4,30.6,81.3,7,19,45.8,269,976,1313,1366,53,RB
3367,Stephen Davis,180,5,185,2005,31,CAR,13,11,180,549,3.1,12,42.2,32,37.2,12,5,45,9,0,3.5,41.7,3.8,3,33.3,185,549,594,594,0,RB
3368,Ron Dayne,53,3,56,2005,27,DEN,10,0,53,270,5.1,1,27,14,50.9,3,3,17,5.7,0,1.7,100,5.7,0,33.3,56,270,287,287,0,RB
3369,Corey Dillon,209,22,231,2005,31,NWE,12,10,209,733,3.5,12,61.1,51,47.4,26,22,181,8.2,1,15.1,84.6,7,8,57.7,231,733,914,914,0,RB
3370,Reuben Droughns,309,39,348,2005,27,CLE,16,16,309,1232,4,2,77,61,44,56,39,369,9.5,0,23.1,69.6,6.6,14,46.4,348,1232,1601,1720,119,RB
3371,T.J. Duckett,121,6,127,2005,24,ATL,14,0,121,380,3.1,8,27.1,24,37.2,7,6,63,10.5,0,4.5,85.7,9,3,71.4,127,380,443,479,36,RB
3372,Kevin Dudley,0,0,0,2005,23,ATL,1,0,0,0,,0,0,0,,0,0,0,,0,0,,,0,,0,0,0,0,0,RB
3373,Warrick Dunn,280,29,309,2005,30,ATL,16,16,280,1416,5.1,3,88.5,67,45.4,37,29,220,7.6,1,13.8,78.4,5.9,8,54.1,309,1416,1636,1637,0,RB
3374,Omar Easy,0,0,0,2005,28,OAK,16,0,0,0,,0,0,0,,0,0,0,,0,0,,,0,,0,0,0,0,0,FB
3375,Adimchinobe Echemandu,0,0,0,2005,25,MIN,2,0,0,0,,0,0,0,,0,0,0,,0,0,,,0,,0,0,0,0,0,RB
3376,Marc Edwards,0,10,10,2005,31,CHI,8,5,0,0,,0,0,0,,13,10,66,6.6,2,8.3,76.9,5.1,4,38.5,10,0,66,66,0,FB
3377,Heath Evans,52,14,66,2005,27,"MIA,NWE",12,3,52,192,3.7,0,16,12,38.5,17,14,105,7.5,0,8.8,82.4,6.2,2,41.2,66,192,297,297,0,FB
3378,Justin Fargas,5,1,6,2005,25,OAK,14,0,5,28,5.6,0,2,1,40,5,1,9,9,0,0.6,20,1.8,0,20,6,28,37,37,0,FB
3379,Ciatrick Fason,32,0,32,2005,23,MIN,13,0,32,62,1.9,4,4.8,12,40.6,0,0,0,,0,0,,,0,,32,62,62,66,4,RB
3380,Kevin Faulk,51,29,80,2005,29,NWE,8,2,51,145,2.8,0,18.1,6,29.4,37,29,260,9,0,32.5,78.4,7,13,51.4,80,145,405,486,81,RB
3381,Marshall Faulk,65,44,109,2005,32,STL,16,1,65,292,4.5,0,18.3,15,46.2,58,44,291,6.6,1,18.2,75.9,5,18,43.1,109,292,583,583,0,RB
3382,Jim Finn,0,13,13,2005,29,NYG,16,13,0,0,,0,0,0,,24,13,98,7.5,0,6.1,54.2,4.1,5,33.3,13,0,98,98,0,FB
3383,Tony Fisher,60,48,108,2005,26,GNB,14,4,60,173,2.9,1,12.4,9,40,65,48,347,7.2,1,24.8,73.8,5.3,11,41.5,108,187,520,520,0,RB
3384,Troy Fleming,0,10,10,2005,25,TEN,13,2,0,0,,0,0,0,,15,10,69,6.9,1,5.3,66.7,4.6,4,33.3,10,0,69,78,9,RB
3385,J.P. Foschi,0,6,6,2005,23,OAK,10,5,0,0,,0,0,0,,11,6,37,6.2,0,3.7,54.5,3.4,2,36.4,6,0,37,37,0,FB
3386,DeShaun Foster,205,34,239,2005,25,CAR,15,5,205,879,4.3,2,58.6,38,41,48,34,372,10.9,1,24.8,70.8,7.8,12,41.7,239,879,1251,1251,0,RB
3387,Samkon Gado,143,10,153,2005,23,GNB,8,5,143,582,4.1,6,72.8,32,42,12,10,77,7.7,1,9.6,83.3,6.4,4,58.3,153,582,659,659,0,RB
3388,Nick Goings,37,14,51,2005,27,CAR,16,1,37,133,3.6,0,8.3,6,32.4,20,14,151,10.8,0,9.4,70,7.6,5,50,51,133,284,305,21,RB
3389,Lamar Gordon,54,11,65,2005,25,PHI,14,4,54,182,3.4,1,13,12,53.7,17,11,79,7.2,0,5.6,64.7,4.6,1,29.4,65,182,261,326,64,RB
3390,Frank Gore,127,15,142,2005,22,SFO,14,1,127,608,4.8,3,43.4,27,45.7,22,15,131,8.7,0,9.4,68.2,6,4,31.8,142,608,739,739,0,RB
3391,Earnest Graham,28,0,28,2005,25,TAM,16,0,28,83,3,0,5.2,4,28.6,1,0,0,,0,0,0,0,0,0,28,83,83,157,74,RB
3392,Ahman Green,77,19,96,2005,28,GNB,5,5,77,255,3.3,0,51,12,39,27,19,147,7.7,0,29.4,70.4,5.4,7,44.4,96,255,402,402,0,RB
3393,Justin Green,5,7,12,2005,23,BAL,12,4,5,4,0.8,0,0.3,0,20,8,7,32,4.6,0,2.7,87.5,4,1,37.5,12,4,36,46,10,FB
3394,William Green,20,5,25,2005,26,CLE,8,0,20,78,3.9,0,9.8,4,40,8,5,30,6,0,3.8,62.5,3.8,0,12.5,25,78,108,187,79,RB
3395,Justin Griffith,15,21,36,2005,25,ATL,16,15,15,65,4.3,0,4.1,3,46.7,34,21,111,5.3,3,6.9,61.8,3.3,7,35.3,36,65,176,325,149,FB
3396,Arlen Harris,13,4,17,2005,25,STL,16,0,13,21,1.6,1,1.3,2,23.1,5,4,34,8.5,0,2.1,80,6.8,1,40,17,21,55,76,21,RB
3397,Verron Haynes,74,11,85,2005,26,PIT,14,0,74,274,3.7,3,19.6,17,31.1,17,11,113,10.3,0,8.1,64.7,6.6,5,35.3,85,274,387,387,0,RB
3398,Madison Hedgecock,1,9,10,2005,24,STL,16,7,1,0,0,0,0,0,0,11,9,69,7.7,0,4.3,81.8,6.3,3,63.6,10,0,69,69,0,FB
3399,William Henderson,1,30,31,2005,34,GNB,16,8,1,-5,-5,0,-0.3,0,0,34,30,264,8.8,0,16.5,88.2,7.8,13,64.7,31,-5,259,279,20,FB
3400,Travis Henry,88,13,101,2005,27,TEN,10,1,88,335,3.8,0,33.5,13,31.8,20,13,117,9,0,11.7,65,5.9,5,35,101,335,452,452,0,RB
3401,Noah Herron,48,0,48,2005,23,"GNB,PIT",7,0,48,123,2.6,2,17.6,9,39.6,0,0,0,,0,0,,,0,,48,123,123,123,0,RB
3402,Chris Hetherington,1,5,6,2005,33,SFO,16,6,1,3,3,0,0.2,0,0,9,5,26,5.2,0,1.6,55.6,2.9,1,22.2,6,3,29,29,0,FB
3403,Maurice Hicks,59,12,71,2005,27,SFO,14,3,59,308,5.2,3,22,13,40.7,16,12,47,3.9,0,3.4,75,2.9,2,31.3,71,308,355,1044,689,RB
3404,James Hodgins,0,0,0,2005,28,ARI,1,0,0,0,,0,0,0,,0,0,0,,0,0,,,0,,0,0,0,0,0,FB
3405,Tony Hollings,0,0,0,2005,24,HOU,2,0,0,0,,0,0,0,,0,0,0,,0,0,,,0,,0,0,0,46,46,RB
3406,Priest Holmes,119,21,140,2005,32,KAN,7,7,119,451,3.8,6,64.4,30,43.7,32,21,197,9.4,1,28.1,65.6,6.2,7,43.8,140,451,648,648,0,RB
3407,Brad Hoover,10,14,24,2005,29,CAR,15,15,10,22,2.2,0,1.5,4,50,21,14,87,6.2,0,5.8,66.7,4.1,2,42.9,24,22,109,119,10,FB
3408,Cedric Houston,81,8,89,2005,23,NYJ,12,4,81,302,3.7,2,25.2,15,42,10,8,66,8.3,0,5.5,80,6.6,2,60,89,302,368,386,18,RB
3409,James Jackson,4,2,6,2005,29,ARI,8,0,4,11,2.8,0,1.4,0,0,4,2,31,15.5,0,3.9,50,7.8,2,50,6,11,42,56,14,RB
3410,Steven Jackson,254,43,297,2005,22,STL,15,15,254,1046,4.1,8,69.7,50,41.7,55,43,320,7.4,2,21.3,78.2,5.8,13,56.4,297,1046,1366,1359,0,RB
3411,Terry Jackson,2,10,12,2005,29,SFO,16,0,2,11,5.5,0,0.7,0,0,18,10,67,6.7,0,4.2,55.6,3.7,2,27.8,12,11,78,78,0,FB
3412,Brandon Jacobs,38,0,38,2005,23,NYG,16,0,38,99,2.6,7,6.2,19,57.9,0,0,0,,0,0,,,0,,38,99,99,157,58,RB
3413,Edgerrin James,360,44,404,2005,27,IND,15,15,360,1506,4.2,13,100.4,97,58.9,50,44,337,7.7,1,22.5,88,6.7,22,56,404,1506,1843,1843,0,RB
3414,Bryan Johnson,1,5,6,2005,27,CHI,7,6,1,5,5,0,0.7,0,100,5,5,15,3,0,2.1,100,3,1,40,6,5,20,20,0,FB
3415,Jeremi Johnson,8,12,20,2005,25,CIN,16,11,8,14,1.8,0,0.9,1,25,19,12,65,5.4,3,4.1,63.2,3.4,3,26.3,20,14,79,79,0,FB
3416,Kyle Johnson,4,17,21,2005,27,DEN,16,14,4,9,2.3,1,0.6,3,75,31,17,160,9.4,5,10,54.8,5.2,12,41.9,21,9,169,177,8,FB
3417,Larry Johnson,336,33,369,2005,26,KAN,16,9,336,1750,5.2,20,109.4,99,53,49,33,343,10.4,1,21.4,67.3,7,13,51,369,1750,2093,2093,0,RB
3418,Rudi Johnson,337,23,360,2005,26,CIN,16,14,337,1458,4.3,12,91.1,80,50.1,30,23,90,3.9,0,5.6,76.7,3,2,23.3,360,1458,1548,1548,0,RB
3419,Greg Jones,151,10,161,2005,24,JAX,14,13,151,575,3.8,4,41.1,32,42.4,15,10,65,6.5,0,4.6,66.7,4.3,3,53.3,161,575,640,640,0,FB
3420,Julius Jones,257,35,292,2005,24,DAL,13,12,257,993,3.9,5,76.4,48,38.1,45,35,218,6.2,0,16.8,77.8,4.8,9,35.6,292,993,1211,1211,0,RB
3421,Kevin Jones,186,20,206,2005,23,DET,13,13,186,664,3.6,5,51.1,29,41.4,28,20,109,5.5,0,8.4,71.4,3.9,3,32.1,206,664,773,796,0,RB
3422,Thomas Jones,314,26,340,2005,27,CHI,15,15,314,1335,4.3,9,89,63,38.9,39,26,143,5.5,0,9.5,66.7,3.7,6,30.8,340,1335,1478,1478,0,RB
3423,LaMont Jordan,272,70,342,2005,27,OAK,14,14,272,1025,3.8,9,73.2,62,45.6,103,70,563,8,2,40.2,68,5.5,26,43.7,342,1025,1588,1588,0,RB
3424,Mike Karney,6,10,16,2005,24,NOR,16,14,6,12,2,0,0.8,2,50,13,10,61,6.1,0,3.8,76.9,4.7,2,46.2,16,12,73,73,0,FB
3425,Dan Kreider,3,7,10,2005,28,PIT,16,8,3,21,7,0,1.3,1,66.7,11,7,43,6.1,0,2.7,63.6,3.9,1,63.6,10,21,64,67,3,FB
3426,Luke Lawton,0,0,0,2005,25,NYJ,4,0,0,0,,0,0,0,,0,0,0,,0,0,,,0,,0,0,0,0,0,RB
3427,Vonta Leach,0,5,5,2005,24,GNB,16,5,0,0,,0,0,0,,10,5,19,3.8,0,1.2,50,1.9,0,0,5,0,19,58,39,FB
3428,ReShard Lee,11,1,12,2005,25,GNB,7,1,11,16,1.5,0,2.3,1,18.2,1,1,5,5,0,0.7,100,5,0,0,12,16,21,340,319,RB
3429,Jamal Lewis,269,32,301,2005,26,BAL,15,15,269,906,3.4,3,60.4,49,41.3,44,32,191,6,1,12.7,72.7,4.3,6,38.6,301,906,1097,1097,0,RB
3430,Reno Mahe,20,12,32,2005,25,PHI,15,0,20,87,4.4,0,5.8,3,45,20,12,68,5.7,0,4.5,60,3.4,3,20,32,87,155,443,288,RB
3431,Curtis Martin,220,24,244,2005,32,NYJ,12,12,220,735,3.3,5,61.3,37,40,30,24,118,4.9,0,9.8,80,3.9,3,36.7,244,735,853,853,0,RB
3432,Chris Massey,0,0,0,2005,26,STL,16,0,0,0,,0,0,0,,0,0,0,,0,0,,,0,,0,0,0,0,0,RB
3433,Fred McAfee,0,0,0,2005,37,NOR,16,0,0,0,,0,0,0,,0,0,0,,0,0,,,0,,0,0,0,485,485,RB
3434,Deuce McAllister,93,17,110,2005,27,NOR,5,5,93,335,3.6,3,67,21,41.9,18,17,117,6.9,0,23.4,94.4,6.5,4,38.9,110,335,452,452,0,RB
3435,Fred McCrary,0,3,3,2005,33,ATL,15,0,0,0,,0,0,0,,3,3,12,4,0,0.8,100,4,1,33.3,3,0,12,12,0,FB
3436,Willis McGahee,325,28,353,2005,24,BUF,16,15,325,1247,3.8,5,77.9,71,44.3,37,28,178,6.4,0,11.1,75.7,4.8,10,37.8,353,1247,1425,1425,0,RB
3437,Sean McHugh,0,0,0,2005,23,DET,3,0,0,0,,0,0,0,,1,0,0,,0,0,0,0,0,0,0,0,0,0,0,FB
3438,Corey McIntyre,0,0,0,2005,26,CLE,15,1,0,0,,0,0,0,,1,0,0,,0,0,0,0,0,0,0,0,0,47,47,FB
3439,Jason McKie,3,4,7,2005,25,CHI,8,2,3,22,7.3,0,2.8,1,66.7,4,4,15,3.8,0,1.9,100,3.8,1,25,7,22,37,66,29,FB
3440,Travis Minor,5,1,6,2005,26,MIA,16,0,5,17,3.4,0,1.1,0,0,1,1,0,0,0,0,100,0,0,0,6,17,17,39,22,RB
3441,Ryan Moats,55,4,59,2005,23,PHI,7,1,55,278,5.1,3,39.7,12,38.2,6,4,7,1.8,0,1,66.7,1.2,0,16.7,59,278,285,311,26,RB
3442,Mewelde Moore,155,37,192,2005,23,MIN,16,8,155,662,4.3,1,41.4,33,40,49,37,339,9.2,2,21.2,75.5,6.9,17,51,192,662,1001,1318,317,RB
3443,Vernand Morency,46,10,56,2005,25,HOU,12,1,46,184,4,2,15.3,7,34.8,15,10,87,8.7,0,7.3,66.7,5.8,5,40,56,184,271,708,437,RB
3444,Harold Morrow,0,0,0,2005,32,ARI,14,0,0,0,,0,0,0,,0,0,0,,0,0,,,0,,0,0,0,0,0,FB
3445,Maurice Morris,71,5,76,2005,26,SEA,16,2,71,288,4.1,1,18,18,42.3,6,5,48,9.6,0,3,83.3,8,3,50,76,288,336,356,21,RB
3446,Sammy Morris,16,8,24,2005,28,MIA,16,2,16,58,3.6,1,3.6,3,50,12,8,54,6.8,0,3.4,66.7,4.5,2,25,24,58,112,112,0,RB
3447,Chad Morton,0,0,0,2005,28,NYG,16,0,0,0,,0,0,0,,0,0,0,,0,0,,,0,,0,0,0,1012,1012,RB
3448,Ovie Mughelli,0,3,3,2005,25,BAL,13,5,0,0,,0,0,0,,6,3,13,4.3,0,1,50,2.2,0,0,3,0,13,13,0,FB
3449,James Mungro,7,3,10,2005,27,IND,12,0,7,15,2.1,0,1.3,1,28.6,3,3,28,9.3,0,2.3,100,9.3,1,66.7,10,15,43,82,39,RB
3450,Damien Nash,6,3,9,2005,23,TEN,3,0,6,32,5.3,0,10.7,2,83.3,3,3,14,4.7,0,4.7,100,4.7,0,66.7,9,32,46,46,0,RB
3451,Lorenzo Neal,29,24,53,2005,35,SDG,16,15,29,98,3.4,0,6.1,18,82.8,29,24,145,6,1,9.1,82.8,5,4,58.6,53,98,243,243,0,FB
3452,Moran Norris,0,1,1,2005,27,HOU,16,5,0,0,,0,0,0,,1,1,4,4,1,0.3,100,4,1,100,1,0,4,6,2,FB
3453,Willie Parker,255,18,273,2005,25,PIT,15,15,255,1202,4.7,4,80.1,48,47.1,24,18,218,12.1,1,14.5,75,9.1,9,58.3,273,1202,1420,1420,0,RB
3454,Josh Parry,0,13,13,2005,27,PHI,16,11,0,0,,0,0,0,,16,13,89,6.8,0,5.6,81.3,5.6,5,68.8,13,0,89,89,0,FB
3455,Patrick Pass,54,22,76,2005,28,NWE,12,4,54,245,4.5,3,20.4,13,40.7,30,22,227,10.3,0,18.9,73.3,7.6,8,43.3,76,245,472,503,31,FB
3456,Jarrett Payton,33,6,39,2005,25,TEN,13,0,33,105,3.2,2,8.1,6,36.4,10,6,30,5,0,2.3,60,3,0,40,39,105,135,159,24,RB
3457,Alvin Pearman,39,32,71,2005,23,JAX,16,0,39,149,3.8,1,9.3,6,35.9,36,32,240,7.5,0,15,88.9,6.7,11,55.6,71,149,389,986,597,RB
3458,Bruce Perry,16,0,16,2005,24,PHI,2,1,16,74,4.6,0,37,3,50,2,0,0,,0,0,0,0,0,0,16,74,74,347,273,RB
3459,Chris Perry,61,51,112,2005,24,CIN,14,2,61,279,4.6,0,19.9,17,47.5,62,51,328,6.4,2,23.4,82.3,5.3,17,45.2,112,279,607,607,0,RB
3460,Adrian Peterson,76,7,83,2005,26,CHI,16,0,76,391,5.1,2,24.4,21,46.1,12,7,48,6.9,0,3,58.3,4,1,25,83,391,439,471,32,RB
3461,Andrew Pinnock,1,0,1,2005,25,SDG,12,0,1,4,4,0,0.3,1,100,0,0,0,,0,0,,,0,,1,4,4,28,24,FB
3462,Artose Pinner,106,21,127,2005,27,DET,16,2,106,349,3.3,3,21.8,22,45.3,25,21,181,8.6,0,11.3,84,7.2,7,48,127,349,530,530,0,RB
3463,Michael Pittman,70,36,106,2005,30,TAM,16,4,70,436,6.2,1,27.3,10,37.1,46,36,300,8.3,1,18.8,78.3,6.5,14,47.8,106,436,736,821,85,RB
3464,Lousaka Polite,2,9,11,2005,24,DAL,14,3,2,8,4,0,0.6,1,100,14,9,72,8,1,5.1,64.3,5.1,4,50,11,8,80,80,0,RB
3465,Clinton Portis,352,30,382,2005,24,WAS,16,16,352,1516,4.3,11,94.8,76,48.3,41,30,216,7.2,0,13.5,73.2,5.3,13,58.5,382,1533,1732,1732,0,RB
3466,Dominic Rhodes,40,12,52,2005,26,IND,13,1,40,118,3,4,9.1,11,40,16,12,88,7.3,0,6.8,75,5.5,2,50,52,118,206,1061,855,RB
3467,Alan Ricard,0,2,2,2005,28,BAL,2,2,0,0,,0,0,0,,3,2,18,9,0,9,66.7,6,1,66.7,2,0,18,18,0,FB
3468,Tony Richardson,6,9,15,2005,34,KAN,16,16,6,20,3.3,0,1.3,1,50,16,9,68,7.6,1,4.3,56.3,4.3,3,37.5,15,20,88,88,0,FB
3469,Jamal Robertson,14,0,14,2005,28,CAR,7,0,14,41,2.9,1,5.9,3,35.7,2,0,0,,0,0,0,0,0,0,14,41,41,384,343,RB
3470,B.J. Sams,0,0,0,2005,25,BAL,14,0,0,0,,0,0,0,,0,0,0,,0,0,,,0,,0,0,0,1399,1399,RB
3471,Cecil Sapp,5,2,7,2005,27,DEN,16,0,5,21,4.2,0,1.3,1,20,2,2,17,8.5,0,1.1,100,8.5,1,50,7,21,38,66,28,RB
3472,Cory Schlesinger,1,8,9,2005,33,DET,11,8,1,1,1,0,0.1,1,100,14,8,31,3.9,1,2.8,57.1,2.2,2,35.7,9,1,32,32,0,FB
3473,Josh Scobey,0,0,0,2005,26,SEA,16,0,0,0,,0,0,0,,0,0,0,,0,0,,,0,,0,0,0,1326,1326,RB
3474,Daimon Shelton,1,13,14,2005,33,BUF,16,11,1,0,0,0,0,0,0,21,13,98,7.5,1,6.1,61.9,4.7,6,52.4,14,0,98,124,26,FB
3475,Marcel Shipp,157,35,192,2005,27,ARI,15,11,157,451,2.9,0,30.1,23,40.8,44,35,255,7.3,0,17,79.5,5.8,8,36.4,192,451,706,706,0,RB
3476,Rod Smart,3,0,3,2005,28,CAR,12,0,3,6,2,0,0.5,1,33.3,0,0,0,,0,0,,,0,,3,6,6,621,615,RB
3477,Antowain Smith,166,12,178,2005,33,NOR,16,7,166,659,4,3,41.2,23,36.1,15,12,46,3.8,0,2.9,80,3.1,2,26.7,178,659,705,735,30,RB
3478,Musa Smith,0,3,3,2005,23,BAL,1,0,0,0,,0,0,0,,3,3,5,1.7,0,5,100,1.7,0,0,3,0,5,5,0,RB
3479,Paul Smith,4,6,10,2005,27,DET,12,5,4,16,4,0,1.3,1,50,12,6,49,8.2,0,4.1,50,4.1,4,41.7,10,16,65,65,0,FB
3480,Terrelle Smith,6,12,18,2005,27,CLE,16,15,6,9,1.5,0,0.6,1,16.7,16,12,58,4.8,1,3.6,75,3.6,3,50,18,9,67,91,24,FB
3481,Jerald Sowell,1,28,29,2005,31,NYJ,16,14,1,1,1,1,0.1,1,100,38,28,155,5.5,2,9.7,73.7,4.1,7,39.5,29,1,156,156,0,FB
3482,Darren Sproles,8,3,11,2005,22,SDG,15,0,8,50,6.3,0,3.3,2,50,4,3,10,3.3,0,0.7,75,2.5,0,25,11,50,60,1696,1636,RB
3483,Duce Staley,38,6,44,2005,30,PIT,5,1,38,148,3.9,1,29.6,10,47.4,7,6,34,5.7,0,6.8,85.7,4.9,0,42.9,44,148,182,182,0,RB
3484,Aaron Stecker,95,35,130,2005,30,NOR,15,4,95,363,3.8,0,24.2,24,42.1,48,35,281,8,0,18.7,72.9,5.9,12,47.9,130,363,644,1316,672,RB
3485,Mack Strong,17,22,39,2005,34,SEA,16,6,17,78,4.6,0,4.9,7,47.1,27,22,166,7.5,0,10.4,81.5,6.1,6,51.9,39,78,244,244,0,FB
3486,Lee Suggs,8,6,14,2005,25,CLE,8,0,8,15,1.9,0,1.9,1,25,8,6,26,4.3,0,3.3,75,3.3,0,37.5,14,15,41,41,0,RB
3487,Chester Taylor,117,41,158,2005,26,BAL,15,1,117,487,4.2,0,32.5,30,41.9,53,41,292,7.1,1,19.5,77.4,5.5,13,37.7,158,487,779,1032,253,RB
3488,Fred Taylor,194,13,207,2005,29,JAX,11,11,194,787,4.1,3,71.5,29,37.6,18,13,83,6.4,0,7.5,72.2,4.6,4,44.4,207,787,870,870,0,RB
3489,Anthony Thomas,43,4,47,2005,28,"DAL,NOR",9,2,43,92,2.1,0,10.2,5,23.3,8,4,13,3.3,0,1.4,50,1.6,0,12.5,47,92,105,105,0,RB
3490,Tyson Thompson,46,3,49,2005,24,DAL,15,0,46,182,4,0,12.1,11,37,4,3,16,5.3,0,1.1,75,4,0,50,49,182,198,1597,1399,RB
3491,LaBrandon Toefield,36,3,39,2005,25,JAX,9,2,36,142,3.9,4,15.8,9,41.7,7,3,17,5.7,0,1.9,42.9,2.4,1,28.6,39,142,159,159,0,RB
3492,LaDainian Tomlinson,339,51,390,2005,26,SDG,16,16,339,1462,4.3,18,91.4,72,46.9,77,51,370,7.3,2,23.1,66.2,4.8,15,33.8,390,1509,1832,1832,0,RB
3493,Michael Turner,57,0,57,2005,23,SDG,16,0,57,335,5.9,3,20.9,12,47.4,1,0,0,,0,0,0,0,0,0,57,335,335,335,0,RB
3494,Derrick Ward,35,2,37,2005,25,NYG,14,0,35,123,3.5,0,8.8,6,37.1,5,2,13,6.5,0,0.9,40,2.6,1,20,37,123,136,136,0,RB
3495,Kenny Watson,0,0,0,2005,27,CIN,1,0,0,0,,0,0,0,,0,0,0,,0,0,,,0,,0,0,0,0,0,RB
3496,Leonard Weaver,17,1,18,2005,23,SEA,16,0,17,80,4.7,0,5,3,47.1,3,1,12,12,0,0.8,33.3,4,1,33.3,18,80,92,92,0,RB
3497,Jonathan Wells,90,22,112,2005,26,HOU,15,6,90,325,3.6,4,21.7,20,51.1,27,22,179,8.1,0,11.9,81.5,6.6,6,63,112,325,504,610,106,RB
3498,Brian Westbrook,156,61,217,2005,26,PHI,12,12,156,617,4,3,51.4,29,37.8,96,61,616,10.1,4,51.3,63.5,6.4,27,41.7,217,614,1233,1293,60,RB
3499,Jamel White,6,0,6,2005,28,BAL,5,0,6,17,2.8,0,3.4,0,0,1,0,0,,0,0,0,0,0,0,6,17,17,35,18,RB
3500,Cadillac Williams,290,20,310,2005,23,TAM,14,14,290,1178,4.1,6,84.1,59,42.4,25,20,81,4.1,0,5.8,80,3.2,4,32,310,1178,1259,1259,0,RB
3501,Moe Williams,13,8,21,2005,31,MIN,6,1,13,20,1.5,0,3.3,2,30.8,14,8,52,6.5,0,8.7,57.1,3.7,2,28.6,21,20,72,88,16,RB
3502,Nick Luchey,1,0,1,2005,28,CIN,3,0,1,0,0,0,0,0,0,0,0,0,,0,0,,,0,,1,0,0,0,0,FB
3503,Ricky Williams,168,17,185,2005,28,MIA,12,3,168,743,4.4,6,61.9,39,45.8,20,17,93,5.5,0,7.8,85,4.7,3,45,185,743,836,836,0,RB
3504,Shaud Williams,45,17,62,2005,25,BUF,16,0,45,161,3.6,0,10.1,7,31.1,23,17,118,6.9,0,7.4,73.9,5.1,3,30.4,62,161,279,279,0,RB
3505,Walter Williams,0,1,1,2005,28,GNB,2,0,0,0,,0,0,0,,2,1,19,19,0,9.5,50,9.5,1,50,1,0,19,19,0,RB
3506,Derrick Wimbush,3,5,8,2005,25,JAX,14,1,3,12,4,1,0.9,1,66.7,10,5,26,5.2,0,1.9,50,2.6,3,40,8,12,38,993,955,RB
3507,Jason Wright,11,3,14,2005,23,CLE,3,0,11,27,2.5,1,9,1,27.3,3,3,15,5,0,5,100,5,1,33.3,14,27,42,59,17,RB
3508,Amos Zereoue,7,1,8,2005,29,NWE,3,0,7,14,2,0,4.7,2,28.6,1,1,5,5,0,1.7,100,5,0,0,8,14,19,19,0,RB
3509,Rabih Abdullah,13,1,14,2004,29,NWE,9,0,13,13,1,1,1.4,3,23.1,2,1,9,9,0,1,50,4.5,0,0,14,13,22,22,0,RB
3510,Shaun Alexander,353,23,376,2004,27,SEA,16,16,353,1696,4.8,16,106,78,44.8,38,23,170,7.4,4,10.6,60.5,4.5,9,39.5,376,1696,1866,1866,0,RB
3511,David Allen,0,2,2,2004,26,JAX,5,0,0,0,,0,0,0,,2,2,8,4,0,1.6,100,4,0,0,2,0,8,362,354,RB
3512,Mike Alstott,67,29,96,2004,31,TAM,14,11,67,230,3.4,2,16.4,20,56.7,41,29,202,7,0,14.4,70.7,4.9,11,36.6,96,230,432,432,0,FB
3513,Damien Anderson,1,0,1,2004,25,ARI,4,0,1,2,2,0,0.5,0,0,0,0,0,,0,0,,,0,,1,2,2,2,0,RB
3514,Richie Anderson,57,26,83,2004,33,DAL,12,4,57,246,4.3,1,20.5,12,40.4,41,26,207,8,0,17.3,63.4,5,7,41.5,83,272,453,453,0,FB
3515,B.J. Askew,6,2,8,2004,24,NYJ,16,0,6,23,3.8,0,1.4,1,16.7,2,2,12,6,0,0.8,100,6,1,50,8,23,35,53,18,FB
3516,Obafemi Ayanbadejo,30,19,49,2004,29,ARI,16,5,30,122,4.1,3,7.6,9,63.3,25,19,171,9,1,10.7,76,6.8,9,56,49,122,293,343,50,FB
3517,Tiki Barber,322,52,374,2004,29,NYG,16,14,322,1518,4.7,13,94.9,82,47.2,79,52,578,11.1,2,36.1,65.8,7.3,20,45.6,374,1518,2096,2096,0,RB
3518,Kevan Barlow,244,35,279,2004,25,SFO,15,14,244,822,3.4,7,54.8,45,38.9,45,35,212,6.1,0,14.1,77.8,4.7,12,57.8,279,822,1034,1034,0,RB
3519,Darian Barnes,5,10,15,2004,24,DAL,16,10,5,10,2,0,0.6,3,40,14,10,59,5.9,1,3.7,71.4,4.2,4,42.9,15,10,69,69,0,FB
3520,Jarrod Baxter,2,1,3,2004,25,HOU,8,1,2,1,0.5,0,0.1,0,0,2,1,3,3,0,0.4,50,1.5,0,0,3,1,4,4,0,FB
3521,Fred Beasley,9,10,19,2004,30,SFO,14,10,9,15,1.7,0,1.1,4,44.4,25,10,44,4.4,0,3.1,40,1.8,1,16,19,15,59,59,0,FB
3522,Tatum Bell,75,5,80,2004,23,DEN,14,0,75,396,5.3,3,28.3,20,57.3,7,5,80,16,0,5.7,71.4,11.4,1,28.6,80,396,476,476,0,RB
3523,Brandon Bennett,6,0,6,2004,31,CAR,8,0,6,17,2.8,1,2.1,2,33.3,0,0,0,,0,0,,,0,,6,17,17,194,177,RB
3524,Michael Bennett,70,21,91,2004,26,MIN,11,7,70,276,3.9,1,25.1,14,40,23,21,207,9.9,1,18.8,91.3,9,6,69.6,91,276,483,483,0,RB
3525,Jerome Bettis,250,6,256,2004,32,PIT,15,6,250,941,3.8,13,62.7,50,48,8,6,46,7.7,0,3.1,75,5.8,2,50,256,951,987,987,0,RB
3526,Ladell Betts,90,15,105,2004,25,WAS,16,1,90,371,4.1,1,23.2,20,48.9,25,15,108,7.2,0,6.8,60,4.3,4,24,105,371,479,1007,528,RB
3527,Derrick Blaylock,118,25,143,2004,25,KAN,12,5,118,539,4.6,8,44.9,34,55.9,36,25,246,9.8,1,20.5,69.4,6.8,10,44.4,143,539,785,807,22,RB
3528,Chris Brown,220,20,240,2004,23,TEN,11,11,220,1067,4.9,6,97,40,43.2,33,20,147,7.4,0,13.4,60.6,4.5,6,39.4,240,1067,1214,1214,0,RB
3529,Dante Brown,1,0,1,2004,24,PIT,1,0,1,2,2,0,2,1,100,0,0,0,,0,0,,,0,,1,2,2,2,0,RB
3530,Dee Brown,0,0,0,2004,26,CLE,5,0,0,0,,0,0,0,,0,0,0,,0,0,,,0,,0,0,0,243,243,RB
3531,Shawn Bryson,50,44,94,2004,28,DET,16,1,50,264,5.3,0,16.5,15,46,57,44,322,7.3,0,20.1,77.2,5.6,12,40.4,94,264,586,613,27,RB
3532,Joe Burns,20,1,21,2004,25,BUF,16,0,20,73,3.7,0,4.6,2,25,3,1,7,7,0,0.4,33.3,2.3,1,33.3,21,73,80,80,0,RB
3533,Kerry Carter,4,0,4,2004,24,SEA,16,0,4,15,3.8,0,0.9,2,75,0,0,0,,0,0,,,0,,4,15,15,463,448,RB
3534,Ki-Jana Carter,10,0,10,2004,31,NOR,2,0,10,17,1.7,0,8.5,2,20,1,0,0,,0,0,0,0,0,0,10,17,17,17,0,RB
3535,Rock Cartwright,2,0,2,2004,25,WAS,13,0,2,0,0,0,0,0,0,1,0,0,,0,0,0,0,0,0,2,0,0,0,0,FB
3536,Aveion Cason,0,0,0,2004,25,STL,3,0,0,0,,0,0,0,,0,0,0,,0,0,,,0,,0,0,0,310,310,RB
3537,Jesse Chatman,65,2,67,2004,25,SDG,15,0,65,392,6,3,26.1,19,49.2,2,2,17,8.5,0,1.1,100,8.5,1,50,67,392,409,498,89,RB
3538,Mike Cloud,21,1,22,2004,29,NYG,10,0,21,90,4.3,3,9,9,47.6,1,1,3,3,0,0.3,100,3,0,0,22,90,93,268,175,RB
3539,Cedric Cobbs,22,0,22,2004,23,NWE,3,0,22,50,2.3,0,16.7,3,27.3,0,0,0,,0,0,,,0,,22,50,50,50,0,RB
3540,Greg Comella,0,1,1,2004,29,TAM,7,0,0,0,,0,0,0,,1,1,12,12,0,1.7,100,12,1,100,1,0,12,32,20,FB
3541,Jameel Cook,0,7,7,2004,25,TAM,12,5,0,0,,0,0,0,,12,7,44,6.3,1,3.7,58.3,3.7,3,58.3,7,0,44,44,0,FB
3542,Zack Crockett,48,16,64,2004,32,OAK,16,9,48,232,4.8,2,14.5,12,62.5,20,16,87,5.4,0,5.4,80,4.4,4,60,64,232,319,319,0,FB
3543,Larry Croom,29,2,31,2004,23,ARI,6,1,29,76,2.6,0,12.7,3,31,5,2,16,8,0,2.7,40,3.2,1,40,31,76,92,406,314,RB
3544,Najeh Davenport,71,4,75,2004,25,GNB,11,1,71,359,5.1,2,32.6,16,46.5,4,4,33,8.3,0,3,100,8.3,1,75,75,359,392,678,286,RB
3545,Carey Davis,0,0,0,2004,23,"ATL,IND",1,0,0,0,,0,0,0,,0,0,0,,0,0,,,0,,0,0,0,0,0,RB
3546,Domanick Williams,302,68,370,2004,24,HOU,15,15,302,1188,3.9,13,79.2,57,42.7,84,68,588,8.6,1,39.2,81,7,27,59.5,370,1188,1776,1776,0,RB
3547,Stephen Davis,24,2,26,2004,30,CAR,2,2,24,92,3.8,0,46,5,45.8,2,2,32,16,0,16,100,16,2,100,26,92,124,124,0,RB
3548,Ron Dayne,52,1,53,2004,26,NYG,14,2,52,179,3.4,1,12.8,10,46.2,4,1,7,7,0,0.5,25,1.8,0,0,53,179,186,197,11,RB
3549,Dahrran Diedrick,0,0,0,2004,25,WAS,1,0,0,0,,0,0,0,,0,0,0,,0,0,,,0,,0,0,0,0,0,RB
3550,Corey Dillon,345,15,360,2004,30,NWE,15,14,345,1635,4.7,12,109,84,53,21,15,103,6.9,1,6.9,71.4,4.9,3,52.4,360,1635,1738,1738,0,RB
3551,Reuben Droughns,275,32,307,2004,26,DEN,16,15,275,1240,4.5,6,77.5,72,49.1,44,32,241,7.5,2,15.1,72.7,5.5,14,47.7,307,1240,1481,1825,344,RB
3552,T.J. Duckett,104,3,107,2004,23,ATL,13,0,104,509,4.9,8,39.2,30,54.8,3,3,15,5,0,1.2,100,5,1,33.3,107,509,524,524,0,RB
3553,Warrick Dunn,265,29,294,2004,29,ATL,16,16,265,1106,4.2,9,69.1,47,41.1,39,29,294,10.1,0,18.4,74.4,7.5,9,43.6,294,1106,1400,1400,0,RB
3554,Doug Easlick,0,1,1,2004,24,MIA,3,1,0,0,,0,0,0,,2,1,4,4,0,1.3,50,2,0,0,1,0,4,4,0,RB
3555,Omar Easy,4,0,4,2004,27,KAN,15,0,4,1,0.3,0,0.1,0,0,0,0,0,,0,0,,,0,,4,1,1,1,0,FB
3556,Adimchinobe Echemandu,8,3,11,2004,24,CLE,4,0,8,25,3.1,0,6.3,2,37.5,4,3,25,8.3,0,6.3,75,6.3,1,50,11,25,50,50,0,RB
3557,Marc Edwards,0,7,7,2004,30,JAX,13,5,0,0,,0,0,0,,8,7,41,5.9,0,3.2,87.5,5.1,2,50,7,0,41,49,8,FB
3558,Heath Evans,7,2,9,2004,26,SEA,15,0,7,20,2.9,0,1.3,3,57.1,4,2,12,6,0,0.8,50,3,0,0,9,20,32,83,51,FB
3559,Justin Fargas,35,11,46,2004,24,OAK,12,0,35,126,3.6,1,10.5,9,51.4,14,11,68,6.2,0,5.7,78.6,4.9,3,50,46,126,194,194,0,FB
3560,Kevin Faulk,54,26,80,2004,28,NWE,11,1,54,255,4.7,2,23.2,14,51.9,30,26,248,9.5,1,22.5,86.7,8.3,14,50,80,255,503,709,206,RB
3561,Marshall Faulk,195,50,245,2004,31,STL,14,14,195,774,4,3,55.3,46,46.2,65,50,310,6.2,1,22.1,76.9,4.8,12,40,245,774,1084,1084,0,RB
3562,Jim Finn,3,15,18,2004,28,NYG,16,9,3,7,2.3,0,0.4,0,33.3,18,15,112,7.5,0,7,83.3,6.2,5,55.6,18,7,119,135,16,FB
3563,Tony Fisher,65,38,103,2004,25,GNB,16,0,65,224,3.4,0,14,16,43.1,44,38,277,7.3,2,17.3,86.4,6.3,13,52.3,103,232,501,501,0,RB
3564,Troy Fleming,7,19,26,2004,24,TEN,16,0,7,40,5.7,0,2.5,2,42.9,28,19,164,8.6,2,10.3,67.9,5.9,8,42.9,26,40,204,520,316,RB
3565,Brock Forsey,19,0,19,2004,24,MIA,7,0,19,53,2.8,0,7.6,2,42.1,0,0,0,,0,0,,,0,,19,53,53,53,0,RB
3566,DeShaun Foster,59,9,68,2004,24,CAR,4,3,59,255,4.3,2,63.8,13,42.4,10,9,76,8.4,0,19,90,7.6,3,40,68,255,331,347,16,RB
3567,Chris Fuamatu-Ma'afala,20,4,24,2004,27,JAX,7,1,20,69,3.5,1,9.9,7,65,6,4,19,4.8,0,2.7,66.7,3.2,0,33.3,24,69,88,88,0,RB
3568,Charlie Garner,30,9,39,2004,32,TAM,3,3,30,111,3.7,0,37,3,40,14,9,62,6.9,0,20.7,64.3,4.4,1,35.7,39,111,173,173,0,RB
3569,Eddie George,132,9,141,2004,31,DAL,13,8,132,432,3.3,4,33.2,28,42.4,13,9,83,9.2,0,6.4,69.2,6.4,1,53.8,141,432,515,515,0,RB
3570,Nick Goings,217,45,262,2004,26,CAR,16,8,217,821,3.8,6,51.3,42,41.9,61,45,394,8.8,1,24.6,73.8,6.5,17,50.8,262,821,1215,1215,0,RB
3571,Joey Goodspeed,3,11,14,2004,26,STL,16,5,3,6,2,1,0.4,2,66.7,16,11,71,6.5,0,4.4,68.8,4.4,2,50,14,6,77,86,9,FB
3572,Lamar Gordon,35,13,48,2004,24,MIA,3,2,35,64,1.8,0,21.3,3,28.6,19,13,74,5.7,0,24.7,68.4,3.9,2,31.6,48,64,138,138,0,RB
3573,Earnest Graham,13,0,13,2004,24,TAM,9,0,13,73,5.6,0,8.1,2,76.9,1,0,0,,0,0,0,0,0,0,13,73,73,125,52,RB
3574,Ahman Green,259,40,299,2004,27,GNB,15,15,259,1163,4.5,7,77.5,58,49.8,51,40,275,6.9,1,18.3,78.4,5.4,18,45.1,299,1183,1438,1438,0,RB
3575,William Green,163,14,177,2004,25,CLE,15,13,163,585,3.6,2,39,29,35.6,22,14,84,6,0,5.6,63.6,3.8,3,27.3,177,585,669,669,0,RB
3576,Justin Griffith,9,22,31,2004,24,ATL,12,11,9,39,4.3,0,3.3,2,44.4,31,22,220,10,1,18.3,71,7.1,10,45.2,31,39,259,290,31,FB
3577,Quentin Griffin,85,10,95,2004,23,DEN,6,4,85,311,3.7,2,51.8,14,32.9,14,10,68,6.8,1,11.3,71.4,4.9,4,50,95,311,379,431,52,RB
3578,Troy Hambrick,63,4,67,2004,28,ARI,10,0,63,283,4.5,1,28.3,12,34.9,5,4,16,4,1,1.6,80,3.2,1,20,67,283,299,299,0,RB
3579,Arlen Harris,20,4,24,2004,24,STL,14,1,20,63,3.2,0,4.5,3,40,4,4,44,11,0,3.1,100,11,3,75,24,63,107,1058,951,RB
3580,Joey Harris,15,0,15,2004,24,CAR,4,0,15,53,3.5,0,13.3,3,33.3,3,0,0,,0,0,0,0,0,0,15,53,53,53,0,RB
3581,Verron Haynes,55,18,73,2004,25,PIT,13,0,55,272,4.9,0,20.9,17,47.3,23,18,142,7.9,2,10.9,78.3,6.2,9,39.1,73,272,414,421,5,RB
3582,Garrison Hearst,20,2,22,2004,33,DEN,7,0,20,81,4.1,1,11.6,8,45,3,2,20,10,0,2.9,66.7,6.7,1,33.3,22,81,101,101,0,RB
3583,William Henderson,0,34,34,2004,33,GNB,16,8,0,0,,0,0,0,,40,34,239,7,3,14.9,85,6,15,52.5,34,0,239,255,16,FB
3584,Leonard Henry,46,3,49,2004,26,MIA,6,2,46,141,3.1,0,23.5,5,30.4,6,3,12,4,0,2,50,2,0,16.7,49,141,153,153,0,RB
3585,Travis Henry,94,10,104,2004,26,BUF,10,5,94,326,3.5,0,32.6,18,40.4,14,10,45,4.5,0,4.5,71.4,3.2,4,50,104,326,371,371,0,RB
3586,Chris Hetherington,1,3,4,2004,32,OAK,5,2,1,4,4,0,0.8,0,0,4,3,28,9.3,0,5.6,75,7,1,75,4,4,32,55,23,FB
3587,Maurice Hicks,96,16,112,2004,26,SFO,9,2,96,362,3.8,2,40.2,20,37.5,25,16,154,9.6,0,17.1,64,6.2,9,48,112,362,516,1139,623,RB
3588,Robert Holcombe,17,11,28,2004,29,TEN,16,8,17,62,3.6,0,3.9,3,35.3,21,11,60,5.5,0,3.8,52.4,2.9,1,47.6,28,62,122,148,26,FB
3589,Tony Hollings,11,5,16,2004,23,HOU,7,0,11,47,4.3,0,6.7,2,63.6,7,5,46,9.2,0,6.6,71.4,6.6,1,28.6,16,47,93,116,23,RB
3590,Priest Holmes,196,19,215,2004,31,KAN,8,8,196,892,4.6,14,111.5,59,53.1,25,19,187,9.8,1,23.4,76,7.5,8,36,215,892,1079,1079,0,RB
3591,Brad Hoover,68,21,89,2004,28,CAR,14,9,68,246,3.6,0,17.6,14,38.2,32,21,161,7.7,2,11.5,65.6,5,7,40.6,89,246,407,437,30,FB
3592,Jasen Isom,1,1,2,2004,27,SFO,5,1,1,0,0,0,0,0,0,2,1,1,1,0,0.2,50,0.5,0,0,2,0,1,1,0,FB
3593,James Jackson,12,6,18,2004,28,"CLE,GNB",5,0,12,81,6.8,0,16.2,2,41.7,8,6,22,3.7,0,4.4,75,2.8,1,12.5,18,81,103,142,39,RB
3594,Steven Jackson,134,19,153,2004,21,STL,14,3,134,673,5,4,48.1,37,56,24,19,189,9.9,0,13.5,79.2,7.9,6,41.7,153,673,862,941,79,RB
3595,Terry Jackson,26,21,47,2004,28,SFO,16,0,26,101,3.9,0,6.3,4,30.8,30,21,139,6.6,0,8.7,70,4.6,5,26.7,47,101,240,262,22,FB
3596,Edgerrin James,334,51,385,2004,26,IND,16,16,334,1548,4.6,9,96.8,78,56,60,51,483,9.5,0,30.2,85,8.1,20,56.7,385,1548,2031,2031,0,RB
3597,Bryan Johnson,0,14,14,2004,26,CHI,12,6,0,0,,0,0,0,,25,14,55,3.9,2,4.6,56,2.2,4,28,14,0,55,73,18,FB
3598,Jeremi Johnson,3,16,19,2004,24,CIN,16,6,3,5,1.7,0,0.3,0,33.3,18,16,53,3.3,1,3.3,88.9,2.9,2,38.9,19,5,58,58,0,FB
3599,Kyle Johnson,0,9,9,2004,26,DEN,14,3,0,0,,0,0,0,,13,9,126,14,2,9,69.2,9.7,5,53.8,9,0,126,126,0,RB
3600,Larry Johnson,120,22,142,2004,25,KAN,10,3,120,581,4.8,9,58.1,36,53.3,29,22,278,12.6,2,27.8,75.9,9.6,13,62.1,142,581,859,859,0,RB
3601,Rudi Johnson,361,15,376,2004,25,CIN,16,16,361,1454,4,12,90.9,74,46,28,15,84,5.6,0,5.3,53.6,3,2,17.9,376,1454,1538,1538,0,RB
3602,Greg Jones,62,3,65,2004,23,JAX,16,3,62,162,2.6,3,10.1,14,45.2,10,3,13,4.3,0,0.8,30,1.3,1,10,65,162,175,265,90,RB
3603,Julius Jones,197,17,214,2004,23,DAL,8,7,197,819,4.2,7,102.4,44,43.7,26,17,109,6.4,0,13.6,65.4,4.2,6,38.5,214,819,928,928,0,RB
3604,Kevin Jones,241,28,269,2004,22,DET,15,14,241,1133,4.7,5,75.5,59,46.9,41,28,180,6.4,1,12,68.3,4.4,8,46.3,269,1133,1313,1313,0,RB
3605,Thomas Jones,240,56,296,2004,26,CHI,14,14,240,948,4,7,67.7,49,45.8,72,56,427,7.6,0,30.5,77.8,5.9,17,41.7,296,948,1375,1375,0,RB
3606,LaMont Jordan,93,15,108,2004,26,NYJ,16,0,93,479,5.2,2,29.9,27,53.8,16,15,112,7.5,0,7,93.8,7,7,62.5,108,479,591,875,284,RB
3607,Mike Karney,3,6,9,2004,23,NOR,16,8,3,7,2.3,0,0.4,1,66.7,7,6,42,7,0,2.6,85.7,6,2,42.9,9,7,49,49,0,FB
3608,Vick King,4,1,5,2004,24,MIA,2,0,4,9,2.3,0,4.5,1,25,2,1,8,8,0,4,50,4,0,50,5,9,17,17,0,RB
3609,Rob Konrad,2,8,10,2004,28,MIA,10,1,2,18,9,0,1.8,1,100,18,8,69,8.6,1,6.9,44.4,3.8,5,27.8,10,18,87,87,0,FB
3610,Dan Kreider,4,10,14,2004,27,PIT,16,9,4,18,4.5,0,1.1,1,50,14,10,75,7.5,1,4.7,71.4,5.4,3,64.3,14,18,93,93,0,FB
3611,George Layne,1,1,2,2004,26,"ATL,SDG",4,0,1,12,12,0,3,1,100,1,1,6,6,0,1.5,100,6,0,100,2,12,18,18,0,RB
3612,Vonta Leach,0,0,0,2004,23,GNB,6,0,0,0,,0,0,0,,0,0,0,,0,0,,,0,,0,0,0,0,0,RB
3613,ReShard Lee,27,1,28,2004,24,DAL,14,0,27,128,4.7,1,9.1,8,48.1,3,1,4,4,0,0.3,33.3,1.3,0,33.3,28,128,132,1096,964,RB
3614,Dorsey Levens,94,9,103,2004,34,PHI,15,5,94,410,4.4,4,27.3,25,53.2,14,9,92,10.2,0,6.1,64.3,6.6,5,42.9,103,410,502,502,0,RB
3615,Jamal Lewis,235,10,245,2004,25,BAL,12,12,235,1006,4.3,7,83.8,51,45.1,12,10,116,11.6,0,9.7,83.3,9.7,5,50,245,1006,1122,1120,0,RB
3616,Tom Lopienski,0,0,0,2004,25,IND,2,0,0,0,,0,0,0,,0,0,0,,0,0,,,0,,0,0,0,0,0,FB
3617,James Lynch,0,0,0,2004,22,CIN,1,0,0,0,,0,0,0,,0,0,0,,0,0,,,0,,0,0,0,0,0,RB
3618,Reno Mahe,23,14,37,2004,24,PHI,11,0,23,91,4,0,8.3,6,39.1,16,14,123,8.8,0,11.2,87.5,7.7,2,62.5,37,91,214,367,153,RB
3619,Curtis Martin,371,41,412,2004,31,NYJ,16,16,371,1697,4.6,12,106.1,93,52.6,49,41,245,6,2,15.3,83.7,5,12,44.9,412,1697,1942,1933,0,RB
3620,Jamar Martin,0,4,4,2004,24,MIA,9,1,0,0,,0,0,0,,8,4,15,3.8,0,1.7,50,1.9,0,0,4,0,15,15,0,FB
3621,Chris Massey,0,0,0,2004,25,STL,16,0,0,0,,0,0,0,,0,0,0,,0,0,,,0,,0,0,0,0,0,RB
3622,Fred McAfee,2,0,2,2004,36,NOR,11,0,2,54,27,0,4.9,1,50,0,0,0,,0,0,,,0,,2,54,54,191,137,RB
3623,Deuce McAllister,269,34,303,2004,26,NOR,14,14,269,1074,4,9,76.7,54,40.9,48,34,228,6.7,0,16.3,70.8,4.8,5,27.1,303,1074,1302,1302,0,RB
3624,Eric McCoo,9,2,11,2004,24,PHI,1,0,9,54,6,0,54,3,66.7,5,2,15,7.5,0,15,40,3,0,40,11,54,69,69,0,RB
3625,Fred McCrary,0,2,2,2004,32,ATL,3,2,0,0,,0,0,0,,4,2,23,11.5,0,7.7,50,5.8,1,50,2,0,23,23,0,FB
3626,Willis McGahee,284,22,306,2004,23,BUF,16,11,284,1128,4,13,70.5,65,45.1,36,22,169,7.7,0,10.6,61.1,4.7,8,38.9,306,1128,1297,1297,0,RB
3627,Dusty McGrorty,0,0,0,2004,23,STL,1,0,0,0,,0,0,0,,0,0,0,,0,0,,,0,,0,0,0,0,0,RB
3628,Sean McHugh,0,0,0,2004,22,GNB,1,0,0,0,,0,0,0,,0,0,0,,0,0,,,0,,0,0,0,0,0,FB
3629,Jason McKie,1,13,14,2004,24,CHI,15,2,1,1,1,0,0.1,0,0,17,13,70,5.4,2,4.7,76.5,4.1,4,52.9,14,1,71,136,65,FB
3630,Travis Minor,109,13,122,2004,25,MIA,11,4,109,388,3.6,3,35.3,22,35.8,27,13,75,5.8,0,6.8,48.1,2.8,2,18.5,122,388,463,463,0,RB
3631,Mewelde Moore,65,27,92,2004,22,MIN,10,3,65,379,5.8,0,37.9,17,56.9,32,27,238,8.8,0,23.8,84.4,7.4,8,53.1,92,379,617,1031,414,RB
3632,Harold Morrow,0,0,0,2004,31,BAL,15,0,0,0,,0,0,0,,0,0,0,,0,0,,,0,,0,0,0,0,0,FB
3633,Maurice Morris,30,9,39,2004,25,SEA,15,0,30,126,4.2,0,8.4,9,56.7,20,9,53,5.9,0,3.5,45,2.7,5,30,39,126,179,1248,1069,RB
3634,Sammy Morris,132,22,154,2004,27,MIA,13,8,132,523,4,6,40.2,33,45.5,28,22,124,5.6,0,9.5,78.6,4.4,5,35.7,154,514,647,674,27,RB
3635,Chad Morton,0,0,0,2004,27,WAS,6,0,0,0,,0,0,0,,0,0,0,,0,0,,,0,,0,0,0,438,438,RB
3636,Ovie Mughelli,0,0,0,2004,24,BAL,3,0,0,0,,0,0,0,,0,0,0,,0,0,,,0,,0,0,0,0,0,FB
3637,James Mungro,5,7,12,2004,26,IND,15,0,5,19,3.8,0,1.3,1,40,8,7,36,5.1,3,2.4,87.5,4.5,5,75,12,19,55,166,111,RB
3638,Lorenzo Neal,16,13,29,2004,34,SDG,16,10,16,53,3.3,0,3.3,11,81.3,19,13,66,5.1,0,4.1,68.4,3.5,1,36.8,29,53,119,131,12,FB
3639,Larry Ned,0,1,1,2004,26,MIN,16,0,0,0,,0,0,0,,1,1,9,9,0,0.6,100,9,1,100,1,0,9,9,0,RB
3640,Moran Norris,1,4,5,2004,26,HOU,12,4,1,0,0,0,0,0,0,5,4,13,3.3,0,1.1,80,2.6,1,40,5,0,13,38,25,FB
3641,Willie Parker,32,3,35,2004,24,PIT,8,0,32,186,5.8,0,23.3,9,43.8,7,3,16,5.3,0,2,42.9,2.3,0,0,35,186,202,202,0,RB
3642,Josh Parry,0,9,9,2004,26,PHI,13,4,0,0,,0,0,0,,18,9,75,8.3,0,5.8,50,4.2,3,38.9,9,0,75,99,24,RB
3643,Patrick Pass,39,28,67,2004,27,NWE,14,4,39,141,3.6,0,10.1,8,43.6,32,28,215,7.7,0,15.4,87.5,6.7,7,40.6,67,141,356,471,115,FB
3644,Chris Perry,2,3,5,2004,23,CIN,2,0,2,1,0.5,0,0.5,0,0,3,3,33,11,0,16.5,100,11,2,100,5,1,34,34,0,RB
3645,Adrian Peterson,6,2,8,2004,25,CHI,14,0,6,19,3.2,0,1.4,2,16.7,2,2,30,15,0,2.1,100,15,1,50,8,19,49,106,57,RB
3646,Andrew Pinnock,9,3,12,2004,24,SDG,1,0,9,26,2.9,0,26,2,44.4,3,3,26,8.7,0,26,100,8.7,2,66.7,12,26,52,52,0,FB
3647,Artose Pinner,57,11,68,2004,26,DET,9,2,57,174,3.1,2,19.3,11,50.9,11,11,72,6.5,0,8,100,6.5,1,54.5,68,174,246,246,0,RB
3648,Michael Pittman,219,41,260,2004,29,TAM,13,13,219,926,4.2,7,71.2,41,41.1,65,41,391,9.5,3,30.1,63.1,6,13,40,260,926,1317,1317,0,RB
3649,Lousaka Polite,0,1,1,2004,23,DAL,1,0,0,0,,0,0,0,,1,1,4,4,0,4,100,4,0,0,1,0,4,4,0,RB
3650,Clinton Portis,343,40,383,2004,23,WAS,15,15,343,1315,3.8,5,87.7,67,44.3,57,40,235,5.9,2,15.7,70.2,4.1,10,36.8,383,1330,1550,1550,0,RB
3651,Stanley Pritchett,6,2,8,2004,31,ATL,14,2,6,18,3,0,1.3,1,33.3,4,2,5,2.5,1,0.4,50,1.3,1,50,8,18,23,25,2,FB
3652,J.R. Redmond,21,32,53,2004,27,OAK,16,1,21,119,5.7,0,7.4,5,47.6,50,32,233,7.3,0,14.6,64,4.7,7,28,53,119,352,505,153,RB
3653,Dominic Rhodes,53,2,55,2004,25,IND,16,0,53,254,4.8,1,15.9,16,45.3,4,2,24,12,0,1.5,50,6,1,50,55,254,278,1466,1188,RB
3654,Alan Ricard,10,11,21,2004,27,BAL,16,9,10,36,3.6,0,2.3,3,70,14,11,39,3.5,0,2.4,78.6,2.8,3,28.6,21,36,75,75,0,FB
3655,Tony Richardson,12,19,31,2004,33,KAN,16,16,12,56,4.7,0,3.5,3,50,26,19,118,6.2,0,7.4,73.1,4.5,4,34.6,31,56,174,174,0,FB
3656,Jon Ritchie,0,4,4,2004,30,PHI,3,0,0,0,,0,0,0,,6,4,36,9,0,12,66.7,6,2,66.7,4,0,36,36,0,FB
3657,Jamal Robertson,16,4,20,2004,27,"CAR,SFO",12,0,16,71,4.4,1,5.9,6,62.5,5,4,34,8.5,0,2.8,80,6.8,2,80,20,71,105,845,740,RB
3658,B.J. Sams,4,1,5,2004,24,BAL,16,1,4,19,4.8,1,1.2,2,75,5,1,2,2,0,0.1,20,0.4,0,0,5,19,21,1847,1826,RB
3659,Cecil Sapp,4,0,4,2004,26,DEN,5,0,4,32,8,0,6.4,2,75,2,0,0,,0,0,0,0,0,0,4,32,32,66,34,RB
3660,Cory Schlesinger,4,10,14,2004,32,DET,13,11,4,7,1.8,0,0.5,1,25,16,10,91,9.1,3,7,62.5,5.7,7,50,14,7,98,121,23,FB
3661,Josh Scobey,27,18,45,2004,25,ARI,12,0,27,89,3.3,0,7.4,7,40.7,21,18,191,10.6,0,15.9,85.7,9.1,8,47.6,45,89,280,1003,723,RB
3662,Mike Sellers,0,1,1,2004,29,WAS,16,1,0,0,,0,0,0,,2,1,14,14,0,0.9,50,7,1,50,1,0,14,70,56,RB
3663,Daimon Shelton,0,17,17,2004,32,BUF,16,12,0,0,,0,0,0,,24,17,114,6.7,0,7.1,70.8,4.8,6,41.7,17,0,114,139,25,FB
3664,Ian Smart,2,2,4,2004,24,TAM,4,0,2,26,13,0,6.5,1,50,2,2,10,5,0,2.5,100,5,1,100,4,26,36,203,167,RB
3665,Rod Smart,3,1,4,2004,27,CAR,3,0,3,4,1.3,0,1.3,0,0,1,1,5,5,0,1.7,100,5,0,0,4,4,9,178,169,RB
3666,Antowain Smith,137,22,159,2004,32,TEN,13,4,137,509,3.7,4,39.2,23,38.7,26,22,169,7.7,0,13,84.6,6.5,7,50,159,509,678,678,0,RB
3667,Emmitt Smith,267,15,282,2004,35,ARI,15,15,267,937,3.5,9,62.5,43,38.2,20,15,105,7,0,7,75,5.3,3,45,282,958,1042,1046,0,RB
3668,Musa Smith,12,2,14,2004,22,BAL,9,0,12,48,4,0,5.3,4,33.3,4,2,31,15.5,0,3.4,50,7.8,1,25,14,48,79,79,0,RB
3669,Onterrio Smith,124,36,160,2004,24,MIN,11,6,124,544,4.4,2,49.5,18,46,45,36,394,10.9,2,35.8,80,8.8,22,66.7,160,544,938,1093,155,RB
3670,Terrelle Smith,4,7,11,2004,26,CLE,16,9,4,9,2.3,0,0.6,3,100,12,7,39,5.6,0,2.4,58.3,3.3,2,33.3,11,9,48,48,0,FB
3671,Jerald Sowell,2,45,47,2004,30,NYJ,16,16,2,28,14,0,1.8,1,50,59,45,342,7.6,1,21.4,76.3,5.8,15,54.2,47,28,370,370,0,FB
3672,Duce Staley,192,6,198,2004,29,PIT,10,10,192,830,4.3,1,83,38,49,12,6,55,9.2,0,5.5,50,4.6,3,33.3,198,830,885,885,0,RB
3673,Matt Stanley,0,0,0,2004,25,SFO,1,0,0,0,,0,0,0,,0,0,0,,0,0,,,0,,0,0,0,0,0,FB
3674,Aaron Stecker,58,29,87,2004,29,NOR,16,3,58,244,4.2,2,15.3,11,36.2,38,29,174,6,0,10.9,76.3,4.6,8,34.2,87,244,418,873,469,RB
3675,Mack Strong,36,21,57,2004,33,SEA,16,13,36,131,3.6,0,8.2,13,52.8,31,21,99,4.7,0,6.2,67.7,3.2,8,35.5,57,131,230,230,0,FB
3676,Lee Suggs,199,20,219,2004,24,CLE,10,3,199,744,3.7,2,74.4,39,43.7,36,20,178,8.9,1,17.8,55.6,4.9,6,27.8,219,744,922,922,0,RB
3677,Thomas Tapeh,12,2,14,2004,24,PHI,7,0,12,42,3.5,0,6,2,33.3,2,2,15,7.5,0,2.1,100,7.5,1,50,14,42,57,57,0,FB
3678,Chester Taylor,160,30,190,2004,25,BAL,16,4,160,714,4.5,2,44.6,34,41.3,38,30,184,6.1,0,11.5,78.9,4.8,10,47.4,190,714,898,898,0,RB
3679,Fred Taylor,260,36,296,2004,28,JAX,14,14,260,1224,4.7,2,87.4,49,42.7,58,36,345,9.6,1,24.6,62.1,5.9,18,41.4,296,1224,1569,1569,0,RB
3680,Anthony Thomas,122,17,139,2004,27,CHI,12,2,122,404,3.3,2,33.7,16,38.5,23,17,132,7.8,0,11,73.9,5.7,5,30.4,139,404,536,536,0,RB
3681,LaBrandon Toefield,51,28,79,2004,24,JAX,14,0,51,169,3.3,0,12.1,7,49,34,28,151,5.4,1,10.8,82.4,4.4,13,52.9,79,162,320,363,43,RB
3682,LaDainian Tomlinson,339,53,392,2004,25,SDG,15,15,339,1335,3.9,17,89,74,43.4,66,53,441,8.3,1,29.4,80.3,6.7,16,40.9,392,1372,1776,1776,0,RB
3683,Stephen Trejo,0,4,4,2004,27,"DET,STL",13,2,0,0,,0,0,0,,4,4,37,9.3,0,2.8,100,9.3,3,100,4,0,37,49,12,FB
3684,Michael Turner,20,4,24,2004,22,SDG,14,1,20,104,5.2,0,7.4,4,35,5,4,8,2,0,0.6,80,1.6,0,20,24,104,112,130,18,RB
3685,Derrick Ward,0,0,0,2004,24,NYG,5,0,0,0,,0,0,0,,0,0,0,,0,0,,,0,,0,0,0,436,436,RB
3686,Kenny Watson,26,25,51,2004,26,CIN,16,0,26,161,6.2,0,10.1,8,50,35,25,171,6.8,1,10.7,71.4,4.9,9,34.3,51,161,332,572,240,RB
3687,Jonathan Wells,82,11,93,2004,25,HOU,16,1,82,299,3.6,3,18.7,17,45.1,16,11,79,7.2,2,4.9,68.8,4.9,3,37.5,93,299,378,405,27,RB
3688,Brian Westbrook,177,73,250,2004,25,PHI,13,12,177,812,4.6,3,62.5,41,41.8,87,73,703,9.6,6,54.1,83.9,8.1,30,50.6,250,808,1515,1529,14,RB
3689,Tyrone Wheatley,85,15,100,2004,32,OAK,8,7,85,327,3.8,4,40.9,25,50.6,15,15,78,5.2,0,9.8,100,5.2,4,40,100,327,405,405,0,RB
3690,Jamel White,27,6,33,2004,27,"BAL,TAM",13,0,27,82,3,0,6.3,2,25.9,9,6,21,3.5,0,1.6,66.7,2.3,1,11.1,33,82,103,202,99,RB
3691,Moe Williams,30,21,51,2004,30,MIN,14,1,30,161,5.4,3,11.5,13,66.7,27,21,233,11.1,1,16.6,77.8,8.6,10,44.4,51,161,394,394,0,RB
3692,Nick Luchey,10,2,12,2004,27,GNB,16,6,10,24,2.4,0,1.5,4,60,4,2,20,10,0,1.3,50,5,2,50,12,24,44,44,0,FB
3693,Shaud Williams,42,3,45,2004,24,BUF,4,0,42,167,4,2,41.8,9,42.9,3,3,19,6.3,0,4.8,100,6.3,0,33.3,45,167,186,186,0,RB
3694,Walter Williams,6,0,6,2004,27,GNB,1,0,6,42,7,0,42,1,33.3,0,0,0,,0,0,,,0,,6,42,42,42,0,RB
3695,Jason Wright,3,0,3,2004,22,ATL,2,0,3,10,3.3,0,5,0,0,1,0,0,,0,0,0,0,0,0,3,10,10,10,0,RB
3696,Amos Zereoue,112,39,151,2004,28,OAK,15,6,112,425,3.8,3,28.3,20,41.1,48,39,284,7.3,0,18.9,81.3,5.9,12,54.2,151,425,709,709,0,RB
3697,Rabih Abdullah,18,8,26,2003,28,CHI,15,0,18,37,2.1,0,2.5,4,27.8,9,8,55,6.9,0,3.7,88.9,6.1,3,33.3,26,37,92,154,62,RB
3698,Dan Alexander,0,0,0,2003,25,STL,1,0,0,0,,0,0,0,,0,0,0,,0,0,,,0,,0,0,0,0,0,RB
3699,Shaun Alexander,326,42,368,2003,26,SEA,16,15,326,1435,4.4,14,89.7,81,46.6,59,42,295,7,2,18.4,71.2,5,17,45.8,368,1435,1730,1730,0,RB
3700,Brian Allen,0,0,0,2003,23,IND,4,0,0,0,,0,0,0,,0,0,0,,0,0,,,0,,0,0,0,6,6,RB
3701,David Allen,4,6,10,2003,25,JAX,14,0,4,8,2,0,0.6,1,25,7,6,60,10,1,4.3,85.7,8.6,3,71.4,10,8,68,1223,1155,RB
3702,Mike Alstott,27,10,37,2003,30,TAM,4,3,27,77,2.9,2,19.3,9,44.4,12,10,83,8.3,0,20.8,83.3,6.9,2,66.7,37,77,160,160,0,RB
3703,Damien Anderson,18,6,24,2003,24,ARI,16,0,18,68,3.8,0,4.3,5,44.4,12,6,36,6,0,2.3,50,3,2,33.3,24,68,104,135,31,RB
3704,Mike Anderson,70,12,82,2003,30,DEN,12,5,70,257,3.7,3,21.4,17,41.4,15,12,53,4.4,2,4.4,80,3.5,3,46.7,82,257,310,324,14,FB
3705,Richie Anderson,70,69,139,2003,32,DAL,15,8,70,306,4.4,1,20.4,16,44.3,87,69,493,7.1,4,32.9,79.3,5.7,21,43.7,139,306,799,799,0,FB
3706,B.J. Askew,2,0,2,2003,23,NYJ,16,0,2,9,4.5,0,0.6,1,100,0,0,0,,0,0,,,0,,2,9,9,36,27,FB
3707,John Avery,1,2,3,2003,27,MIN,6,0,1,0,0,0,0,0,0,4,2,24,12,1,4,50,6,2,50,3,0,24,370,346,RB
3708,Obafemi Ayanbadejo,1,12,13,2003,28,MIA,16,2,1,-2,-2,0,-0.1,0,0,13,12,53,4.4,0,3.3,92.3,4.1,4,30.8,13,-2,51,51,0,RB
3709,Tiki Barber,278,69,347,2003,28,NYG,16,16,278,1216,4.4,2,76,68,47.5,98,69,461,6.7,1,28.8,70.4,4.7,26,43.9,347,1216,1677,1677,0,RB
3710,Kevan Barlow,201,35,236,2003,24,SFO,16,4,201,1024,5.1,6,64,44,49.8,44,35,307,8.8,1,19.2,79.5,7,14,47.7,236,1024,1331,1331,0,RB
3711,Darian Barnes,0,1,1,2003,23,TAM,14,0,0,0,,0,0,0,,1,1,6,6,0,0.4,100,6,1,100,1,0,6,6,0,FB
3712,Michael Bates,0,0,0,2003,34,"DAL,NYJ",9,0,0,0,,0,0,0,,0,0,0,,0,0,,,0,,0,0,0,686,686,RB
3713,Fred Beasley,17,19,36,2003,29,SFO,16,11,17,24,1.4,0,1.5,4,23.5,28,19,184,9.7,1,11.5,67.9,6.6,6,42.9,36,24,208,208,0,FB
3714,Brandon Bennett,56,25,81,2003,30,CIN,16,0,56,173,3.1,0,10.8,11,32.1,32,25,176,7,1,11,78.1,5.5,7,37.5,81,173,349,1496,1146,RB
3715,Michael Bennett,90,12,102,2003,25,MIN,8,7,90,447,5,1,55.9,18,45.6,14,12,132,11,0,16.5,85.7,9.4,4,57.1,102,447,579,579,0,RB
3716,Jerome Bettis,246,13,259,2003,31,PIT,16,10,246,811,3.3,7,50.7,44,46.7,22,13,86,6.6,0,5.4,59.1,3.9,5,36.4,259,811,897,897,0,RB
3717,Ladell Betts,77,15,92,2003,24,WAS,9,1,77,255,3.3,2,28.3,16,48.1,23,15,167,11.1,0,18.6,65.2,7.3,8,39.1,92,255,422,481,59,RB
3718,Erik Bickerstaff,19,0,19,2003,23,DAL,4,0,19,56,2.9,1,14,3,42.1,0,0,0,,0,0,,,0,,19,56,56,80,24,RB
3719,Derrick Blaylock,22,15,37,2003,24,KAN,16,0,22,112,5.1,2,7,7,50,22,15,181,12.1,1,11.3,68.2,8.2,5,36.4,37,112,293,325,32,RB
3720,R.J. Bowers,0,1,1,2003,29,CLE,1,0,0,0,,0,0,0,,2,1,2,2,1,2,50,1,1,50,1,0,2,2,0,RB
3721,Chris Brown,56,8,64,2003,22,TEN,11,0,56,221,3.9,0,20.1,9,39.3,9,8,61,7.6,0,5.5,88.9,6.8,5,66.7,64,221,282,282,0,RB
3722,Dee Brown,0,0,0,2003,25,PIT,1,0,0,0,,0,0,0,,0,0,0,,0,0,,,0,,0,0,0,0,0,RB
3723,Shawn Bryson,158,54,212,2003,27,DET,16,13,158,606,3.8,3,37.9,32,40.5,72,54,340,6.3,0,21.3,75,4.7,10,33.3,212,606,946,946,0,RB
3724,Correll Buckhalter,126,10,136,2003,25,PHI,15,5,126,542,4.3,8,36.1,31,46.8,14,10,133,13.3,1,8.9,71.4,9.5,6,57.1,136,542,675,675,0,RB
3725,Joe Burns,39,7,46,2003,24,BUF,16,1,39,113,2.9,0,7.1,3,33.3,9,7,62,8.9,0,3.9,77.8,6.9,3,44.4,46,113,175,192,17,RB
3726,Trung Canidate,142,10,152,2003,26,WAS,11,10,142,600,4.2,1,54.5,27,43,15,10,71,7.1,1,6.5,66.7,4.7,4,40,152,600,671,671,0,RB
3727,Kerry Carter,3,0,3,2003,23,SEA,16,0,3,-2,-0.7,0,-0.1,0,0,0,0,0,,0,0,,,0,,3,-2,-2,183,185,RB
3728,Ki-Jana Carter,19,1,20,2003,30,NOR,8,0,19,72,3.8,1,9,4,31.6,3,1,11,11,0,1.4,33.3,3.7,1,33.3,20,72,83,83,0,RB
3729,Rock Cartwright,107,18,125,2003,24,WAS,15,3,107,411,3.8,4,27.4,36,53.3,28,18,176,9.8,0,11.7,64.3,6.3,5,35.7,125,411,587,613,26,FB
3730,Aveion Cason,40,17,57,2003,24,DAL,10,0,40,220,5.5,2,22,7,32.5,20,17,142,8.4,0,14.2,85,7.1,3,25,57,257,362,443,81,RB
3731,Larry Centers,21,19,40,2003,35,NWE,9,3,21,82,3.9,0,9.1,2,38.1,34,19,106,5.6,1,11.8,55.9,3.1,9,29.4,40,82,188,188,0,FB
3732,Doug Chapman,15,1,16,2003,26,MIN,4,0,15,33,2.2,0,8.3,1,26.7,1,1,8,8,0,2,100,8,1,100,16,33,41,92,51,RB
3733,Jesse Chatman,8,5,13,2003,24,SDG,16,0,8,17,2.1,0,1.1,0,25,5,5,54,10.8,0,3.4,100,10.8,1,100,13,17,71,102,31,RB
3734,Mike Cloud,27,1,28,2003,28,NWE,5,1,27,118,4.4,5,23.6,12,51.9,2,1,8,8,0,1.6,50,4,0,0,28,118,126,164,38,RB
3735,Avon Cobourne,10,4,14,2003,24,DET,7,0,10,27,2.7,0,3.9,1,20,9,4,30,7.5,0,4.3,44.4,3.3,0,22.2,14,27,57,180,123,RB
3736,Greg Comella,0,0,0,2003,28,HOU,5,0,0,0,,0,0,0,,1,0,0,,0,0,0,0,0,0,0,0,0,0,0,FB
3737,Jameel Cook,1,20,21,2003,24,TAM,14,8,1,-1,-1,0,-0.1,0,0,30,20,120,6,1,8.6,66.7,4,8,36.7,21,-1,119,119,0,FB
3738,Zack Crockett,48,7,55,2003,31,OAK,16,7,48,145,3,7,9.1,19,45.8,12,7,53,7.6,0,3.3,58.3,4.4,2,33.3,55,145,198,198,0,FB
3739,Phillip Crosby,0,0,0,2003,27,BUF,3,0,0,0,,0,0,0,,0,0,0,,0,0,,,0,,0,0,0,0,0,FB
3740,Dan Curley,0,0,0,2003,25,STL,1,0,0,0,,0,0,0,,0,0,0,,0,0,,,0,,0,0,0,0,0,FB
3741,Woodrow Dantzler,8,0,8,2003,24,ATL,9,0,8,21,2.6,1,2.3,2,37.5,0,0,0,,0,0,,,0,,8,16,21,163,142,RB
3742,Najeh Davenport,77,6,83,2003,24,GNB,15,0,77,420,5.5,2,28,18,51.9,10,6,38,6.3,0,2.5,60,3.8,2,40,83,420,458,955,505,RB
3743,Chris Davis,0,0,0,2003,24,SEA,1,0,0,0,,0,0,0,,0,0,0,,0,0,,,0,,0,0,0,0,0,FB
3744,Domanick Williams,238,47,285,2003,23,HOU,14,10,238,1031,4.3,8,73.6,48,39.5,68,47,351,7.5,0,25.1,69.1,5.2,15,45.6,285,1031,1382,1443,61,RB
3745,Stephen Davis,318,14,332,2003,29,CAR,14,14,318,1444,4.5,8,103.1,69,45.6,17,14,159,11.4,0,11.4,82.4,9.4,8,70.6,332,1444,1603,1603,0,RB
3746,Corey Dillon,138,11,149,2003,29,CIN,13,11,138,541,3.9,2,41.6,27,42,18,11,71,6.5,0,5.5,61.1,3.9,4,38.9,149,541,612,612,0,RB
3747,Reuben Droughns,6,9,15,2003,25,DEN,15,4,6,14,2.3,0,0.9,1,16.7,12,9,87,9.7,2,5.8,75,7.3,7,75,15,14,101,394,293,RB
3748,T.J. Duckett,197,11,208,2003,22,ATL,16,10,197,779,4,11,48.7,39,45.7,13,11,94,8.5,0,5.9,84.6,7.2,1,53.8,208,779,873,873,0,RB
3749,Warrick Dunn,125,37,162,2003,28,ATL,11,6,125,672,5.4,3,61.1,28,42.4,52,37,336,9.1,2,30.5,71.2,6.5,14,36.5,162,669,1008,1008,0,RB
3750,Omar Easy,0,3,3,2003,26,KAN,15,0,0,0,,0,0,0,,5,3,19,6.3,0,1.3,60,3.8,0,0,3,0,19,19,0,FB
3751,Chris Edmonds,0,0,0,2003,25,CIN,4,0,0,0,,0,0,0,,0,0,0,,0,0,,,0,,0,0,0,0,0,FB
3752,Marc Edwards,7,31,38,2003,29,JAX,16,16,7,13,1.9,1,0.8,4,57.1,43,31,226,7.3,0,14.1,72.1,5.3,11,46.5,38,13,239,283,44,FB
3753,Heath Evans,7,2,9,2003,25,SEA,14,0,7,24,3.4,0,1.7,1,42.9,2,2,34,17,0,2.4,100,17,2,100,9,24,58,72,14,FB
3754,Justin Fargas,40,2,42,2003,23,OAK,10,1,40,203,5.1,0,20.3,10,37.5,3,2,2,1,0,0.2,66.7,0.7,0,0,42,203,205,520,315,FB
3755,Kevin Faulk,178,48,226,2003,27,NWE,15,8,178,638,3.6,0,42.5,30,42.1,67,48,440,9.2,0,29.3,71.6,6.6,20,53.7,226,638,1078,1351,273,RB
3756,Marshall Faulk,209,45,254,2003,30,STL,11,11,209,818,3.9,10,74.4,51,43.1,61,45,290,6.4,1,26.4,73.8,4.8,11,36.1,254,818,1108,1108,0,RB
3757,James Fenderson,4,1,5,2003,27,NOR,9,0,4,14,3.5,0,1.6,0,0,1,1,5,5,0,0.6,100,5,0,0,5,14,19,19,0,RB
3758,Jim Finn,0,14,14,2003,27,NYG,15,9,0,0,,0,0,0,,20,14,115,8.2,0,7.7,70,5.8,5,50,14,0,115,134,19,FB
3759,Tony Fisher,40,21,61,2003,24,GNB,15,0,40,200,5,1,13.3,9,35,25,21,206,9.8,2,13.7,84,8.2,10,52,61,200,406,406,0,RB
3760,Brock Forsey,50,3,53,2003,23,CHI,9,2,50,191,3.8,2,21.2,12,52,5,3,37,12.3,0,4.1,60,7.4,3,60,53,191,228,228,0,RB
3761,DeShaun Foster,113,26,139,2003,23,CAR,14,2,113,429,3.8,0,30.6,23,32.7,35,26,207,8,2,14.8,74.3,5.9,7,45.7,139,429,636,636,0,RB
3762,Chris Fuamatu-Ma'afala,35,1,36,2003,26,JAX,13,0,35,144,4.1,1,11.1,12,57.1,2,1,2,2,0,0.2,50,1,0,0,36,144,146,146,0,RB
3763,Charlie Garner,120,48,168,2003,31,OAK,14,9,120,553,4.6,3,39.5,27,44.2,70,48,386,8,1,27.6,68.6,5.5,15,34.3,168,553,939,939,0,RB
3764,Olandis Gary,113,13,126,2003,28,DET,13,1,113,384,3.4,2,29.5,18,36.3,22,13,69,5.3,0,5.3,59.1,3.1,4,27.3,126,384,453,453,0,RB
3765,Sam Gash,1,11,12,2003,34,BUF,16,10,1,3,3,0,0.2,0,0,13,11,83,7.5,0,5.2,84.6,6.4,5,53.8,12,3,86,86,0,FB
3766,Eddie George,312,22,334,2003,30,TEN,16,16,312,1031,3.3,5,64.4,52,38.5,31,22,163,7.4,0,10.2,71,5.3,7,48.4,334,1031,1194,1195,0,RB
3767,Nick Goings,10,12,22,2003,25,CAR,15,0,10,69,6.9,0,4.6,4,80,14,12,97,8.1,1,6.5,85.7,6.9,7,64.3,22,69,166,166,0,RB
3768,Joey Goodspeed,0,0,0,2003,25,STL,8,4,0,0,,0,0,0,,1,0,0,,0,0,0,0,0,0,0,0,0,1,1,FB
3769,Lamar Gordon,71,8,79,2003,23,STL,10,4,71,298,4.2,1,29.8,22,47.9,13,8,59,7.4,0,5.9,61.5,4.5,2,30.8,79,298,357,357,0,RB
3770,Ahman Green,355,50,405,2003,26,GNB,16,16,355,1883,5.3,15,117.7,100,49.3,60,50,367,7.3,5,22.9,83.3,6.1,21,53.3,405,1883,2250,2250,0,RB
3771,William Green,142,10,152,2003,24,CLE,7,7,142,559,3.9,1,79.9,30,45.8,14,10,50,5,0,7.1,71.4,3.6,3,42.9,152,559,609,609,0,RB
3772,Justin Griffith,38,21,59,2003,23,ATL,16,11,38,168,4.4,0,10.5,13,63.2,34,21,122,5.8,2,7.6,61.8,3.6,6,29.4,59,168,290,290,0,FB
3773,Quentin Griffin,94,8,102,2003,22,DEN,10,1,94,345,3.7,0,34.5,16,39.4,11,8,61,7.6,0,6.1,72.7,5.5,4,54.5,102,345,406,406,0,RB
3774,Troy Hambrick,275,17,292,2003,27,DAL,16,16,275,972,3.5,5,60.8,58,42.9,24,17,99,5.8,0,6.2,70.8,4.1,2,37.5,292,972,1071,1071,0,RB
3775,Arlen Harris,85,15,100,2003,23,STL,16,2,85,255,3,4,15.9,16,42.4,19,15,102,6.8,0,6.4,78.9,5.4,5,36.8,100,255,357,1568,1211,RB
3776,Verron Haynes,20,7,27,2003,24,PIT,12,0,20,63,3.2,0,5.3,3,30,10,7,57,8.1,0,4.8,70,5.7,2,30,27,63,120,120,0,RB
3777,Garrison Hearst,178,25,203,2003,32,SFO,12,12,178,768,4.3,3,64,41,41,38,25,211,8.4,1,17.6,65.8,5.6,7,34.2,203,768,979,979,0,RB
3778,William Henderson,0,24,24,2003,32,GNB,16,12,0,0,,0,0,0,,34,24,214,8.9,3,13.4,70.6,6.3,14,50,24,0,214,247,33,FB
3779,Travis Henry,331,28,359,2003,25,BUF,15,15,331,1356,4.1,10,90.4,77,44.1,40,28,158,5.6,1,10.5,70,4,9,37.5,359,1356,1514,1514,0,RB
3780,Chris Hetherington,0,2,2,2003,31,OAK,14,1,0,0,,0,0,0,,4,2,23,11.5,0,1.6,50,5.8,1,50,2,0,23,23,0,FB
3781,Dwone Hicks,0,0,0,2003,22,TEN,3,0,0,0,,0,0,0,,0,0,0,,0,0,,,0,,0,0,0,0,0,RB
3782,James Hodgins,2,14,16,2003,26,ARI,16,8,2,6,3,0,0.4,1,50,19,14,58,4.1,2,3.6,73.7,3.1,2,47.4,16,6,64,77,13,FB
3783,Robert Holcombe,63,19,82,2003,28,TEN,15,0,63,201,3.2,1,13.4,11,27,25,19,121,6.4,1,8.1,76,4.8,4,36,82,201,322,389,38,RB
3784,Tony Hollings,38,2,40,2003,22,HOU,14,1,38,102,2.7,0,7.3,5,28.9,6,2,25,12.5,0,1.8,33.3,4.2,1,16.7,40,102,127,269,142,RB
3785,Priest Holmes,320,74,394,2003,30,KAN,16,16,320,1420,4.4,27,88.8,90,57.5,90,74,690,9.3,0,43.1,82.2,7.7,35,56.7,394,1420,2110,2110,0,RB
3786,Brad Hoover,6,12,18,2003,27,CAR,16,9,6,21,3.5,0,1.3,2,83.3,20,12,72,6,1,4.5,60,3.6,3,40,18,21,93,93,0,FB
3787,Jasen Isom,0,0,0,2003,26,SFO,2,0,0,0,,0,0,0,,0,0,0,,0,0,,,0,,0,0,0,0,0,FB
3788,James Jackson,102,14,116,2003,27,CLE,12,6,102,382,3.7,3,31.8,22,54.9,18,14,114,8.1,0,9.5,77.8,6.3,4,61.1,116,382,496,564,68,RB
3789,Ray Jackson,0,0,0,2003,25,TEN,1,0,0,0,,0,0,0,,0,0,0,,0,0,,,0,,0,0,0,77,77,RB
3790,Terry Jackson,0,0,0,2003,27,SFO,16,0,0,0,,0,0,0,,0,0,0,,0,0,,,0,,0,0,0,0,0,FB
3791,Edgerrin James,310,51,361,2003,25,IND,13,13,310,1259,4.1,11,96.8,84,49.4,71,51,292,5.7,0,22.5,71.8,4.1,9,39.4,361,1259,1551,1551,0,RB
3792,Ronney Jenkins,0,0,0,2003,26,OAK,7,0,0,0,,0,0,0,,1,0,0,,0,0,0,0,0,0,0,0,0,553,553,RB
3793,Travis Jervey,0,0,0,2003,31,ATL,15,0,0,0,,0,0,0,,0,0,0,,0,0,,,0,,0,0,0,118,118,RB
3794,Bryan Johnson,2,9,11,2003,25,WAS,16,11,2,5,2.5,0,0.3,0,0,12,9,71,7.9,0,4.4,75,5.9,3,50,11,5,76,91,15,FB
3795,Jeremi Johnson,15,15,30,2003,23,CIN,16,13,15,41,2.7,1,2.6,5,46.7,20,15,82,5.5,1,5.1,75,4.1,4,40,30,41,123,139,16,FB
3796,Larry Johnson,20,1,21,2003,24,KAN,6,0,20,85,4.3,1,14.2,6,45,3,1,2,2,0,0.3,33.3,0.7,0,0,21,85,87,87,0,RB
3797,Leon Johnson,4,0,4,2003,29,SDG,14,0,4,26,6.5,0,1.9,1,25,2,0,0,,0,0,0,0,0,0,4,26,26,1361,1335,RB
3798,Rudi Johnson,215,21,236,2003,24,CIN,13,5,215,957,4.5,9,73.6,51,46,23,21,146,7,0,11.2,91.3,6.3,9,56.5,236,957,1103,1126,23,RB
3799,Thomas Jones,137,24,161,2003,25,TAM,16,3,137,627,4.6,3,39.2,24,42.3,31,24,180,7.5,0,11.3,77.4,5.8,9,45.2,161,627,807,1078,271,RB
3800,LaMont Jordan,46,11,57,2003,25,NYJ,16,0,46,190,4.1,4,11.9,14,47.8,13,11,101,9.2,0,6.3,84.6,7.8,5,46.2,57,190,291,500,209,RB
3801,Delvin Joyce,11,3,14,2003,25,NYG,16,0,11,39,3.5,0,2.4,2,36.4,5,3,7,2.3,0,0.4,60,1.4,0,20,14,39,46,364,318,RB
3802,Rob Konrad,4,16,20,2003,27,MIA,14,12,4,17,4.3,0,1.2,1,50,19,16,166,10.4,0,11.9,84.2,8.7,9,78.9,20,17,183,183,0,FB
3803,Dan Kreider,7,9,16,2003,26,PIT,16,12,7,29,4.1,1,1.8,1,71.4,24,9,107,11.9,0,6.7,37.5,4.5,5,29.2,16,29,136,165,29,FB
3804,George Layne,1,1,2,2003,25,ATL,3,0,1,15,15,0,5,1,100,2,1,3,3,0,1,50,1.5,0,0,2,15,18,18,0,RB
3805,Dorsey Levens,68,5,73,2003,33,NYG,11,0,68,197,2.9,3,17.9,16,35.3,7,5,39,7.8,0,3.5,71.4,5.6,2,57.1,73,197,236,236,0,RB
3806,Jamal Lewis,387,26,413,2003,24,BAL,16,16,387,2066,5.3,14,129.1,85,45.2,38,26,205,7.9,0,12.8,68.4,5.4,10,47.4,413,2066,2271,2271,0,RB
3807,Tom Lopienski,0,0,0,2003,24,IND,4,0,0,0,,0,0,0,,0,0,0,,0,0,,,0,,0,0,0,0,0,FB
3808,Malaefou MacKenzie,0,0,0,2003,24,JAX,1,0,0,0,,0,0,0,,0,0,0,,0,0,,,0,,0,0,0,0,0,FB
3809,Stacey Mack,93,9,102,2003,28,HOU,8,5,93,253,2.7,4,31.6,15,34.4,12,9,55,6.1,0,6.9,75,4.6,3,50,102,253,308,308,0,RB
3810,Nick Maddox,0,0,0,2003,23,CLE,1,0,0,0,,0,0,0,,0,0,0,,0,0,,,0,,0,0,0,58,58,RB
3811,Reno Mahe,0,1,1,2003,23,PHI,2,0,0,0,,0,0,0,,2,1,5,5,0,2.5,50,2.5,0,0,1,0,5,60,55,RB
3812,Cecil Martin,0,0,0,2003,28,TAM,1,0,0,0,,0,0,0,,0,0,0,,0,0,,,0,,0,0,0,0,0,FB
3813,Curtis Martin,323,42,365,2003,30,NYJ,16,16,323,1308,4,2,81.8,57,44.6,53,42,262,6.2,0,16.4,79.2,4.9,9,35.8,365,1308,1570,1570,0,RB
3814,Jamar Martin,4,2,6,2003,23,DAL,14,1,4,7,1.8,0,0.5,2,50,4,2,9,4.5,0,0.6,50,2.3,1,50,6,7,16,16,0,FB
3815,Chris Massey,1,0,1,2003,24,STL,16,0,1,-1,-1,0,-0.1,1,0,0,0,0,,0,0,,,0,,1,-1,-1,-1,0,RB
3816,Fred McAfee,1,0,1,2003,35,NOR,14,0,1,13,13,0,0.9,1,100,0,0,0,,0,0,,,0,,1,13,13,153,140,RB
3817,Deuce McAllister,351,69,420,2003,25,NOR,16,16,351,1641,4.7,8,102.6,69,40.7,87,69,516,7.5,0,32.3,79.3,5.9,23,49.4,420,1641,2157,2154,0,RB
3818,Fred McCrary,3,2,5,2003,31,NWE,6,3,3,3,1,0,0.5,1,33.3,5,2,12,6,0,2,40,2.4,1,20,5,3,15,15,0,FB
3819,Sultan McCullough,1,3,4,2003,23,WAS,1,0,1,9,9,0,9,0,0,3,3,13,4.3,0,13,100,4.3,0,0,4,9,22,22,0,RB
3820,Jason McKie,0,0,0,2003,23,CHI,6,0,0,0,,0,0,0,,0,0,0,,0,0,,,0,,0,0,0,0,0,FB
3821,Kevin McLeod,0,0,0,2003,29,CLE,1,1,0,0,,0,0,0,,0,0,0,,0,0,,,0,,0,0,0,0,0,FB
3822,Travis Minor,41,4,45,2003,24,MIA,16,0,41,193,4.7,1,12.1,13,48.8,5,4,13,3.3,0,0.8,80,2.6,1,20,45,193,206,933,727,RB
3823,Brian Mitchell,4,4,8,2003,35,NYG,16,0,4,20,5,1,1.3,2,50,5,4,38,9.5,0,2.4,80,7.6,1,40,8,20,58,1329,1271,RB
3824,Harold Morrow,0,0,0,2003,30,BAL,14,0,0,0,,0,0,0,,0,0,0,,0,0,,,0,,0,0,0,0,0,FB
3825,Maurice Morris,38,4,42,2003,24,SEA,16,1,38,239,6.3,0,14.9,10,42.1,6,4,32,8,1,2,66.7,5.3,2,66.7,42,239,271,1278,1007,RB
3826,Sammy Morris,19,14,33,2003,26,BUF,9,0,19,70,3.7,1,7.8,7,52.6,17,14,100,7.1,0,11.1,82.4,5.9,4,29.4,33,70,170,316,146,RB
3827,Chad Morton,48,15,63,2003,26,WAS,15,2,48,216,4.5,0,14.4,10,50,26,15,187,12.5,1,12.5,57.7,7.2,7,42.3,63,216,403,1620,1217,RB
3828,Ovie Mughelli,0,0,0,2003,23,BAL,6,0,0,0,,0,0,0,,0,0,0,,0,0,,,0,,0,0,0,0,0,FB
3829,James Mungro,24,1,25,2003,25,IND,7,0,24,60,2.5,2,8.6,5,37.5,5,1,-4,-4,0,-0.6,20,-0.8,0,0,25,60,56,63,7,RB
3830,Adrian Murrell,28,4,32,2003,33,DAL,3,0,28,107,3.8,0,35.7,6,46.4,4,4,32,8,0,10.7,100,8,2,75,32,107,139,139,0,RB
3831,Spencer Nead,0,1,1,2003,26,STL,10,0,0,0,,0,0,0,,1,1,6,6,0,0.6,100,6,0,0,1,0,6,33,27,FB
3832,Lorenzo Neal,18,16,34,2003,33,SDG,16,15,18,40,2.2,1,2.5,7,55.6,25,16,62,3.9,0,3.9,64,2.5,2,20,34,40,102,103,1,FB
3833,Larry Ned,0,0,0,2003,25,MIN,3,0,0,0,,0,0,0,,0,0,0,,0,0,,,0,,0,0,0,0,0,RB
3834,Moran Norris,0,7,7,2003,25,HOU,16,9,0,0,,0,0,0,,10,7,40,5.7,0,2.5,70,4,1,40,7,0,40,111,71,FB
3835,Patrick Pass,6,4,10,2003,25,NWE,13,1,6,27,4.5,0,2.1,2,83.3,8,4,21,5.3,0,1.6,50,2.6,1,25,10,27,48,302,254,FB
3836,Adrian Peterson,22,1,23,2003,24,CHI,6,1,22,70,3.2,0,11.7,4,50,1,1,5,5,0,0.8,100,5,0,0,23,70,75,75,0,RB
3837,Andrew Pinnock,0,0,0,2003,23,SDG,16,0,0,0,,0,0,0,,0,0,0,,0,0,,,0,,0,0,0,50,50,FB
3838,Artose Pinner,39,5,44,2003,25,DET,3,2,39,99,2.5,0,33,3,30.8,7,5,40,8,0,13.3,71.4,5.7,2,57.1,44,99,139,139,0,RB
3839,Michael Pittman,187,75,262,2003,28,TAM,16,13,187,751,4,0,46.9,39,47.6,121,75,597,8,2,37.3,62,4.9,23,36.4,262,751,1348,1348,0,RB
3840,Clinton Portis,290,38,328,2003,22,DEN,13,13,290,1591,5.5,14,122.4,79,51,51,38,314,8.3,0,24.2,74.5,6.2,10,37.3,328,1591,1905,1905,0,RB
3841,Stanley Pritchett,21,18,39,2003,30,CHI,16,11,21,93,4.4,2,5.8,8,57.1,27,18,83,4.6,0,5.2,66.7,3.1,5,25.9,39,93,176,176,0,FB
3842,J.R. Redmond,9,1,10,2003,26,OAK,1,0,9,30,3.3,0,30,2,44.4,2,1,6,6,0,6,50,3,0,50,10,30,36,36,0,RB
3843,Joffrey Reynolds,0,0,0,2003,24,STL,4,0,0,0,,0,0,0,,0,0,0,,0,0,,,0,,0,0,0,109,109,RB
3844,Dominic Rhodes,37,6,43,2003,24,IND,11,0,37,157,4.2,0,14.3,6,40.5,7,6,62,10.3,1,5.6,85.7,8.9,3,57.1,43,157,219,630,411,RB
3845,Alan Ricard,19,9,28,2003,26,BAL,16,13,19,79,4.2,0,4.9,5,36.8,15,9,62,6.9,0,3.9,60,4.1,4,33.3,28,79,141,191,0,FB
3846,Tony Richardson,24,12,36,2003,32,KAN,16,10,24,60,2.5,0,3.8,5,41.7,16,12,76,6.3,0,4.8,75,4.8,3,50,36,60,136,136,0,FB
3847,Jon Ritchie,1,17,18,2003,29,PHI,16,7,1,1,1,0,0.1,0,0,26,17,86,5.1,3,5.4,65.4,3.3,8,53.8,18,1,87,87,0,FB
3848,Jamal Robertson,32,0,32,2003,26,SFO,9,0,32,136,4.3,0,15.1,7,31.3,2,0,0,,0,0,0,0,0,0,32,136,136,136,0,RB
3849,Charlie Rogers,0,0,0,2003,27,MIA,11,0,0,0,,0,0,0,,1,0,0,,0,0,0,0,0,0,0,0,0,569,569,RB
3850,Cecil Sapp,12,0,12,2003,25,DEN,1,0,12,31,2.6,0,31,1,25,0,0,0,,0,0,,,0,,12,31,31,31,0,RB
3851,Cory Schlesinger,9,34,43,2003,31,DET,16,10,9,16,1.8,0,1,5,55.6,49,34,247,7.3,2,15.4,69.4,5,11,44.9,43,16,263,286,23,FB
3852,Josh Scobey,0,1,1,2003,24,ARI,15,0,0,0,,0,0,0,,1,1,9,9,0,0.6,100,9,0,0,1,0,9,1693,1684,RB
3853,Marcel Shipp,228,30,258,2003,25,ARI,16,11,228,830,3.6,0,51.9,37,42.1,37,30,184,6.1,0,11.5,81.1,5,6,32.4,258,830,1014,1014,0,RB
3854,John Simon,3,3,6,2003,25,WAS,4,0,3,9,3,0,2.3,0,33.3,3,3,21,7,0,5.3,100,7,1,66.7,6,9,30,51,21,RB
3855,Ken Simonton,2,0,2,2003,24,BUF,2,0,2,4,2,0,2,0,0,0,0,0,,0,0,,,0,,2,4,4,4,0,RB
3856,Rod Smart,20,3,23,2003,26,CAR,16,0,20,49,2.5,0,3.1,3,30,3,3,11,3.7,0,0.7,100,3.7,1,33.3,23,49,60,1007,947,RB
3857,Antowain Smith,182,14,196,2003,31,NWE,13,6,182,642,3.5,3,49.4,31,42.9,16,14,92,6.6,0,7.1,87.5,5.8,5,43.8,196,642,734,734,0,RB
3858,Detron Smith,0,0,0,2003,29,IND,11,0,0,0,,0,0,0,,0,0,0,,0,0,,,0,,0,0,0,15,15,RB
3859,Emmitt Smith,90,14,104,2003,34,ARI,10,5,90,256,2.8,2,25.6,15,38.9,19,14,107,7.6,0,10.7,73.7,5.6,4,42.1,104,256,363,344,0,RB
3860,Lamar Smith,11,1,12,2003,33,NOR,4,0,11,61,5.5,0,15.3,4,72.7,1,1,2,2,0,0.5,100,2,1,0,12,61,63,63,0,RB
3861,Musa Smith,9,0,9,2003,21,BAL,11,0,9,31,3.4,2,2.8,2,22.2,0,0,0,,0,0,,,0,,9,31,31,48,17,RB
3862,Onterrio Smith,107,15,122,2003,23,MIN,15,3,107,579,5.4,5,38.6,29,53.3,20,15,129,8.6,0,8.6,75,6.5,8,55,122,579,708,1296,588,RB
3863,Paul Smith,2,5,7,2003,25,DET,7,0,2,5,2.5,0,0.7,0,0,6,5,45,9,0,6.4,83.3,7.5,3,66.7,7,5,50,50,0,RB
3864,Terrelle Smith,0,6,6,2003,25,NOR,15,10,0,0,,0,0,0,,10,6,28,4.7,0,1.9,60,2.8,0,0,6,0,28,28,0,FB
3865,Jerald Sowell,1,47,48,2003,29,NYJ,16,16,1,2,2,0,0.1,0,0,60,47,436,9.3,1,27.3,78.3,7.3,27,58.3,48,2,438,438,0,FB
3866,Charles Stackhouse,1,6,7,2003,23,MIN,14,2,1,0,0,0,0,0,0,7,6,30,5,0,2.1,85.7,4.3,1,28.6,7,0,30,30,0,FB
3867,Duce Staley,96,36,132,2003,28,PHI,16,4,96,463,4.8,5,28.9,22,52.1,47,36,382,10.6,2,23.9,76.6,8.1,19,51.1,132,463,845,845,0,RB
3868,Aaron Stecker,37,9,46,2003,28,TAM,16,1,37,125,3.4,0,7.8,5,37.8,12,9,48,5.3,1,3,75,4,2,33.3,46,125,173,693,520,RB
3869,Mack Strong,37,29,66,2003,32,SEA,16,9,37,174,4.7,1,10.9,19,62.2,33,29,216,7.4,0,13.5,87.9,6.5,9,48.5,66,174,390,450,60,FB
3870,Lee Suggs,56,2,58,2003,23,CLE,7,0,56,289,5.2,2,41.3,14,42.9,4,2,0,0,0,0,50,0,0,0,58,289,289,607,318,RB
3871,Chester Taylor,63,20,83,2003,24,BAL,16,1,63,276,4.4,2,17.3,12,39.7,27,20,132,6.6,0,8.3,74.1,4.9,7,33.3,83,276,408,856,448,RB
3872,Fred Taylor,345,48,393,2003,27,JAX,16,16,345,1572,4.6,6,98.3,79,46.7,74,48,370,7.7,1,23.1,64.9,5,16,44.6,393,1572,1942,1942,0,RB
3873,Anthony Thomas,244,9,253,2003,26,CHI,13,13,244,1024,4.2,6,78.8,47,45.1,14,9,36,4,0,2.8,64.3,2.6,1,14.3,253,1024,1060,1060,0,RB
3874,LaBrandon Toefield,53,14,67,2003,23,JAX,16,0,53,212,4,2,13.3,11,49.1,16,14,105,7.5,1,6.6,87.5,6.6,6,50,67,244,317,589,272,RB
3875,LaDainian Tomlinson,313,100,413,2003,24,SDG,16,16,313,1645,5.3,13,102.8,83,43.1,137,100,725,7.3,4,45.3,73,5.3,26,32.1,413,1666,2370,2370,0,RB
3876,Stephen Trejo,0,1,1,2003,26,DET,16,0,0,0,,0,0,0,,1,1,2,2,0,0.1,100,2,1,100,1,0,2,2,0,FB
3877,Kenny Watson,0,0,0,2003,25,CIN,8,0,0,0,,0,0,0,,0,0,0,,0,0,,,0,,0,0,0,113,113,RB
3878,Jonathan Wells,5,2,7,2003,24,HOU,13,0,5,14,2.8,0,1.1,1,40,4,2,17,8.5,0,1.3,50,4.3,1,50,7,14,31,55,24,RB
3879,Brian Westbrook,117,37,154,2003,24,PHI,15,8,117,613,5.2,7,40.9,30,43.6,48,37,332,9,4,22.1,77.1,6.9,17,45.8,154,613,945,1738,793,RB
3880,Tyrone Wheatley,159,12,171,2003,31,OAK,15,5,159,678,4.3,4,45.2,31,49.1,18,12,120,10,0,8,66.7,6.7,5,38.9,171,678,798,798,0,RB
3881,Jamel White,70,46,116,2003,26,CLE,16,3,70,266,3.8,1,16.6,15,44.3,69,46,303,6.6,1,18.9,66.7,4.4,14,31.9,116,266,569,571,2,RB
3882,Moe Williams,174,65,239,2003,29,MIN,16,7,174,745,4.3,5,46.6,43,46,87,65,644,9.9,3,40.3,74.7,7.4,34,54,239,745,1389,1389,0,RB
3883,Nick Luchey,1,1,2,2003,26,GNB,11,2,1,3,3,0,0.3,0,0,2,1,12,12,0,1.1,50,6,1,50,2,3,15,36,21,FB
3884,Ricky Williams,392,50,442,2003,26,MIA,16,16,392,1372,3.5,9,85.8,68,36.7,62,50,351,7,1,21.9,80.6,5.7,12,41.9,442,1372,1723,1723,0,RB
3885,Ricky Williams,48,22,70,2003,25,IND,13,4,48,155,3.2,2,11.9,7,43.8,29,22,157,7.1,1,12.1,75.9,5.4,9,41.4,70,155,312,379,67,RB
3886,Amos Zereoue,132,40,172,2003,27,PIT,16,6,132,433,3.3,2,27.1,22,37.9,52,40,310,7.8,0,19.4,76.9,6,12,44.2,172,433,743,743,0,RB
3887,Rabih Abdullah,0,0,0,2002,27,CHI,16,0,0,0,,0,0,0,,0,0,0,,0,0,,,0,,0,0,0,182,182,RB
3888,Dan Alexander,0,0,0,2002,24,JAX,3,0,0,0,,0,0,0,,0,0,0,,0,0,,,0,,0,0,0,0,0,RB
3889,Shaun Alexander,295,59,354,2002,25,SEA,16,16,295,1175,4,16,73.4,64,41,78,59,460,7.8,2,28.8,75.6,5.9,20,43.6,354,1175,1635,1635,0,RB
3890,James Allen,155,47,202,2002,27,HOU,16,5,155,519,3.3,0,32.4,22,32.3,57,47,302,6.4,0,18.9,82.5,5.3,11,42.1,202,524,821,821,0,RB
3891,Mike Alstott,146,35,181,2002,29,TAM,16,9,146,548,3.8,5,34.3,37,42.5,48,35,242,6.9,2,15.1,72.9,5,11,54.2,181,548,790,790,0,FB
3892,Damien Anderson,24,3,27,2002,23,ARI,10,1,24,65,2.7,0,6.5,3,12.5,7,3,36,12,0,3.6,42.9,5.1,3,42.9,27,65,101,328,227,RB
3893,Mike Anderson,84,18,102,2002,29,DEN,15,12,84,386,4.6,2,25.7,24,52.4,24,18,167,9.3,2,11.1,75,7,7,66.7,102,386,553,592,39,FB
3894,Richie Anderson,5,45,50,2002,31,NYJ,16,14,5,27,5.4,0,1.7,1,40,56,45,257,5.7,1,16.1,80.4,4.6,9,48.2,50,27,284,284,0,FB
3895,Tiki Barber,304,69,373,2002,27,NYG,16,15,304,1387,4.6,11,86.7,71,41.4,95,69,597,8.7,0,37.3,72.6,6.3,24,44.2,373,1387,1984,1989,5,RB
3896,Kevan Barlow,145,14,159,2002,23,SFO,14,0,145,675,4.7,4,48.2,35,51.7,21,14,136,9.7,1,9.7,66.7,6.5,7,47.6,159,675,811,811,0,RB
3897,Darian Barnes,0,0,0,2002,22,TAM,6,0,0,0,,0,0,0,,0,0,0,,0,0,,,0,,0,0,0,0,0,FB
3898,Jarrod Baxter,7,5,12,2002,23,HOU,16,10,7,14,2,0,0.9,2,28.6,10,5,33,6.6,1,2.1,50,3.3,2,30,12,14,47,66,19,FB
3899,Fred Beasley,26,22,48,2002,28,SFO,16,14,26,75,2.9,0,4.7,15,65.4,32,22,152,6.9,1,9.5,68.8,4.8,8,40.6,48,75,227,227,0,FB
3900,Brandon Bennett,33,18,51,2002,29,CIN,12,0,33,155,4.7,0,12.9,10,42.4,25,18,109,6.1,0,9.1,72,4.4,3,36,51,155,264,1495,1231,RB
3901,Michael Bennett,255,37,292,2002,24,MIN,16,16,255,1296,5.1,5,81,47,49.4,41,37,351,9.5,1,21.9,90.2,8.6,16,58.5,292,1296,1647,1647,0,RB
3902,Sean Bennett,0,5,5,2002,27,NYG,7,0,0,0,,0,0,0,,6,5,37,7.4,0,5.3,83.3,6.2,2,50,5,0,37,37,0,RB
3903,Jerome Bettis,187,7,194,2002,30,PIT,13,11,187,666,3.6,9,51.2,42,46.5,9,7,57,8.1,0,4.4,77.8,6.3,3,66.7,194,666,723,723,0,RB
3904,Ladell Betts,65,12,77,2002,23,WAS,11,0,65,307,4.7,1,27.9,14,38.5,17,12,154,12.8,0,14,70.6,9.1,5,47.1,77,307,461,1151,690,RB
3905,Derrick Blaylock,16,5,21,2002,23,KAN,12,0,16,72,4.5,0,6,3,31.3,10,5,47,9.4,0,3.9,50,4.7,2,40,21,72,119,168,49,RB
3906,R.J. Bowers,0,0,0,2002,28,CLE,4,0,0,0,,0,0,0,,1,0,0,,0,0,0,0,0,0,0,0,0,0,0,RB
3907,Dee Brown,102,17,119,2002,24,CAR,14,3,102,360,3.5,4,25.7,20,39.2,33,17,86,5.1,1,6.1,51.5,2.6,6,24.2,119,360,446,699,253,RB
3908,Shawn Bryson,13,1,14,2002,26,BUF,6,0,13,35,2.7,0,5.8,2,38.5,3,1,9,9,0,1.5,33.3,3,1,33.3,14,35,44,62,18,RB
3909,Joe Burns,5,0,5,2002,23,BUF,10,0,5,7,1.4,0,0.7,0,0,0,0,0,,0,0,,,0,,5,7,7,42,35,RB
3910,Trung Canidate,17,4,21,2002,25,STL,16,1,17,48,2.8,0,3,3,29.4,6,4,31,7.8,0,1.9,66.7,5.2,2,50,21,48,79,276,197,RB
3911,Rock Cartwright,3,11,14,2002,23,WAS,16,0,3,22,7.3,0,1.4,2,66.7,13,11,121,11,1,7.6,84.6,9.3,5,53.8,14,22,143,312,169,FB
3912,Tony Carter,0,0,0,2002,30,GNB,12,0,0,0,,0,0,0,,1,0,0,,0,0,0,0,0,0,0,0,0,42,42,RB
3913,Aveion Cason,26,19,45,2002,23,DET,10,3,26,107,4.1,0,10.7,5,26.9,32,19,288,15.2,2,28.8,59.4,9,8,31.3,45,107,395,443,48,RB
3914,Larry Centers,11,43,54,2002,34,BUF,16,7,11,56,5.1,2,3.5,6,54.5,63,43,388,9,0,24.3,68.3,6.2,19,50.8,54,56,444,444,0,FB
3915,Doug Chapman,12,0,12,2002,25,MIN,6,0,12,89,7.4,0,14.8,4,58.3,1,0,0,,0,0,0,0,0,0,12,89,89,314,225,RB
3916,Jesse Chatman,6,3,9,2002,23,SDG,10,0,6,19,3.2,0,1.9,1,16.7,3,3,44,14.7,0,4.4,100,14.7,2,100,9,19,63,63,0,RB
3917,Bob Christian,31,13,44,2002,34,ATL,15,10,31,119,3.8,3,7.9,8,54.8,24,13,174,13.4,0,11.6,54.2,7.3,7,37.5,44,119,293,293,0,FB
3918,Mike Cloud,49,6,55,2002,27,KAN,14,2,49,115,2.3,2,8.2,9,44.9,9,6,48,8,0,3.4,66.7,5.3,1,44.4,55,115,163,163,0,RB
3919,KaRon Coleman,0,0,0,2002,24,DEN,2,0,0,0,,0,0,0,,0,0,0,,0,0,,,0,,0,0,0,8,6,RB
3920,Greg Comella,1,10,11,2002,27,TEN,12,7,1,0,0,0,0,0,0,15,10,70,7,0,5.8,66.7,4.7,4,53.3,11,0,70,70,0,FB
3921,Jameel Cook,0,4,4,2002,23,TAM,14,1,0,0,,0,0,0,,6,4,43,10.8,0,3.1,66.7,7.2,3,50,4,0,43,43,0,FB
3922,Rafael Cooper,12,1,13,2002,27,DET,5,0,12,57,4.8,0,11.4,4,33.3,3,1,4,4,0,0.8,33.3,1.3,0,33.3,13,57,61,116,55,RB
3923,Zack Crockett,40,0,40,2002,30,OAK,16,0,40,118,3,8,7.4,22,70,0,0,0,,0,0,,,0,,40,118,118,118,0,FB
3924,Phillip Crosby,0,4,4,2002,26,BUF,16,4,0,0,,0,0,0,,8,4,33,8.3,0,2.1,50,4.1,2,50,4,0,33,78,45,FB
3925,Woodrow Dantzler,0,0,0,2002,23,DAL,5,0,0,0,,0,0,0,,0,0,0,,0,0,,,0,,0,0,0,602,602,RB
3926,Najeh Davenport,39,5,44,2002,23,GNB,8,0,39,184,4.7,1,23,8,41,9,5,33,6.6,0,4.1,55.6,3.7,2,33.3,44,184,217,347,130,RB
3927,Stephen Davis,207,23,230,2002,28,WAS,12,12,207,820,4,7,68.3,49,50.2,33,23,142,6.2,1,11.8,69.7,4.3,3,42.4,230,820,962,962,0,RB
3928,Ron Dayne,125,11,136,2002,24,NYG,16,1,125,428,3.4,3,26.8,27,40,12,11,49,4.5,0,3.1,91.7,4.1,1,41.7,136,428,477,477,0,RB
3929,Autry Denson,2,0,2,2002,26,IND,1,0,2,2,1,0,2,0,0,0,0,0,,0,0,,,0,,2,2,2,40,38,RB
3930,Corey Dillon,314,43,357,2002,28,CIN,16,16,314,1311,4.2,7,81.9,72,50.6,61,43,298,6.9,0,18.6,70.5,4.9,18,39.3,357,1311,1609,1600,0,RB
3931,Reuben Droughns,4,5,9,2002,24,DEN,16,0,4,11,2.8,1,0.7,1,50,7,5,53,10.6,1,3.3,71.4,7.6,2,42.9,9,11,64,580,516,RB
3932,T.J. Duckett,130,9,139,2002,21,ATL,12,3,130,507,3.9,4,42.3,31,48.5,11,9,61,6.8,0,5.1,81.8,5.5,3,45.5,139,507,568,572,4,RB
3933,Warrick Dunn,230,50,280,2002,27,ATL,15,14,230,927,4,7,61.8,39,42.6,66,50,377,7.5,2,25.1,75.8,5.7,16,39.4,280,927,1304,1304,0,RB
3934,Deon Dyer,0,0,0,2002,25,MIA,13,0,0,0,,0,0,0,,0,0,0,,0,0,,,0,,0,0,0,0,0,FB
3935,Omar Easy,0,3,3,2002,25,KAN,7,0,0,0,,0,0,0,,5,3,23,7.7,1,3.3,60,4.6,2,40,3,0,23,23,0,FB
3936,Chris Edmonds,0,0,0,2002,24,CIN,8,0,0,0,,0,0,0,,0,0,0,,0,0,,,0,,0,0,0,0,0,FB
3937,Marc Edwards,31,23,54,2002,28,NWE,16,10,31,96,3.1,0,6,11,54.8,32,23,196,8.5,0,12.3,71.9,6.1,10,56.3,54,96,292,319,27,FB
3938,Robert Edwards,20,18,38,2002,28,MIA,12,0,20,107,5.4,1,8.9,7,45,23,18,126,7,1,10.5,78.3,5.5,10,47.8,38,107,233,233,0,RB
3939,Heath Evans,17,8,25,2002,24,SEA,16,1,17,53,3.1,0,3.3,4,52.9,12,8,41,5.1,0,2.6,66.7,3.4,3,50,25,53,94,178,84,FB
3940,Kevin Faulk,52,37,89,2002,26,NWE,15,0,52,271,5.2,2,18.1,8,50,53,37,379,10.2,3,25.3,69.8,7.2,14,45.3,89,271,650,1440,790,RB
3941,Marshall Faulk,212,80,292,2002,29,STL,14,10,212,953,4.5,8,68.1,54,50,102,80,537,6.7,2,38.4,78.4,5.3,23,44.1,292,953,1490,1495,0,RB
3942,James Fenderson,13,6,19,2002,26,NOR,16,1,13,65,5,1,4.1,2,46.2,10,6,38,6.3,0,2.4,60,3.8,2,50,19,65,103,146,43,RB
3943,Jim Finn,5,6,11,2002,26,IND,12,2,5,8,1.6,0,0.7,0,40,9,6,31,5.2,0,2.6,66.7,3.4,1,33.3,11,8,39,39,0,FB
3944,Tony Fisher,70,18,88,2002,23,GNB,15,1,70,283,4,2,18.9,15,44.3,22,18,70,3.9,0,4.7,81.8,3.2,3,36.4,88,283,353,395,42,RB
3945,Terrell Fletcher,26,10,36,2002,29,SDG,10,0,26,128,4.9,1,12.8,8,50,17,10,62,6.2,0,6.2,58.8,3.6,2,35.3,36,128,190,212,22,RB
3946,Chris Fuamatu-Ma'afala,23,2,25,2002,25,PIT,8,0,23,115,5,0,14.4,6,47.8,3,2,12,6,0,1.5,66.7,4,0,0,25,115,127,127,0,RB
3947,Charlie Garner,182,91,273,2002,30,OAK,16,15,182,962,5.3,7,60.1,49,51.6,111,91,941,10.3,4,58.8,82,8.5,47,64,273,962,1903,1904,0,RB
3948,Olandis Gary,37,18,55,2002,27,DEN,13,2,37,147,4,1,11.3,7,32.4,20,18,148,8.2,0,11.4,90,7.4,5,60,55,147,295,308,13,RB
3949,Sam Gash,0,0,0,2002,33,BAL,11,0,0,0,,0,0,0,,0,0,0,,0,0,,,0,,0,0,0,14,14,FB
3950,Eddie George,343,36,379,2002,29,TEN,16,16,343,1165,3.4,12,72.8,62,44.6,46,36,255,7.1,2,15.9,78.3,5.5,11,60.9,379,1165,1420,1420,0,RB
3951,Nick Goings,50,18,68,2002,24,CAR,14,2,50,188,3.8,0,13.4,11,34,29,18,91,5.1,0,6.5,62.1,3.1,4,31,68,188,279,258,0,RB
3952,Joey Goodspeed,0,0,0,2002,24,SDG,12,0,0,0,,0,0,0,,0,0,0,,0,0,,,0,,0,0,0,0,0,FB
3953,Lamar Gordon,65,30,95,2002,22,STL,13,5,65,228,3.5,1,17.5,12,38.5,38,30,278,9.3,2,21.4,78.9,7.3,13,65.8,95,228,506,610,104,RB
3954,Jay Graham,1,2,3,2002,27,GNB,3,0,1,3,3,0,1,0,0,2,2,6,3,0,2,100,3,0,0,3,3,9,9,0,RB
3955,Ahman Green,286,57,343,2002,25,GNB,14,14,286,1240,4.3,7,88.6,57,45.1,74,57,393,6.9,2,28.1,77,5.3,19,48.6,343,1240,1633,1633,0,RB
3956,Mike Green,21,7,28,2002,26,TEN,15,2,21,71,3.4,0,4.7,3,33.3,10,7,57,8.1,1,3.8,70,5.7,4,40,28,71,128,138,10,RB
3957,William Green,243,16,259,2002,23,CLE,16,10,243,887,3.7,6,55.4,39,41.2,27,16,113,7.1,0,7.1,59.3,4.2,5,37,259,887,1000,1000,0,RB
3958,Troy Hambrick,79,21,100,2002,26,DAL,16,0,79,317,4,1,19.8,17,43,24,21,99,4.7,0,6.2,87.5,4.1,1,25,100,317,416,408,0,RB
3959,Verron Haynes,10,3,13,2002,23,PIT,14,0,10,51,5.1,0,3.6,2,20,7,3,10,3.3,0,0.7,42.9,1.4,0,0,13,51,61,61,0,RB
3960,Garrison Hearst,215,48,263,2002,31,SFO,16,16,215,972,4.5,8,60.8,53,50.2,69,48,317,6.6,1,19.8,69.6,4.6,14,39.1,263,972,1289,1289,0,RB
3961,William Henderson,7,26,33,2002,31,GNB,15,12,7,27,3.9,1,1.8,2,57.1,32,26,168,6.5,3,11.2,81.3,5.3,12,62.5,33,27,195,195,0,FB
3962,Travis Henry,325,43,368,2002,24,BUF,16,16,325,1438,4.4,13,89.9,78,50.5,59,43,309,7.2,1,19.3,72.9,5.2,14,50.8,368,1438,1747,1747,0,RB
3963,Chris Hetherington,1,1,2,2002,30,STL,6,4,1,0,0,0,0,0,0,2,1,2,2,0,0.3,50,1,0,0,2,0,2,2,0,FB
3964,Madre Hill,0,0,0,2002,26,OAK,2,0,0,0,,0,0,0,,1,0,0,,0,0,0,0,0,0,0,0,0,0,0,RB
3965,James Hodgins,3,9,12,2002,25,STL,9,8,3,7,2.3,0,0.8,1,66.7,10,9,47,5.2,0,5.2,90,4.7,1,60,12,7,54,54,0,FB
3966,Robert Holcombe,47,10,57,2002,27,TEN,8,0,47,242,5.1,0,30.3,14,51.1,11,10,91,9.1,0,11.4,90.9,8.3,3,63.6,57,242,333,333,0,RB
3967,Priest Holmes,313,70,383,2002,29,KAN,14,14,313,1615,5.2,21,115.4,105,54.3,81,70,672,9.6,3,48,86.4,8.3,31,56.8,383,1615,2287,2287,0,RB
3968,Brad Hoover,31,17,48,2002,26,CAR,16,10,31,129,4.2,0,8.1,7,45.2,30,17,187,11,2,11.7,56.7,6.2,7,46.7,48,129,316,316,0,FB
3969,Dameon Hunter,0,0,0,2002,23,BAL,1,0,0,0,,0,0,0,,0,0,0,,0,0,,,0,,0,0,0,0,0,RB
3970,Richard Huntley,3,0,3,2002,30,DET,3,1,3,4,1.3,0,1.3,0,0,0,0,0,,0,0,,,0,,3,4,4,4,0,RB
3971,James Jackson,12,3,15,2002,26,CLE,16,0,12,54,4.5,0,3.4,2,25,6,3,9,3,0,0.6,50,1.5,0,0,15,54,63,76,13,RB
3972,Terry Jackson,0,0,0,2002,26,SFO,5,0,0,0,,0,0,0,,0,0,0,,0,0,,,0,,0,0,0,67,67,FB
3973,Edgerrin James,277,61,338,2002,24,IND,14,14,277,989,3.6,2,70.6,59,45.8,80,61,354,5.8,1,25.3,76.3,4.4,17,36.3,338,989,1343,1343,0,RB
3974,Ronney Jenkins,0,0,0,2002,25,SDG,13,0,0,0,,0,0,0,,0,0,0,,0,0,,,0,,0,0,0,925,925,RB
3975,Travis Jervey,10,0,10,2002,30,ATL,6,0,10,17,1.7,0,2.8,1,30,0,0,0,,0,0,,,0,,10,17,17,160,143,RB
3976,Bryan Johnson,1,15,16,2002,24,WAS,16,12,1,0,0,0,0,0,0,19,15,114,7.6,0,7.1,78.9,6,5,57.9,16,0,114,114,0,FB
3977,Leon Johnson,103,16,119,2002,28,CHI,16,4,103,329,3.2,1,20.6,25,42.7,27,16,125,7.8,0,7.8,59.3,4.6,8,40.7,119,356,454,1158,706,RB
3978,Rudi Johnson,17,6,23,2002,23,CIN,7,0,17,67,3.9,0,9.6,6,47.1,10,6,34,5.7,0,4.9,60,3.4,2,30,23,67,101,378,277,RB
3979,Thomas Jones,138,20,158,2002,24,ARI,9,9,138,511,3.7,2,56.8,24,41.3,30,20,113,5.7,0,12.6,66.7,3.8,4,36.7,158,511,624,624,0,RB
3980,LaMont Jordan,84,17,101,2002,24,NYJ,14,0,84,316,3.8,3,22.6,17,38.1,23,17,160,9.4,0,11.4,73.9,7,8,52.2,101,316,476,588,112,RB
3981,Randy Jordan,3,2,5,2002,32,OAK,14,0,3,14,4.7,1,1,1,33.3,4,2,19,9.5,0,1.4,50,4.8,1,25,5,14,33,33,0,RB
3982,Elvis Joseph,0,0,0,2002,24,JAX,15,0,0,0,,0,0,0,,1,0,0,,0,0,0,0,0,0,0,0,0,562,562,RB
3983,Delvin Joyce,2,1,3,2002,24,NYG,12,0,2,2,1,0,0.2,0,0,2,1,5,5,0,0.4,50,2.5,0,0,3,2,7,993,986,RB
3984,Jarmar Julien,0,0,0,2002,23,KAN,2,0,0,0,,0,0,0,,0,0,0,,0,0,,,0,,0,0,0,0,0,RB
3985,Curtis Keaton,12,0,12,2002,26,NOR,6,0,12,19,1.6,0,3.2,0,0,0,0,0,,0,0,,,0,,12,19,19,19,0,RB
3986,Terry Kirby,16,17,33,2002,32,OAK,6,0,16,51,3.2,0,8.5,5,50,22,17,115,6.8,1,19.2,77.3,5.2,3,40.9,33,51,166,670,504,RB
3987,Rob Konrad,3,34,37,2002,26,MIA,16,12,3,2,0.7,0,0.1,0,0,45,34,233,6.9,3,14.6,75.6,5.2,14,62.2,37,2,235,268,33,FB
3988,Dan Kreider,6,18,24,2002,25,PIT,16,13,6,16,2.7,0,1,2,66.7,25,18,122,6.8,1,7.6,72,4.9,10,52,24,16,138,156,18,FB
3989,George Layne,1,2,3,2002,24,ATL,2,0,1,5,5,0,2.5,1,100,2,2,11,5.5,0,5.5,100,5.5,0,100,3,5,16,16,0,RB
3990,Dorsey Levens,75,19,94,2002,32,PHI,16,0,75,411,5.5,1,25.7,13,41.3,28,19,124,6.5,1,7.8,67.9,4.4,6,32.1,94,411,535,559,24,RB
3991,Jamal Lewis,308,47,355,2002,23,BAL,16,15,308,1327,4.3,6,82.9,66,47.7,60,47,442,9.4,1,27.6,78.3,7.4,14,36.7,355,1327,1769,1769,0,RB
3992,Stacey Mack,98,11,109,2002,27,JAX,16,0,98,436,4.4,9,27.3,38,59.2,13,11,79,7.2,0,4.9,84.6,6.1,5,46.2,109,436,515,749,234,RB
3993,Joel Makovicka,5,15,20,2002,27,ARI,12,1,5,54,10.8,0,4.5,2,60,19,15,81,5.4,3,6.8,78.9,4.3,6,57.9,20,54,135,165,30,FB
3994,Cecil Martin,1,15,16,2002,27,PHI,16,9,1,-4,-4,0,-0.3,0,0,22,15,126,8.4,0,7.9,68.2,5.7,3,36.4,16,-4,122,122,0,FB
3995,Curtis Martin,261,49,310,2002,29,NYJ,16,16,261,1094,4.2,7,68.4,55,42.9,56,49,362,7.4,0,22.6,87.5,6.5,17,53.6,310,1090,1456,1456,0,RB
3996,Chris Massey,0,0,0,2002,23,STL,16,1,0,0,,0,0,0,,1,0,0,,0,0,0,0,0,0,0,0,0,0,0,RB
3997,Fred McAfee,1,0,1,2002,34,NOR,11,0,1,11,11,0,1,1,100,0,0,0,,0,0,,,0,,1,11,11,80,69,RB
3998,Deuce McAllister,325,47,372,2002,24,NOR,15,15,325,1388,4.3,13,92.5,68,40.6,74,47,352,7.5,3,23.5,63.5,4.8,15,36.5,372,1380,1740,1740,0,RB
3999,Fred McCrary,2,22,24,2002,30,SDG,16,16,2,1,0.5,0,0.1,0,0,31,22,96,4.4,3,6,71,3.1,5,29,24,1,97,97,0,FB
4000,Dennis McKinley,0,0,0,2002,26,ARI,12,1,0,0,,0,0,0,,1,0,0,,0,0,0,0,0,0,0,0,0,0,0,FB
4001,Jason McKie,0,1,1,2002,22,DAL,1,0,0,0,,0,0,0,,1,1,7,7,0,7,100,7,0,0,1,0,7,7,0,FB
4002,Rondell Mealey,11,7,18,2002,25,GNB,3,1,11,36,3.3,1,12,3,27.3,9,7,45,6.4,0,15,77.8,5,2,66.7,18,36,81,81,0,RB
4003,Travis Minor,44,0,44,2002,23,MIA,16,0,44,180,4.1,2,11.3,10,45.5,0,0,0,,0,0,,,0,,44,180,180,1251,1071,RB
4004,Brian Mitchell,0,0,0,2002,34,PHI,16,0,0,0,,0,0,0,,0,0,0,,0,0,,,0,,0,57,0,1738,1729,RB
4005,Joe Montgomery,7,0,7,2002,26,CAR,3,0,7,20,2.9,0,6.7,0,0,0,0,0,,0,0,,,0,,7,20,20,20,0,RB
4006,Harold Morrow,0,0,0,2002,29,MIN,16,0,0,0,,0,0,0,,0,0,0,,0,0,,,0,,0,0,0,0,0,FB
4007,Maurice Morris,32,3,35,2002,23,SEA,11,0,32,153,4.8,0,13.9,7,46.9,3,3,25,8.3,0,2.3,100,8.3,1,66.7,35,153,178,999,821,RB
4008,Sammy Morris,2,3,5,2002,25,BUF,16,0,2,5,2.5,0,0.3,0,0,4,3,48,16,0,3,75,12,3,75,5,5,53,53,0,RB
4009,Chad Morton,4,3,7,2002,25,NYJ,16,0,4,8,2,0,0.5,0,0,5,3,19,6.3,0,1.2,60,3.8,0,0,7,8,27,1587,1560,RB
4010,James Mungro,97,13,110,2002,24,IND,9,1,97,336,3.5,8,37.3,24,44.3,16,13,81,6.2,0,9,81.3,5.1,4,56.3,110,336,417,417,0,RB
4011,Lorenzo Neal,9,21,30,2002,32,CIN,16,8,9,31,3.4,0,1.9,3,44.4,29,21,133,6.3,1,8.3,72.4,4.6,7,55.2,30,31,164,216,52,FB
4012,Moran Norris,0,0,0,2002,24,HOU,13,0,0,0,,0,0,0,,0,0,0,,0,0,,,0,,0,0,0,11,11,FB
4013,Patrick Pass,4,0,4,2002,24,NWE,15,0,4,27,6.8,0,1.8,1,50,0,0,0,,0,0,,,0,,4,27,27,150,123,FB
4014,Adrian Peterson,19,3,22,2002,23,CHI,9,0,19,101,5.3,1,11.2,4,63.2,4,3,18,6,0,2,75,4.5,1,50,22,101,119,156,37,RB
4015,Michael Pittman,204,59,263,2002,27,TAM,16,15,204,718,3.5,1,44.9,37,41.7,86,59,477,8.1,0,29.8,68.6,5.5,19,40.7,263,718,1195,1197,0,RB
4016,Clinton Portis,273,33,306,2002,21,DEN,16,12,273,1508,5.5,15,94.3,82,59.3,49,33,364,11,2,22.8,67.3,7.4,16,51,306,1508,1872,1872,0,RB
4017,Stanley Pritchett,1,19,20,2002,29,CHI,16,2,1,2,2,0,0.1,0,100,27,19,165,8.7,1,10.3,70.4,6.1,10,55.6,20,2,167,167,0,FB
4018,J.R. Redmond,4,2,6,2002,25,NWE,9,0,4,2,0.5,0,0.2,0,0,3,2,5,2.5,0,0.6,66.7,1.7,0,0,6,2,7,19,12,RB
4019,Alan Ricard,14,10,24,2002,25,BAL,16,8,14,58,4.1,2,3.6,5,57.1,14,10,60,6,0,3.8,71.4,4.3,3,42.9,24,58,118,118,0,FB
4020,Tony Richardson,22,18,40,2002,31,KAN,14,12,22,81,3.7,2,5.8,6,45.5,23,18,125,6.9,1,8.9,78.3,5.4,6,52.2,40,81,206,206,0,FB
4021,Jon Ritchie,0,10,10,2002,28,OAK,16,2,0,0,,0,0,0,,21,10,66,6.6,1,4.1,47.6,3.1,2,23.8,10,0,66,66,0,FB
4022,Jamal Robertson,0,0,0,2002,25,SFO,6,0,0,0,,0,0,0,,0,0,0,,0,0,,,0,,0,0,0,242,242,RB
4023,Charlie Rogers,0,0,0,2002,26,BUF,16,0,0,0,,0,0,0,,0,0,0,,0,0,,,0,,0,0,0,1417,1417,RB
4024,Cory Schlesinger,49,35,84,2002,30,DET,16,14,49,139,2.8,2,8.7,6,32.7,54,35,263,7.5,0,16.4,64.8,4.9,13,38.9,84,139,402,417,15,FB
4025,Daimon Shelton,0,7,7,2002,30,CHI,12,8,0,0,,0,0,0,,9,7,34,4.9,0,2.8,77.8,3.8,5,66.7,7,0,34,34,0,FB
4026,Marcel Shipp,188,38,226,2002,24,ARI,15,6,188,834,4.4,6,55.6,44,39.4,49,38,413,10.9,3,27.5,77.6,8.4,14,49,226,834,1247,1367,120,RB
4027,John Simon,9,16,25,2002,24,TEN,12,0,9,18,2,1,1.5,4,33.3,17,16,167,10.4,3,13.9,94.1,9.8,7,58.8,25,18,185,669,484,RB
4028,Rod Smart,1,0,1,2002,25,CAR,16,0,1,2,2,0,0.1,1,100,0,0,0,,0,0,,,0,,1,2,2,2,0,RB
4029,Antowain Smith,252,31,283,2002,30,NWE,16,15,252,982,3.9,6,61.4,58,48,42,31,243,7.8,2,15.2,73.8,5.8,11,42.9,283,982,1225,1225,0,RB
4030,Detron Smith,0,1,1,2002,28,IND,11,2,0,0,,0,0,0,,1,1,14,14,0,1.3,100,14,1,100,1,0,14,30,16,RB
4031,Emmitt Smith,254,16,270,2002,33,DAL,16,16,254,975,3.8,5,60.9,50,41.7,24,16,89,5.6,0,5.6,66.7,3.7,4,33.3,270,975,1064,1064,0,RB
4032,Lamar Smith,209,20,229,2002,32,CAR,11,11,209,737,3.5,7,67,32,37.3,26,20,167,8.4,0,15.2,76.9,6.4,8,46.2,229,737,904,904,0,RB
4033,Maurice Smith,0,0,0,2002,26,ATL,2,0,0,0,,0,0,0,,0,0,0,,0,0,,,0,,0,0,0,0,0,RB
4034,Paul Smith,18,5,23,2002,24,SFO,11,0,18,90,5,0,8.2,6,61.1,8,5,33,6.6,0,3,62.5,4.1,1,50,23,90,123,230,107,RB
4035,Terrelle Smith,5,9,14,2002,24,NOR,16,8,5,11,2.2,0,0.7,0,40,13,9,30,3.3,0,1.9,69.2,2.3,1,23.1,14,11,41,41,0,FB
4036,Jerald Sowell,1,9,10,2002,28,NYJ,16,0,1,0,0,0,0,0,0,13,9,85,9.4,1,5.3,69.2,6.5,7,53.8,10,0,85,105,20,FB
4037,Charles Stackhouse,0,13,13,2002,22,NYG,16,2,0,0,,0,0,0,,18,13,88,6.8,3,5.5,72.2,4.9,5,61.1,13,0,88,88,0,FB
4038,Duce Staley,269,51,320,2002,27,PHI,16,16,269,1029,3.8,5,64.3,58,44.6,69,51,541,10.6,3,33.8,73.9,7.8,20,60.9,320,1029,1570,1563,0,RB
4039,Ed Stansbury,0,0,0,2002,23,HOU,1,0,0,0,,0,0,0,,0,0,0,,0,0,,,0,,0,0,0,0,0,RB
4040,Aaron Stecker,28,13,41,2002,27,TAM,16,1,28,174,6.2,0,10.9,8,46.4,16,13,69,5.3,0,4.3,81.3,4.3,2,43.8,41,174,243,1177,934,RB
4041,Travis Stephens,0,1,1,2002,24,TAM,1,0,0,0,,0,0,0,,1,1,6,6,0,6,100,6,0,0,1,0,6,6,0,RB
4042,James Stewart,231,46,277,2002,31,DET,14,9,231,1021,4.4,4,72.9,47,41.6,70,46,333,7.2,2,23.8,65.7,4.8,13,38.6,277,1021,1354,1354,0,RB
4043,Shyrone Stith,0,0,0,2002,24,IND,1,0,0,0,,0,0,0,,0,0,0,,0,0,,,0,,0,0,0,0,0,RB
4044,Mack Strong,23,22,45,2002,31,SEA,16,12,23,94,4.1,0,5.9,11,78.3,32,22,120,5.5,2,7.5,68.8,3.8,5,43.8,45,94,214,268,54,FB
4045,Chester Taylor,33,14,47,2002,23,BAL,15,2,33,122,3.7,0,8.1,5,39.4,22,14,129,9.2,2,8.6,63.6,5.9,8,36.4,47,122,251,487,236,RB
4046,Fred Taylor,287,49,336,2002,26,JAX,16,16,287,1314,4.6,8,82.1,50,43.6,57,49,408,8.3,0,25.5,86,7.2,15,56.1,336,1314,1722,1722,0,RB
4047,Anthony Thomas,214,24,238,2002,25,CHI,12,12,214,721,3.4,6,60.1,35,43.9,41,24,163,6.8,0,13.6,58.5,4,4,34.1,238,721,884,884,0,RB
4048,Robert Thomas,10,12,22,2002,28,DAL,15,9,10,31,3.1,0,2.1,2,40,16,12,80,6.7,0,5.3,75,5,4,50,22,31,111,111,0,FB
4049,LaDainian Tomlinson,372,79,451,2002,23,SDG,16,16,372,1683,4.5,14,105.2,96,44.6,101,79,489,6.2,1,30.6,78.2,4.8,21,44.6,451,1683,2172,2172,0,RB
4050,Stephen Trejo,1,2,3,2002,25,DET,16,0,1,0,0,0,0,0,0,4,2,13,6.5,0,0.8,50,3.3,0,0,3,0,13,13,0,FB
4051,Lamont Warren,6,4,10,2002,29,DET,3,1,6,8,1.3,0,2.7,1,16.7,12,4,56,14,2,18.7,33.3,4.7,2,16.7,10,8,64,64,0,RB
4052,Damon Washington,0,0,0,2002,25,NYG,12,0,0,0,,0,0,0,,0,0,0,,0,0,,,0,,0,0,0,77,77,RB
4053,Patrick Washington,0,1,1,2002,24,JAX,14,3,0,0,,0,0,0,,3,1,5,5,0,0.4,33.3,1.7,0,0,1,0,5,40,35,FB
4054,Kenny Watson,116,32,148,2002,24,WAS,16,4,116,534,4.6,1,33.4,32,50.9,43,32,253,7.9,1,15.8,74.4,5.9,6,32.6,148,534,787,1283,496,RB
4055,Jonathan Wells,197,9,206,2002,23,HOU,16,11,197,529,2.7,3,33.1,23,27.9,12,9,48,5.3,0,3,75,4,0,41.7,206,529,577,577,0,RB
4056,Brian Westbrook,46,9,55,2002,23,PHI,15,3,46,193,4.2,0,12.9,11,47.8,13,9,86,9.6,0,5.7,69.2,6.6,4,38.5,55,218,279,279,0,RB
4057,Tyrone Wheatley,108,12,120,2002,30,OAK,14,0,108,419,3.9,2,29.9,27,49.1,20,12,71,5.9,0,5.1,60,3.6,1,25,120,419,490,490,0,RB
4058,Jamel White,106,63,169,2002,25,CLE,14,6,106,470,4.4,3,33.6,22,41.5,86,63,452,7.2,0,32.3,73.3,5.3,15,32.6,169,470,922,943,21,RB
4059,Michael Wiley,22,13,35,2002,24,DAL,16,1,22,168,7.6,1,10.5,7,36.4,29,13,144,11.1,0,9,44.8,5,8,31,35,164,312,374,62,RB
4060,Moe Williams,84,27,111,2002,28,MIN,16,0,84,414,4.9,11,25.9,35,59.5,43,27,251,9.3,0,15.7,62.8,5.8,9,44.2,111,414,665,1181,516,RB
4061,Nick Luchey,12,7,19,2002,25,CIN,16,3,12,59,4.9,2,3.7,6,83.3,8,7,46,6.6,0,2.9,87.5,5.8,2,50,19,59,105,145,40,FB
4062,Ricky Williams,383,47,430,2002,25,MIA,16,16,383,1853,4.8,16,115.8,94,48.6,59,47,363,7.7,1,22.7,79.7,6.2,16,49.2,430,1853,2216,2216,0,RB
4063,Ricky Williams,11,1,12,2002,24,IND,10,0,11,35,3.2,0,3.5,2,45.5,2,1,20,20,1,2,50,10,1,50,12,35,55,90,35,RB
4064,James Wofford,0,0,0,2002,24,MIN,9,0,0,0,,0,0,0,,0,0,0,,0,0,,,0,,0,0,0,62,62,RB
4065,Amos Zereoue,193,42,235,2002,26,PIT,16,5,193,762,3.9,4,47.6,36,38.3,53,42,341,8.1,0,21.3,79.2,6.4,15,41.5,235,762,1103,1103,0,RB
4066,Rabih Abdullah,11,2,13,2001,26,TAM,16,0,11,40,3.6,0,2.5,2,36.4,2,2,26,13,0,1.6,100,13,2,100,13,40,66,158,92,RB
4067,Dan Alexander,0,0,0,2001,23,TEN,7,0,0,0,,0,0,0,,0,0,0,,0,0,,,0,,0,0,0,0,0,RB
4068,Shaun Alexander,309,44,353,2001,24,SEA,16,12,309,1318,4.3,14,82.4,64,42.7,59,44,343,7.8,2,21.4,74.6,5.8,15,42.4,353,1318,1661,1669,0,RB
4069,James Allen,135,30,165,2001,26,CHI,16,7,135,469,3.5,1,29.3,26,43.7,43,30,203,6.8,1,12.7,69.8,4.7,8,44.2,165,469,672,672,0,RB
4070,Terry Allen,168,17,185,2001,33,BAL,11,8,168,658,3.9,3,59.8,32,41.1,20,17,68,4,0,6.2,85,3.4,1,35,185,658,726,726,0,RB
4071,Mike Alstott,165,35,200,2001,28,TAM,16,16,165,680,4.1,10,42.5,40,47.3,50,35,231,6.6,1,14.4,70,4.6,9,46,200,680,911,911,0,FB
4072,Jamal Anderson,55,3,58,2001,29,ATL,3,3,55,190,3.5,1,63.3,8,40,4,3,111,37,1,37,75,27.8,1,50,58,190,301,301,0,RB
4073,Mike Anderson,175,8,183,2001,28,DEN,16,7,175,678,3.9,4,42.4,36,42.3,12,8,46,5.8,0,2.9,66.7,3.8,4,41.7,183,678,724,724,0,RB
4074,Richie Anderson,26,40,66,2001,30,NYJ,16,15,26,102,3.9,0,6.4,4,53.8,57,40,252,6.3,2,15.8,70.2,4.4,13,40.4,66,102,354,354,0,FB
4075,Obafemi Ayanbadejo,46,24,70,2001,26,BAL,16,5,46,173,3.8,1,10.8,11,41.3,33,24,121,5,1,7.6,72.7,3.7,7,42.4,70,173,294,294,0,FB
4076,Tiki Barber,166,72,238,2001,26,NYG,14,9,166,865,5.2,4,61.8,40,47,98,72,577,8,0,41.2,73.5,5.9,30,50,238,865,1442,1782,338,RB
4077,Kevan Barlow,125,22,147,2001,22,SFO,15,0,125,512,4.1,4,34.1,28,51.2,28,22,247,11.2,1,16.5,78.6,8.8,10,57.1,147,512,759,759,0,RB
4078,Michael Bates,0,0,0,2001,32,WAS,16,0,0,0,,0,0,0,,0,0,0,,0,0,,,0,,0,0,0,1155,1155,RB
4079,Fred Beasley,23,16,39,2001,27,SFO,15,12,23,73,3.2,1,4.9,8,52.2,28,16,99,6.2,0,6.6,57.1,3.5,6,39.3,39,73,172,172,0,FB
4080,Brandon Bennett,50,20,70,2001,28,CIN,16,1,50,232,4.6,0,14.5,16,44,26,20,150,7.5,0,9.4,76.9,5.8,8,50,70,232,382,442,60,RB
4081,Donnell Bennett,10,15,25,2001,29,WAS,16,14,10,39,3.9,0,2.4,2,40,25,15,112,7.5,0,7,60,4.5,4,40,25,39,151,151,0,FB
4082,Michael Bennett,172,29,201,2001,23,MIN,13,13,172,682,4,2,52.5,28,43.6,38,29,226,7.8,1,17.4,76.3,5.9,9,50,201,682,908,908,0,RB
4083,Jerome Bettis,225,8,233,2001,29,PIT,11,11,225,1072,4.8,4,97.5,46,43.1,10,8,48,6,0,4.4,80,4.8,2,40,233,1104,1120,1120,0,RB
4084,Tim Biakabutuka,53,12,65,2001,27,CAR,5,4,53,230,4.3,1,46,9,41.5,17,12,121,10.1,0,24.2,70.6,7.1,3,29.4,65,230,351,353,0,RB
4085,R.J. Bowers,18,1,19,2001,27,PIT,3,0,18,84,4.7,1,28,5,44.4,1,1,0,0,0,0,100,0,0,0,19,84,84,84,0,RB
4086,Jason Brookins,151,6,157,2001,25,BAL,12,3,151,551,3.6,5,45.9,32,49,9,6,45,7.5,0,3.8,66.7,5,2,44.4,157,551,596,619,23,RB
4087,Shawn Bryson,80,9,89,2001,25,BUF,15,3,80,341,4.3,2,22.7,9,32.5,11,9,59,6.6,0,3.9,81.8,5.4,3,54.5,89,341,400,699,299,RB
4088,Correll Buckhalter,129,13,142,2001,23,PHI,15,6,129,586,4.5,2,39.1,30,41.1,21,13,130,10,0,8.7,61.9,6.2,5,38.1,142,586,716,744,28,RB
4089,Trung Canidate,78,17,95,2001,24,STL,16,2,78,441,5.7,6,27.6,18,46.2,23,17,154,9.1,0,9.6,73.9,6.7,7,43.5,95,441,595,1343,748,RB
4090,Ki-Jana Carter,63,13,76,2001,28,WAS,14,0,63,308,4.9,3,22,18,47.6,21,13,83,6.4,0,5.9,61.9,4,3,38.1,76,308,391,502,111,RB
4091,Tony Carter,1,11,12,2001,29,DEN,16,6,1,4,4,0,0.3,1,100,14,11,83,7.5,0,5.2,78.6,5.9,4,35.7,12,4,87,131,44,FB
4092,Aveion Cason,11,4,15,2001,22,"DET,STL",6,0,11,31,2.8,0,5.2,1,18.2,4,4,32,8,0,5.3,100,8,0,100,15,31,63,136,73,RB
4093,Larry Centers,34,80,114,2001,33,BUF,16,13,34,160,4.7,2,10,6,38.2,105,80,620,7.8,2,38.8,76.2,5.9,34,48.6,114,160,780,780,0,FB
4094,Doug Chapman,63,16,79,2001,24,MIN,16,3,63,195,3.1,0,12.2,10,34.9,19,16,135,8.4,1,8.4,84.2,7.1,3,42.1,79,195,330,330,0,RB
4095,Bob Christian,44,45,89,2001,33,ATL,16,8,44,284,6.5,2,17.8,17,47.7,60,45,392,8.7,2,24.5,75,6.5,19,51.7,89,284,676,676,0,FB
4096,Mike Cloud,7,0,7,2001,26,KAN,15,0,7,54,7.7,1,3.6,3,71.4,0,0,0,,0,0,,,0,,7,54,54,228,174,RB
4097,KaRon Coleman,4,6,10,2001,23,DEN,4,0,4,17,4.3,0,4.3,0,50,11,6,45,7.5,0,11.3,54.5,4.1,2,27.3,10,17,62,62,0,RB
4098,Greg Comella,4,39,43,2001,26,NYG,16,13,4,15,3.8,0,0.9,0,0,55,39,253,6.5,1,15.8,70.9,4.6,11,45.5,43,15,268,268,0,FB
4099,Jameel Cook,2,17,19,2001,22,TAM,16,3,2,2,1,0,0.1,0,0,23,17,89,5.2,0,5.6,73.9,3.9,2,39.1,19,2,91,91,0,FB
4100,Zack Crockett,57,2,59,2001,29,OAK,16,0,57,145,2.5,6,9.1,25,56.1,3,2,10,5,0,0.6,66.7,3.3,0,33.3,59,145,155,155,0,FB
4101,Phillip Crosby,0,2,2,2001,25,BUF,16,2,0,0,,0,0,0,,2,2,16,8,0,1,100,8,0,0,2,0,16,16,0,FB
4102,Stephen Davis,356,28,384,2001,27,WAS,16,16,356,1432,4,5,89.5,75,45.8,37,28,205,7.3,0,12.8,75.7,5.5,8,43.2,384,1432,1637,1637,0,RB
4103,Terrell Davis,167,12,179,2001,29,DEN,8,8,167,701,4.2,0,87.6,39,46.7,21,12,69,5.8,0,8.6,57.1,3.3,2,28.6,179,701,770,770,0,RB
4104,Ron Dayne,180,8,188,2001,23,NYG,16,7,180,690,3.8,7,43.1,39,38.9,11,8,67,8.4,0,4.2,72.7,6.1,1,63.6,188,690,757,740,0,RB
4105,Autry Denson,1,0,1,2001,25,CHI,16,0,1,4,4,0,0.3,0,0,0,0,0,,0,0,,,0,,1,4,4,543,539,RB
4106,Corey Dillon,340,34,374,2001,27,CIN,16,16,340,1315,3.9,10,82.2,69,40.9,61,34,228,6.7,3,14.3,55.7,3.7,13,32.8,374,1315,1543,1543,0,RB
4107,Scott Dragos,0,0,0,2001,26,CHI,6,0,0,0,,0,0,0,,0,0,0,,0,0,,,0,,0,0,0,0,0,FB
4108,Reuben Droughns,30,4,34,2001,23,DET,9,3,30,72,2.4,0,8,3,23.3,5,4,21,5.3,1,2.3,80,4.2,2,60,34,72,93,93,0,RB
4109,Warrick Dunn,158,68,226,2001,26,TAM,13,12,158,447,2.8,3,34.4,19,32.3,97,68,557,8.2,3,42.8,70.1,5.7,31,39.2,226,447,1004,1004,0,RB
4110,Deon Dyer,0,0,0,2001,24,MIA,16,0,0,0,,0,0,0,,2,0,0,,0,0,0,0,0,0,0,0,0,24,24,FB
4111,Marc Edwards,51,25,76,2001,27,NWE,16,13,51,141,2.8,1,8.8,16,49,39,25,166,6.6,2,10.4,64.1,4.3,11,35.9,76,141,307,330,23,FB
4112,Heath Evans,2,0,2,2001,23,SEA,16,0,2,11,5.5,0,0.7,0,0,0,0,0,,0,0,,,0,,2,11,11,51,40,FB
4113,Carl Fair,0,0,0,2001,22,CLE,3,0,0,0,,0,0,0,,0,0,0,,0,0,,,0,,0,0,0,0,0,RB
4114,Kevin Faulk,41,30,71,2001,25,NWE,15,1,41,169,4.1,1,11.3,10,39,36,30,189,6.3,2,12.6,83.3,5.3,9,50,71,192,358,1047,689,RB
4115,Marshall Faulk,260,83,343,2001,28,STL,14,14,260,1382,5.3,12,98.7,70,54.6,104,83,765,9.2,9,54.6,79.8,7.4,40,62.5,343,1382,2147,2147,0,RB
4116,James Fenderson,0,0,0,2001,25,NOR,4,0,0,0,,0,0,0,,0,0,0,,0,0,,,0,,0,0,0,0,0,RB
4117,Jim Finn,0,0,0,2001,25,IND,15,0,0,0,,0,0,0,,1,0,0,,0,0,0,0,0,0,0,0,0,29,29,FB
4118,Terrell Fletcher,29,23,52,2001,28,SDG,13,0,29,107,3.7,0,8.2,7,44.8,29,23,184,8,0,14.2,79.3,6.3,10,44.8,52,107,291,302,11,RB
4119,Chris Fuamatu-Ma'afala,120,16,136,2001,24,PIT,16,5,120,453,3.8,3,28.3,27,40,20,16,127,7.9,1,7.9,80,6.4,3,35,136,453,580,580,0,RB
4120,Charlie Garner,211,72,283,2001,29,OAK,16,16,211,839,4,1,52.4,33,46.9,91,72,578,8,2,36.1,79.1,6.4,29,54.9,283,839,1417,1417,0,RB
4121,Olandis Gary,57,4,61,2001,26,DEN,9,1,57,228,4,1,25.3,13,43.9,5,4,29,7.3,0,3.2,80,5.8,1,60,61,228,257,275,18,RB
4122,Sam Gash,2,9,11,2001,32,BAL,16,4,2,-1,-0.5,0,-0.1,0,0,14,9,80,8.9,1,5,64.3,5.7,3,42.9,11,-1,79,79,0,FB
4123,Ben Gay,51,4,55,2001,21,CLE,16,0,51,172,3.4,1,10.8,12,33.3,7,4,11,2.8,0,0.7,57.1,1.6,0,28.6,55,172,183,696,513,RB
4124,Eddie George,315,37,352,2001,28,TEN,16,16,315,939,3,5,58.7,40,33,51,37,279,7.5,0,17.4,72.5,5.5,11,54.9,352,939,1218,1218,0,RB
4125,Nick Goings,66,8,74,2001,23,CAR,13,2,66,197,3,0,15.2,10,36.4,9,8,39,4.9,0,3,88.9,4.3,1,22.2,74,197,236,236,0,RB
4126,Herbert Goodman,1,0,1,2001,24,GNB,7,0,1,-1,-1,0,-0.1,0,0,0,0,0,,0,0,,,0,,1,-1,-1,20,21,RB
4127,Jay Graham,12,1,13,2001,26,SEA,11,0,12,43,3.6,0,3.9,4,50,1,1,6,6,0,0.5,100,6,0,100,13,43,49,105,56,RB
4128,Ahman Green,304,62,366,2001,24,GNB,16,16,304,1387,4.6,9,86.7,57,42.8,82,62,594,9.6,2,37.1,75.6,7.2,24,52.4,366,1387,1981,1981,0,RB
4129,Mike Green,15,12,27,2001,25,TEN,16,1,15,71,4.7,1,4.4,5,46.7,13,12,64,5.3,1,4,92.3,4.9,2,30.8,27,71,135,155,20,RB
4130,Troy Hambrick,113,4,117,2001,25,DAL,16,11,113,579,5.1,2,36.2,28,46,12,4,62,15.5,0,3.9,33.3,5.2,3,25,117,579,641,641,0,FB
4131,Patrick Hape,2,15,17,2001,27,DEN,15,8,2,0,0,0,0,0,0,19,15,96,6.4,3,6.4,78.9,5.1,7,52.6,17,0,96,96,0,FB
4132,Derrick Harris,0,1,1,2001,29,SDG,16,0,0,0,,0,0,0,,3,1,7,7,0,0.4,33.3,2.3,0,0,1,0,7,32,19,RB
4133,Garrison Hearst,252,41,293,2001,30,SFO,16,16,252,1206,4.8,4,75.4,53,48.8,55,41,347,8.5,1,21.7,74.5,6.3,15,58.2,293,1206,1553,1553,0,RB
4134,William Henderson,6,21,27,2001,30,GNB,16,8,6,11,1.8,0,0.7,2,50,28,21,193,9.2,0,12.1,75,6.9,8,53.6,27,11,204,266,62,FB
4135,Travis Henry,213,22,235,2001,23,BUF,13,12,213,729,3.4,4,56.1,39,37.6,27,22,179,8.1,0,13.8,81.5,6.6,6,37,235,729,908,908,0,RB
4136,Chris Hetherington,5,23,28,2001,29,CAR,16,1,5,12,2.4,0,0.8,1,20,35,23,124,5.4,0,7.8,65.7,3.5,1,22.9,28,12,136,167,31,FB
4137,Skip Hicks,56,5,61,2001,27,TEN,9,0,56,341,6.1,1,37.9,11,41.1,6,5,22,4.4,0,2.4,83.3,3.7,1,33.3,61,341,363,363,0,RB
4138,James Hodgins,2,4,6,2001,24,STL,16,11,2,5,2.5,0,0.3,0,50,7,4,24,6,1,1.5,57.1,3.4,2,42.9,6,5,29,29,0,FB
4139,Robert Holcombe,13,1,14,2001,26,STL,16,0,13,42,3.2,1,2.6,5,53.8,1,1,14,14,0,0.9,100,14,1,100,14,42,56,56,0,RB
4140,Priest Holmes,327,62,389,2001,28,KAN,16,16,327,1555,4.8,8,97.2,81,50.5,75,62,614,9.9,2,38.4,82.7,8.2,21,49.3,389,1555,2169,2169,0,RB
4141,Brad Hoover,17,26,43,2001,25,CAR,16,7,17,71,4.2,0,4.4,5,58.8,47,26,185,7.1,0,11.6,55.3,3.9,6,44.7,43,71,256,264,8,FB
4142,Richard Huntley,165,21,186,2001,29,CAR,14,9,165,665,4,2,47.5,30,39.4,32,21,101,4.8,1,7.2,65.6,3.2,3,25,186,665,766,786,20,RB
4143,James Jackson,195,7,202,2001,25,CLE,11,10,195,554,2.8,2,50.4,34,34.4,10,7,56,8,0,5.1,70,5.6,1,70,202,554,610,610,0,RB
4144,Terry Jackson,22,12,34,2001,25,SFO,16,1,22,138,6.3,1,8.6,9,63.6,14,12,91,7.6,2,5.7,85.7,6.5,5,71.4,34,138,229,229,0,FB
4145,Edgerrin James,151,24,175,2001,23,IND,6,6,151,662,4.4,3,110.3,42,53.6,29,24,193,8,0,32.2,82.8,6.7,9,51.7,175,662,855,855,0,RB
4146,Ronney Jenkins,1,0,1,2001,24,SDG,16,0,1,-1,-1,0,-0.1,0,0,0,0,0,,0,0,,,0,,1,-1,-1,1540,1541,RB
4147,Travis Jervey,3,0,3,2001,29,ATL,16,0,3,6,2,0,0.4,0,0,0,0,0,,0,0,,,0,,3,6,6,6,0,RB
4148,Bryan Johnson,0,9,9,2001,23,WAS,16,1,0,0,,0,0,0,,11,9,129,14.3,0,8.1,81.8,11.7,5,81.8,9,0,129,180,51,FB
4149,J.J. Johnson,5,4,9,2001,27,MIA,10,0,5,22,4.4,0,2.2,0,40,6,4,21,5.3,0,2.1,66.7,3.5,2,50,9,22,43,59,16,RB
4150,Leon Johnson,20,1,21,2001,27,CHI,12,0,20,99,5,4,8.3,10,50,2,1,0,0,0,0,50,0,0,0,21,117,99,640,541,RB
4151,Rudi Johnson,0,0,0,2001,22,CIN,2,0,0,0,,0,0,0,,0,0,0,,0,0,,,0,,0,0,0,79,79,RB
4152,Thomas Jones,112,21,133,2001,23,ARI,16,2,112,380,3.4,5,23.8,22,43.8,24,21,151,7.2,0,9.4,87.5,6.3,6,45.8,133,380,531,531,0,RB
4153,LaMont Jordan,39,7,46,2001,23,NYJ,16,0,39,292,7.5,1,18.3,14,53.8,10,7,44,6.3,1,2.8,70,4.4,2,20,46,292,336,398,62,RB
4154,Randy Jordan,13,9,22,2001,31,OAK,16,0,13,59,4.5,0,3.7,1,38.5,15,9,63,7,0,3.9,60,4.2,1,20,22,59,122,122,0,RB
4155,Elvis Joseph,68,18,86,2001,23,JAX,14,3,68,294,4.3,0,21,13,45.6,24,18,183,10.2,2,13.1,75,7.6,8,45.8,86,294,477,905,428,RB
4156,Curtis Keaton,5,1,6,2001,25,CIN,13,0,5,48,9.6,0,3.7,3,60,1,1,9,9,0,0.7,100,9,0,100,6,48,57,948,891,RB
4157,Terry Kirby,10,9,19,2001,31,OAK,11,0,10,49,4.9,0,4.5,4,40,9,9,62,6.9,0,5.6,100,6.9,1,66.7,19,49,111,1177,1066,RB
4158,Jim Kleinsasser,23,24,47,2001,24,MIN,11,11,23,72,3.1,1,6.5,6,52.2,28,24,184,7.7,0,16.7,85.7,6.6,8,57.1,47,72,256,256,0,FB
4159,Rob Konrad,5,5,10,2001,25,MIA,12,9,5,22,4.4,1,1.8,2,40,13,5,52,10.4,1,4.3,38.5,4,3,30.8,10,22,74,74,0,FB
4160,Dan Kreider,7,2,9,2001,24,PIT,13,1,7,29,4.1,1,2.2,4,71.4,4,2,5,2.5,0,0.4,50,1.3,0,25,9,29,34,34,0,FB
4161,George Layne,0,0,0,2001,23,ATL,2,0,0,0,,0,0,0,,0,0,0,,0,0,,,0,,0,0,0,0,0,RB
4162,Dorsey Levens,44,24,68,2001,31,GNB,15,1,44,165,3.8,0,11,6,29.5,35,24,159,6.6,1,10.6,68.6,4.5,7,31.4,68,165,324,686,362,RB
4163,Stacey Mack,213,23,236,2001,26,JAX,16,11,213,877,4.1,9,54.8,50,46.5,34,23,165,7.2,1,10.3,67.6,4.9,6,44.1,236,877,1042,1091,49,RB
4164,Joel Makovicka,1,16,17,2001,26,ARI,16,14,1,19,19,0,1.2,1,100,28,16,95,5.9,1,5.9,57.1,3.4,4,35.7,17,19,114,121,7,FB
4165,Cecil Martin,9,24,33,2001,26,PHI,16,15,9,27,3,0,1.7,0,22.2,34,24,124,5.2,2,7.8,70.6,3.6,5,38.2,33,27,151,151,0,FB
4166,Curtis Martin,333,53,386,2001,28,NYJ,16,16,333,1513,4.5,10,94.6,78,46.5,63,53,320,6,0,20,84.1,5.1,13,39.7,386,1531,1833,1833,0,RB
4167,Fred McAfee,1,0,1,2001,33,NOR,16,0,1,2,2,0,0.1,0,0,0,0,0,,0,0,,,0,,1,2,2,146,144,RB
4168,Deuce McAllister,16,15,31,2001,23,NOR,16,4,16,91,5.7,1,5.7,4,31.3,20,15,166,11.1,1,10.4,75,8.3,8,55,31,103,257,1372,1115,RB
4169,Fred McCrary,2,13,15,2001,29,SDG,16,12,2,3,1.5,0,0.2,1,50,23,13,71,5.5,0,4.4,56.5,3.1,2,43.5,15,3,74,74,0,FB
4170,Kevin McDougal,17,1,18,2001,24,IND,9,0,17,48,2.8,0,5.3,4,47.1,2,1,10,10,0,1.1,50,5,0,0,18,48,58,420,362,RB
4171,Dennis McKinley,1,1,2,2001,25,ARI,14,0,1,1,1,0,0.1,0,0,1,1,10,10,0,0.7,100,10,1,100,2,1,11,22,11,FB
4172,Rondell Mealey,11,2,13,2001,24,GNB,11,0,11,37,3.4,0,3.4,1,54.5,2,2,31,15.5,0,2.8,100,15.5,2,100,13,37,68,158,63,RB
4173,Travis Minor,59,29,88,2001,22,MIA,16,0,59,281,4.8,2,17.6,11,39,37,29,263,9.1,1,16.4,78.4,7.1,12,48.6,88,281,544,544,0,RB
4174,Brian Mitchell,7,6,13,2001,33,PHI,16,0,7,9,1.3,0,0.6,1,14.3,8,6,122,20.3,0,7.6,75,15.3,3,37.5,13,9,131,1623,1492,RB
4175,Frank Moreau,8,0,8,2001,25,JAX,3,1,8,27,3.4,1,9,3,37.5,0,0,0,,0,0,,,0,,8,27,27,27,0,RB
4176,Harold Morrow,12,13,25,2001,28,MIN,16,2,12,67,5.6,0,4.2,4,66.7,18,13,142,10.9,0,8.9,72.2,7.9,7,50,25,67,209,318,109,FB
4177,Sammy Morris,20,7,27,2001,24,BUF,16,1,20,72,3.6,0,4.5,2,45,9,7,36,5.1,0,2.3,77.8,4,3,55.6,27,72,108,108,0,RB
4178,Chad Morton,0,0,0,2001,24,NYJ,9,0,0,0,,0,0,0,,0,0,0,,0,0,,,0,,0,0,0,360,360,RB
4179,Lorenzo Neal,5,19,24,2001,31,CIN,16,10,5,10,2,0,0.6,0,60,27,19,101,5.3,1,6.3,70.4,3.7,4,40.7,24,10,111,111,0,FB
4180,Moran Norris,0,0,0,2001,23,NOR,5,0,0,0,,0,0,0,,0,0,0,,0,0,,,0,,0,0,0,0,0,FB
4181,Brock Olivo,1,0,1,2001,25,DET,16,0,1,6,6,0,0.4,1,100,1,0,0,,0,0,0,0,0,0,1,6,6,46,40,RB
4182,Wes Ours,0,1,1,2001,24,TEN,3,0,0,0,,0,0,0,,1,1,3,3,0,1,100,3,0,0,1,0,3,3,0,RB
4183,Patrick Pass,1,6,7,2001,24,NWE,16,0,1,7,7,0,0.4,0,100,10,6,66,11,1,4.1,60,6.6,3,40,7,7,73,295,222,FB
4184,Michael Pittman,241,42,283,2001,26,ARI,15,14,241,846,3.5,5,56.4,42,40.2,66,42,264,6.3,0,17.6,63.6,4,10,31.8,283,846,1110,1271,161,RB
4185,Travis Prentice,14,1,15,2001,25,MIN,14,0,14,13,0.9,2,0.9,3,28.6,1,1,10,10,0,0.7,100,10,0,100,15,13,23,25,2,RB
4186,Stanley Pritchett,0,0,0,2001,28,CHI,7,0,0,0,,0,0,0,,1,0,0,,0,0,0,0,0,0,0,0,0,0,0,FB
4187,Jamie Reader,0,2,2,2001,27,PHI,16,0,0,0,,0,0,0,,5,2,14,7,0,0.9,40,2.8,1,20,2,0,14,14,0,FB
4188,J.R. Redmond,35,13,48,2001,24,NWE,12,0,35,119,3.4,0,9.9,5,28.6,21,13,132,10.2,0,11,61.9,6.3,6,47.6,48,119,251,308,57,RB
4189,Dominic Rhodes,233,34,267,2001,22,IND,15,10,233,1104,4.7,9,73.6,58,48.1,55,34,224,6.6,0,14.9,61.8,4.1,13,32.7,267,1104,1328,1681,356,RB
4190,Alan Ricard,0,0,0,2001,24,BAL,5,0,0,0,,0,0,0,,0,0,0,,0,0,,,0,,0,0,0,0,0,FB
4191,Tony Richardson,66,30,96,2001,30,KAN,14,8,66,191,2.9,7,13.6,24,51.5,40,30,265,8.8,0,18.9,75,6.6,12,50,96,191,456,456,0,FB
4192,Jon Ritchie,0,19,19,2001,27,OAK,15,10,0,0,,0,0,0,,27,19,154,8.1,2,10.3,70.4,5.7,5,37,19,0,154,154,0,FB
4193,Charlie Rogers,0,1,1,2001,25,SEA,13,0,0,0,,0,0,0,,1,1,7,7,0,0.5,100,7,0,0,1,0,7,1371,1364,RB
4194,Cory Schlesinger,47,60,107,2001,29,DET,16,13,47,154,3.3,3,9.6,16,46.8,85,60,466,7.8,0,29.1,70.6,5.5,14,45.9,107,154,620,630,10,FB
4195,Daimon Shelton,0,12,12,2001,29,CHI,16,9,0,0,,0,0,0,,18,12,76,6.3,1,4.8,66.7,4.2,3,33.3,12,0,76,76,0,FB
4196,Marcel Shipp,0,0,0,2001,23,ARI,11,0,0,0,,0,0,0,,0,0,0,,0,0,,,0,,0,0,0,118,118,RB
4197,Rod Smart,2,0,2,2001,24,PHI,6,0,2,6,3,0,1,0,0,0,0,0,,0,0,,,0,,2,6,6,6,0,RB
4198,Antowain Smith,287,19,306,2001,29,NWE,16,15,287,1157,4,12,72.3,61,45.6,28,19,192,10.1,1,12,67.9,6.9,6,35.7,306,1157,1349,1349,0,RB
4199,Detron Smith,0,0,0,2001,27,DEN,15,0,0,0,,0,0,0,,0,0,0,,0,0,,,0,,0,0,0,4,4,RB
4200,Emmitt Smith,261,17,278,2001,32,DAL,14,14,261,1021,3.9,3,72.9,48,37.9,21,17,116,6.8,0,8.3,81,5.5,6,57.1,278,1021,1137,1137,0,RB
4201,Lamar Smith,313,30,343,2001,31,MIA,16,16,313,968,3.1,6,60.5,48,37.1,35,30,234,7.8,2,14.6,85.7,6.7,8,51.4,343,968,1202,1202,0,RB
4202,Maurice Smith,237,19,256,2001,25,ATL,16,12,237,760,3.2,5,47.5,38,36.3,27,19,230,12.1,1,14.4,70.4,8.5,7,48.1,256,760,990,990,0,RB
4203,Paul Smith,4,0,4,2001,23,SFO,15,0,4,27,6.8,1,1.8,1,75,0,0,0,,0,0,,,0,,4,27,27,64,37,RB
4204,Terrelle Smith,5,4,9,2001,23,NOR,14,9,5,8,1.6,0,0.6,1,40,8,4,30,7.5,2,2.1,50,3.8,3,50,9,8,38,38,0,FB
4205,Matt Snider,0,0,0,2001,25,MIN,4,0,0,0,,0,0,0,,0,0,0,,0,0,,,0,,0,0,0,0,0,FB
4206,Jerald Sowell,4,1,5,2001,27,NYJ,16,0,4,9,2.3,0,0.6,0,0,1,1,19,19,0,1.2,100,19,1,100,5,9,28,34,6,FB
4207,Duce Staley,166,63,229,2001,26,PHI,13,10,166,604,3.6,2,46.5,29,41,91,63,626,9.9,2,48.2,69.2,6.9,19,44,229,604,1230,1225,0,RB
4208,Aaron Stecker,24,10,34,2001,26,TAM,13,0,24,72,3,1,5.5,3,41.7,13,10,101,10.1,1,7.8,76.9,7.8,6,53.8,34,72,173,432,259,RB
4209,James Stewart,143,23,166,2001,30,DET,11,10,143,685,4.8,1,62.3,23,39.2,26,23,242,10.5,1,22,88.5,9.3,9,50,166,685,927,927,0,RB
4210,Mack Strong,17,17,34,2001,30,SEA,16,13,17,55,3.2,0,3.4,10,76.5,29,17,141,8.3,0,8.8,58.6,4.9,3,37.9,34,55,196,212,16,FB
4211,Fred Taylor,30,2,32,2001,25,JAX,2,2,30,116,3.9,0,58,6,43.3,3,2,13,6.5,0,6.5,66.7,4.3,1,33.3,32,116,129,129,0,RB
4212,Tony Taylor,1,0,1,2001,23,DAL,1,0,1,0,0,0,0,0,0,0,0,0,,0,0,,,0,,1,0,0,0,0,RB
4213,Anthony Thomas,278,22,300,2001,24,CHI,14,10,278,1183,4.3,7,84.5,58,43.9,30,22,178,8.1,0,12.7,73.3,5.9,9,46.7,300,1183,1361,1361,0,RB
4214,Rodney Thomas,37,2,39,2001,28,ATL,12,0,37,126,3.4,0,10.5,5,40.5,3,2,26,13,0,2.2,66.7,8.7,1,66.7,39,126,152,152,0,RB
4215,Robert Thomas,6,5,11,2001,27,DAL,5,5,6,40,6.7,0,8,2,66.7,10,5,19,3.8,1,3.8,50,1.9,2,30,11,40,59,59,0,FB
4216,LaDainian Tomlinson,339,59,398,2001,22,SDG,16,16,339,1236,3.6,10,77.3,68,43.7,74,59,367,6.2,0,22.9,79.7,5,12,47.3,398,1236,1603,1603,0,RB
4217,Stephen Trejo,0,5,5,2001,24,DET,14,0,0,0,,0,0,0,,10,5,61,12.2,0,4.4,50,6.1,4,50,5,0,61,61,0,FB
4218,Lamont Warren,61,40,101,2001,28,DET,16,3,61,191,3.1,3,11.9,11,39.3,60,40,336,8.4,1,21,66.7,5.6,15,43.3,101,191,527,523,-4,RB
4219,Damon Washington,28,4,32,2001,24,NYG,10,0,28,89,3.2,0,8.9,5,28.6,6,4,25,6.3,0,2.5,66.7,4.2,1,16.7,32,89,114,213,99,RB
4220,Patrick Washington,0,5,5,2001,23,JAX,16,6,0,0,,0,0,0,,9,5,36,7.2,0,2.3,55.6,4,1,44.4,5,0,36,36,0,FB
4221,Justin Watson,1,0,1,2001,26,STL,11,0,1,0,0,0,0,0,0,0,0,0,,0,0,,,0,,1,0,0,0,0,RB
4222,Ricky Watters,72,11,83,2001,32,SEA,5,4,72,318,4.4,1,63.6,15,45.8,22,11,107,9.7,0,21.4,50,4.9,4,31.8,83,318,425,425,0,RB
4223,Tyrone Wheatley,88,12,100,2001,29,OAK,11,2,88,276,3.1,5,25.1,21,48.9,16,12,61,5.1,1,5.5,75,3.8,4,37.5,100,276,337,337,0,RB
4224,Jamel White,126,44,170,2001,24,CLE,16,7,126,443,3.5,5,27.7,28,42.9,60,44,418,9.5,1,26.1,73.3,7,18,43.3,170,443,861,1050,189,RB
4225,Reggie White,0,0,0,2001,22,JAX,5,0,0,0,,0,0,0,,0,0,0,,0,0,,,0,,0,0,0,0,0,RB
4226,Michael Wiley,34,16,50,2001,23,DAL,16,0,34,247,7.3,0,15.4,12,50,27,16,99,6.2,1,6.2,59.3,3.7,5,14.8,50,247,346,436,90,RB
4227,Jermaine Williams,0,2,2,2001,28,"KAN,OAK",12,2,0,0,,0,0,0,,3,2,11,5.5,0,0.9,66.7,3.7,0,0,2,0,11,11,0,RB
4228,Moe Williams,65,23,88,2001,27,BAL,15,2,65,291,4.5,0,19.4,9,36.9,35,23,210,9.1,0,14,65.7,6,13,42.9,88,291,501,501,0,RB
4229,Nick Luchey,0,0,0,2001,24,CIN,4,2,0,0,,0,0,0,,1,0,0,,0,0,0,0,0,0,0,0,0,0,0,FB
4230,Ricky Williams,313,60,373,2001,24,NOR,16,16,313,1245,4,6,77.8,61,41.9,88,60,511,8.5,1,31.9,68.2,5.8,19,40.9,373,1245,1756,1760,0,RB
4231,Terry Witherspoon,0,1,1,2001,24,DAL,3,0,0,0,,0,0,0,,1,1,9,9,0,3,100,9,0,0,1,0,9,9,0,FB
4232,Jon Witman,5,6,11,2001,29,PIT,15,12,5,24,4.8,0,1.6,1,40,8,6,32,5.3,0,2.1,75,4,0,25,11,24,56,56,0,FB
4233,Amos Zereoue,85,13,98,2001,25,PIT,14,0,85,441,5.2,1,31.5,26,47.1,14,13,154,11.8,1,11,92.9,11,5,50,98,441,595,595,0,RB
4234,Karim Abdul-Jabbar,1,0,1,2000,26,IND,1,0,1,-2,-2,0,-2,0,0,0,0,0,,0,0,,,0,,1,-2,-2,-2,0,RB
4235,Rabih Abdullah,16,2,18,2000,25,TAM,12,0,16,70,4.4,0,5.8,5,43.8,2,2,14,7,0,1.2,100,7,1,50,18,70,84,100,16,RB
4236,Shaun Alexander,64,5,69,2000,23,SEA,16,1,64,313,4.9,2,19.6,20,45.3,11,5,41,8.2,0,2.6,45.5,3.7,2,18.2,69,313,354,354,0,RB
4237,James Allen,290,39,329,2000,25,CHI,16,15,290,1120,3.9,2,70,56,45.9,60,39,291,7.5,1,18.2,65,4.9,17,41.7,329,1120,1411,1411,0,RB
4238,Terry Allen,46,1,47,2000,32,NOR,4,3,46,179,3.9,2,44.8,9,43.5,1,1,7,7,0,1.8,100,7,0,0,47,179,186,192,6,RB
4239,Mike Alstott,131,13,144,2000,27,TAM,13,13,131,465,3.5,5,35.8,37,51.1,19,13,93,7.2,0,7.2,68.4,4.9,3,47.4,144,465,558,558,0,FB
4240,Jamal Anderson,282,42,324,2000,28,ATL,16,16,282,1024,3.6,6,64,52,42.9,58,42,382,9.1,0,23.9,72.4,6.6,15,46.6,324,1024,1406,1406,0,RB
4241,Kimble Anders,76,15,91,2000,34,KAN,15,7,76,331,4.4,2,22.1,1,14.5,19,15,76,5.1,0,5.1,78.9,4,0,36.8,91,331,407,421,14,RB
4242,Mike Anderson,297,23,320,2000,27,DEN,16,12,297,1487,5,15,92.9,78,46.1,32,23,169,7.3,0,10.6,71.9,5.3,8,43.8,320,1487,1656,1656,0,RB
4243,Richie Anderson,27,88,115,2000,29,NYJ,16,10,27,63,2.3,0,3.9,8,44.4,125,88,853,9.7,2,53.3,70.4,6.8,35,51.2,115,63,916,916,0,FB
4244,Darnell Autry,112,24,136,2000,24,PHI,11,7,112,334,3,3,30.4,17,41.1,37,24,275,11.5,1,25,64.9,7.4,12,59.5,136,334,609,609,0,RB
4245,Obafemi Ayanbadejo,15,23,38,2000,25,BAL,8,4,15,37,2.5,1,4.6,4,53.3,29,23,168,7.3,1,21,79.3,5.8,9,48.3,38,37,205,205,0,RB
4246,Tiki Barber,213,70,283,2000,25,NYG,16,12,213,1006,4.7,8,62.9,39,40.8,95,70,719,10.3,1,44.9,73.7,7.6,29,48.4,283,1006,1725,2085,360,RB
4247,Marlon Barnes,15,1,16,2000,24,CHI,13,0,15,81,5.4,0,6.2,4,53.3,3,1,7,7,0,0.5,33.3,2.3,0,33.3,16,81,88,88,0,RB
4248,Mario Bates,31,15,46,2000,27,DET,13,0,31,127,4.1,2,9.8,12,41.9,21,15,109,7.3,0,8.4,71.4,5.2,5,28.6,46,127,236,236,0,RB
4249,Michael Bates,5,5,10,2000,31,CAR,16,0,5,13,2.6,0,0.8,0,40,8,5,38,7.6,0,2.4,62.5,4.8,1,25,10,13,51,1023,972,RB
4250,Fred Beasley,50,31,81,2000,26,SFO,15,15,50,147,2.9,3,9.8,14,46,51,31,233,7.5,3,15.5,60.8,4.6,11,35.3,81,147,380,380,0,FB
4251,Brandon Bennett,90,19,109,2000,27,CIN,16,0,90,324,3.6,3,20.3,18,37.8,29,19,168,8.8,0,10.5,65.5,5.8,5,27.6,109,324,492,492,0,RB
4252,Donnell Bennett,27,2,29,2000,28,KAN,7,2,27,24,0.9,1,3.4,7,37,2,2,17,8.5,0,2.4,100,8.5,1,50,29,24,41,41,0,RB
4253,Jerome Bettis,355,13,368,2000,28,PIT,16,16,355,1341,3.8,8,83.8,72,47.3,19,13,97,7.5,0,6.1,68.4,5.1,5,47.4,368,1341,1438,1439,0,RB
4254,Tim Biakabutuka,173,34,207,2000,26,CAR,12,11,173,627,3.6,2,52.3,29,38.7,58,34,341,10,2,28.4,58.6,5.9,15,46.6,207,627,968,968,0,RB
4255,Reggie Brown,3,2,5,2000,27,SEA,12,1,3,6,2,0,0.5,1,33.3,4,2,9,4.5,0,0.8,50,2.3,1,25,5,6,15,34,19,RB
4256,Shawn Bryson,161,32,193,2000,24,BUF,16,7,161,591,3.7,0,36.9,32,36.6,46,32,271,8.5,2,16.9,69.6,5.9,10,37,193,591,862,984,122,RB
4257,Kenny Bynum,7,2,9,2000,26,SDG,14,0,7,26,3.7,0,1.9,1,28.6,2,2,13,6.5,0,0.9,100,6.5,0,50,9,26,39,281,242,RB
4258,Trung Canidate,3,1,4,2000,23,STL,3,0,3,6,2,0,2,0,0,3,1,4,4,0,1.3,33.3,1.3,0,0,4,6,10,10,0,RB
4259,Tony Carter,37,9,46,2000,28,NWE,16,6,37,90,2.4,2,5.6,10,37.8,15,9,73,8.1,0,4.6,60,4.9,3,33.3,46,90,163,179,16,FB
4260,Larry Centers,19,81,100,2000,32,WAS,15,6,19,103,5.4,0,6.9,4,47.4,93,81,600,7.4,3,40,87.1,6.5,27,43,100,103,703,703,0,FB
4261,Robert Chancey,42,1,43,2000,28,SDG,4,3,42,141,3.4,2,35.3,9,33.3,2,1,6,6,0,1.5,50,3,0,50,43,141,147,147,0,RB
4262,Bob Christian,9,44,53,2000,32,ATL,16,14,9,19,2.1,0,1.2,1,22.2,63,44,315,7.2,0,19.7,69.8,5,12,38.1,53,19,334,344,0,FB
4263,Mike Cloud,30,2,32,2000,25,KAN,16,4,30,84,2.8,1,5.3,3,33.3,2,2,16,8,0,1,100,8,1,50,32,84,100,879,779,RB
4264,KaRon Coleman,54,1,55,2000,22,DEN,9,0,54,183,3.4,1,20.3,10,44.4,3,1,5,5,0,0.6,33.3,1.7,0,0,55,183,188,188,0,RB
4265,Greg Comella,10,36,46,2000,25,NYG,16,12,10,45,4.5,0,2.8,2,30,50,36,274,7.6,0,17.1,72,5.5,13,42,46,45,319,339,20,FB
4266,Zack Crockett,43,10,53,2000,28,OAK,16,4,43,130,3,7,8.1,11,46.5,15,10,62,6.2,0,3.9,66.7,4.1,3,46.7,53,130,192,192,0,FB
4267,Stephen Davis,332,33,365,2000,26,WAS,15,15,332,1318,4,11,87.9,72,46.7,49,33,313,9.5,0,20.9,67.3,6.4,12,49,365,1318,1631,1631,0,RB
4268,Terrell Davis,78,2,80,2000,28,DEN,5,4,78,282,3.6,2,56.4,15,42.3,2,2,4,2,0,0.8,100,2,0,50,80,282,286,286,0,RB
4269,Ron Dayne,228,3,231,2000,22,NYG,16,4,228,770,3.4,5,48.1,48,43.4,3,3,11,3.7,0,0.7,100,3.7,1,33.3,231,770,781,781,0,RB
4270,Autry Denson,31,14,45,2000,24,MIA,11,0,31,108,3.5,0,9.8,5,35.5,23,14,105,7.5,0,9.5,60.9,4.6,6,34.8,45,108,213,708,495,RB
4271,Corey Dillon,315,18,333,2000,26,CIN,16,16,315,1435,4.6,7,89.7,71,44.8,26,18,158,8.8,0,9.9,69.2,6.1,5,42.3,333,1435,1593,1593,0,RB
4272,Gary Downs,0,0,0,2000,28,ATL,16,0,0,0,,0,0,0,,0,0,0,,0,0,,,0,,0,0,0,0,0,RB
4273,Chad Dukes,2,0,2,2000,29,"JAX,WAS",2,0,2,2,1,0,1,0,0,0,0,0,,0,0,,,0,,2,2,2,2,0,RB
4274,Warrick Dunn,248,44,292,2000,25,TAM,16,14,248,1133,4.6,8,70.8,43,43.5,69,44,422,9.6,1,26.4,63.8,6.1,21,39.1,292,1133,1555,1555,0,RB
4275,Deon Dyer,0,2,2,2000,23,MIA,16,1,0,0,,0,0,0,,2,2,14,7,0,0.9,100,7,1,50,2,0,14,14,0,FB
4276,Marc Edwards,2,16,18,2000,26,CLE,16,8,2,9,4.5,0,0.6,0,100,22,16,128,8,2,8,72.7,5.8,5,59.1,18,9,137,161,24,FB
4277,Curtis Enis,36,8,44,2000,24,CHI,12,5,36,84,2.3,1,7,4,44.4,11,8,68,8.5,0,5.7,72.7,6.2,5,45.5,44,84,152,182,30,FB
4278,Charles Evans,0,0,0,2000,33,BAL,1,0,0,0,,0,0,0,,0,0,0,,0,0,,,0,,0,0,0,0,0,RB
4279,Kevin Faulk,164,51,215,2000,24,NWE,16,9,164,570,3.5,4,35.6,32,39.6,68,51,465,9.1,1,29.1,75,6.8,18,50,215,570,1035,1909,874,RB
4280,Marshall Faulk,253,81,334,2000,27,STL,14,14,253,1359,5.4,18,97.1,78,55.7,113,81,830,10.2,8,59.3,71.7,7.3,42,54,334,1359,2189,2207,18,RB
4281,Jermaine Fazande,119,16,135,2000,25,SDG,13,7,119,368,3.1,2,28.3,22,36.1,18,16,104,6.5,0,8,88.9,5.8,2,50,135,368,472,472,0,RB
4282,Jim Finn,1,4,5,2000,24,IND,16,1,1,1,1,0,0.1,0,0,6,4,13,3.3,1,0.8,66.7,2.2,1,16.7,5,1,14,14,0,FB
4283,Terrell Fletcher,116,48,164,2000,27,SDG,16,6,116,384,3.3,3,24,18,36.2,71,48,355,7.4,1,22.2,67.6,5,17,39.4,164,384,739,739,0,RB
4284,Chris Floyd,2,1,3,2000,25,"CLE,NWE",13,0,2,-1,-0.5,0,-0.1,0,0,2,1,21,21,0,1.6,50,10.5,1,50,3,-1,20,20,0,RB
4285,William Floyd,16,17,33,2000,28,CAR,10,8,16,33,2.1,1,3.3,2,50,27,17,114,6.7,1,11.4,63,4.2,8,40.7,33,33,147,147,0,FB
4286,Chris Fuamatu-Ma'afala,21,11,32,2000,23,PIT,7,1,21,149,7.1,1,21.3,6,52.4,16,11,107,9.7,0,15.3,68.8,6.7,6,43.8,32,149,256,256,0,RB
4287,Charlie Garner,258,68,326,2000,28,SFO,16,15,258,1142,4.4,7,71.4,57,45,94,68,647,9.5,3,40.4,72.3,6.9,28,52.1,326,1142,1789,1789,0,RB
4288,Olandis Gary,13,3,16,2000,25,DEN,1,0,13,80,6.2,0,80,5,53.8,5,3,10,3.3,0,10,60,2,0,60,16,80,90,90,0,RB
4289,Sam Gash,2,6,8,2000,31,BAL,15,4,2,2,1,0,0.1,0,0,11,6,30,5,1,2,54.5,2.7,1,18.2,8,2,32,32,0,FB
4290,Eddie George,403,50,453,2000,27,TEN,16,16,403,1509,3.7,14,94.3,78,41.4,65,50,453,9.1,2,28.3,76.9,7,23,55.4,453,1509,1962,1962,0,RB
4291,Herbert Goodman,3,1,4,2000,23,GNB,5,0,3,-2,-0.7,0,-0.4,0,0,1,1,0,0,0,0,100,0,0,0,4,-2,-2,127,129,RB
4292,Lennox Gordon,4,0,4,2000,22,IND,9,0,4,13,3.3,0,1.4,1,50,0,0,0,,0,0,,,0,,4,13,13,13,0,RB
4293,Ahman Green,263,73,336,2000,23,GNB,16,11,263,1175,4.5,10,73.4,62,47.1,99,73,559,7.7,3,34.9,73.7,5.6,28,45.5,336,1175,1734,1734,0,RB
4294,Mike Green,0,0,0,2000,24,TEN,1,0,0,0,,0,0,0,,1,0,0,,0,0,0,0,0,0,0,0,0,0,0,RB
4295,Howard Griffith,5,16,21,2000,33,DEN,14,14,5,4,0.8,0,0.3,2,40,31,16,101,6.3,2,7.2,51.6,3.3,7,41.9,21,4,105,105,0,FB
4296,Clif Groce,3,11,14,2000,28,CIN,8,6,3,4,1.3,0,0.5,1,33.3,13,11,45,4.1,0,5.6,84.6,3.5,2,30.8,14,4,49,49,0,FB
4297,Troy Hambrick,6,0,6,2000,24,DAL,3,0,6,28,4.7,0,9.3,2,50,0,0,0,,0,0,,,0,,6,28,28,28,0,RB
4298,Raymont Harris,13,4,17,2000,30,"DEN,NWE",4,0,13,36,2.8,0,9,1,46.2,4,4,20,5,0,5,100,5,1,25,17,36,56,56,0,RB
4299,William Henderson,2,35,37,2000,29,GNB,16,6,2,16,8,0,1,0,100,45,35,234,6.7,1,14.6,77.8,5.2,10,60,37,16,250,330,80,FB
4300,Chris Hetherington,23,14,37,2000,28,CAR,16,5,23,65,2.8,2,4.1,5,34.8,21,14,116,8.3,1,7.3,66.7,5.5,9,52.4,37,65,181,202,21,FB
4301,Skip Hicks,29,5,34,2000,26,WAS,10,1,29,78,2.7,1,7.8,6,37.9,5,5,43,8.6,0,4.3,100,8.6,1,60,34,78,121,138,17,RB
4302,James Hodgins,1,2,3,2000,23,STL,15,2,1,3,3,0,0.2,0,0,2,2,5,2.5,0,0.3,100,2.5,0,0,3,3,8,8,0,FB
4303,Robert Holcombe,21,8,29,2000,25,STL,14,9,21,70,3.3,3,5,8,71.4,12,8,90,11.3,1,6.4,66.7,7.5,5,66.7,29,70,160,160,0,FB
4304,Priest Holmes,137,32,169,2000,27,BAL,16,2,137,588,4.3,2,36.8,38,51.1,46,32,221,6.9,0,13.8,69.6,4.8,11,39.1,169,588,809,816,7,RB
4305,Brad Hoover,89,15,104,2000,24,CAR,16,4,89,290,3.3,1,18.1,12,42.7,19,15,112,7.5,0,7,78.9,5.9,6,63.2,104,290,402,402,0,FB
4306,Chris Howard,21,3,24,2000,25,JAX,2,1,21,52,2.5,1,26,4,38.1,5,3,26,8.7,0,13,60,5.2,2,40,24,52,78,78,0,RB
4307,Richard Huntley,46,10,56,2000,28,PIT,13,0,46,215,4.7,3,16.5,13,41.3,19,10,91,9.1,0,7,52.6,4.8,4,31.6,56,215,306,306,0,RB
4308,Sedrick Irvin,9,8,17,2000,22,DET,6,0,9,49,5.4,0,8.2,1,33.3,12,8,90,11.3,0,15,66.7,7.5,4,50,17,49,139,139,0,RB
4309,Terry Jackson,5,5,10,2000,24,SFO,15,1,5,6,1.2,1,0.4,2,40,5,5,48,9.6,1,3.2,100,9.6,4,80,10,6,54,63,9,FB
4310,Edgerrin James,387,63,450,2000,22,IND,16,16,387,1709,4.4,13,106.8,100,53,87,63,594,9.4,5,37.1,72.4,6.8,24,52.9,450,1709,2303,2303,0,RB
4311,Ronney Jenkins,8,1,9,2000,23,SDG,16,0,8,6,0.8,0,0.4,0,0,2,1,1,1,0,0.1,50,0.5,0,0,9,6,7,1538,1531,RB
4312,Travis Jervey,1,0,1,2000,28,SFO,8,0,1,0,0,0,0,0,0,0,0,0,,0,0,,,0,,1,0,0,209,209,RB
4313,Anthony Johnson,28,12,40,2000,33,JAX,12,3,28,112,4,1,9.3,6,42.9,16,12,153,12.8,0,12.8,75,9.6,6,56.3,40,112,265,265,0,RB
4314,Bryan Johnson,0,0,0,2000,22,WAS,1,0,0,0,,0,0,0,,0,0,0,,0,0,,,0,,0,0,0,0,0,FB
4315,J.J. Johnson,50,10,60,2000,26,MIA,13,1,50,168,3.4,1,12.9,5,42,12,10,61,6.1,0,4.7,83.3,5.1,2,50,60,168,229,255,26,RB
4316,Leon Johnson,0,0,0,2000,26,NYJ,3,0,0,0,,0,0,0,,0,0,0,,0,0,,,0,,0,0,0,179,179,RB
4317,Thomas Jones,112,32,144,2000,22,ARI,14,4,112,373,3.3,2,26.6,23,45.5,46,32,208,6.5,0,14.9,69.6,4.5,9,41.3,144,373,581,581,0,RB
4318,Randy Jordan,46,27,73,2000,30,OAK,16,0,46,213,4.6,3,13.3,10,37,32,27,299,11.1,1,18.7,84.4,9.3,15,59.4,73,213,512,512,0,RB
4319,Napoleon Kaufman,93,13,106,2000,27,OAK,14,2,93,499,5.4,0,35.6,22,40.9,24,13,127,9.8,1,9.1,54.2,5.3,8,41.7,106,499,626,824,198,RB
4320,Curtis Keaton,6,0,6,2000,24,CIN,6,0,6,24,4,0,4,1,66.7,0,0,0,,0,0,,,0,,6,24,24,124,100,RB
4321,Charles Kirby,0,0,0,2000,26,TAM,6,2,0,0,,0,0,0,,0,0,0,,0,0,,,0,,0,0,0,0,0,FB
4322,Terry Kirby,11,3,14,2000,30,OAK,2,0,11,51,4.6,0,25.5,2,27.3,4,3,19,6.3,0,9.5,75,4.8,1,50,14,51,70,70,0,RB
4323,Jim Kleinsasser,12,10,22,2000,23,MIN,14,8,12,43,3.6,0,3.1,2,50,14,10,98,9.8,0,7,71.4,7,4,35.7,22,43,141,141,0,FB
4324,Rob Konrad,15,14,29,2000,24,MIA,15,14,15,39,2.6,0,2.6,1,33.3,24,14,83,5.9,0,5.5,58.3,3.5,2,29.2,29,39,122,122,0,FB
4325,Dan Kreider,2,5,7,2000,23,PIT,10,7,2,24,12,0,2.4,1,50,8,5,42,8.4,0,4.2,62.5,5.3,2,50,7,24,66,66,0,FB
4326,Amp Lee,1,1,2,2000,29,PHI,3,0,1,2,2,0,0.7,0,0,3,1,20,20,0,6.7,33.3,6.7,1,33.3,2,2,22,22,0,RB
4327,Dorsey Levens,77,16,93,2000,30,GNB,5,5,77,224,2.9,3,44.8,13,28.6,21,16,146,9.1,0,29.2,76.2,7,9,52.4,93,224,370,370,0,RB
4328,Jamal Lewis,309,27,336,2000,21,BAL,16,13,309,1364,4.4,6,85.3,62,47.9,36,27,296,11,0,18.5,75,8.2,9,55.6,336,1364,1660,1660,0,RB
4329,Jonathan Linton,38,3,41,2000,26,BUF,14,2,38,112,2.9,0,8,6,39.5,4,3,8,2.7,1,0.6,75,2,1,25,41,112,120,160,40,RB
4330,Stacey Mack,54,0,54,2000,25,JAX,6,2,54,145,2.7,1,24.2,10,24.1,0,0,0,,0,0,,,0,,54,145,145,249,104,RB
4331,Joel Makovicka,3,6,9,2000,25,ARI,14,10,3,8,2.7,0,0.6,0,33.3,9,6,18,3,0,1.3,66.7,2,3,33.3,9,8,26,26,0,FB
4332,Cecil Martin,13,31,44,2000,25,PHI,16,9,13,77,5.9,0,4.8,2,46.2,39,31,219,7.1,0,13.7,79.5,5.6,13,51.3,44,77,296,296,0,FB
4333,Curtis Martin,316,70,386,2000,27,NYJ,16,16,316,1204,3.8,9,75.3,64,38.9,96,70,508,7.3,2,31.8,72.9,5.3,25,50,386,1222,1712,1712,0,RB
4334,Fred McAfee,2,0,2,2000,32,NOR,12,0,2,37,18.5,0,3.1,1,50,0,0,0,,0,0,,,0,,2,37,37,288,251,RB
4335,Fred McCrary,7,18,25,2000,28,SDG,15,12,7,8,1.1,0,0.5,1,14.3,26,18,141,7.8,2,9.4,69.2,5.4,9,46.2,25,8,149,149,0,FB
4336,Kevin McDougal,0,0,0,2000,23,IND,6,0,0,0,,0,0,0,,0,0,0,,0,0,,,0,,0,0,0,0,0,RB
4337,Dennis McKinley,0,2,2,2000,24,ARI,16,0,0,0,,0,0,0,,4,2,13,6.5,0,0.8,50,3.3,0,0,2,0,13,33,20,FB
4338,Natrone Means,0,0,0,2000,28,CAR,1,0,0,0,,0,0,0,,0,0,0,,0,0,,,0,,0,0,0,0,0,RB
4339,Glyn Milburn,1,1,2,2000,29,CHI,16,0,1,6,6,0,0.4,0,0,3,1,8,8,0,0.5,33.3,2.7,0,0,2,6,14,1782,1768,RB
4340,Brian Milne,2,5,7,2000,27,NOR,16,2,2,1,0.5,0,0.1,0,0,5,5,33,6.6,1,2.1,100,6.6,1,20,7,1,34,34,0,RB
4341,Basil Mitchell,2,0,2,2000,25,GNB,1,0,2,8,4,0,8,0,0,2,0,0,,0,0,0,0,0,0,2,8,8,34,26,RB
4342,Brian Mitchell,25,13,38,2000,32,PHI,16,1,25,187,7.5,2,11.7,9,52,21,13,89,6.8,1,5.6,61.9,4.2,5,38.1,38,208,276,1735,1459,RB
4343,Joe Montgomery,1,0,1,2000,24,NYG,3,0,1,4,4,1,1.3,1,100,0,0,0,,0,0,,,0,,1,4,4,4,0,RB
4344,Jerald Moore,37,0,37,2000,26,NOR,11,1,37,156,4.2,1,14.2,8,51.4,0,0,0,,0,0,,,0,,37,156,156,156,0,RB
4345,Frank Moreau,67,0,67,2000,24,KAN,11,0,67,179,2.7,4,16.3,17,40.3,1,0,0,,0,0,0,0,0,0,67,179,179,179,0,RB
4346,Jake Moreland,0,0,0,2000,23,NYJ,7,1,0,0,,0,0,0,,0,0,0,,0,0,,,0,,0,0,0,0,0,FB
4347,Harold Morrow,0,1,1,2000,27,MIN,16,0,0,0,,0,0,0,,1,1,2,2,0,0.1,100,2,0,0,1,0,2,19,17,FB
4348,Sammy Morris,93,37,130,2000,23,BUF,12,8,93,341,3.7,5,28.4,28,47.3,48,37,268,7.2,1,22.3,77.1,5.6,7,43.8,130,341,609,626,17,RB
4349,Chad Morton,36,30,66,2000,23,NOR,16,3,36,136,3.8,0,8.5,6,33.3,37,30,213,7.1,0,13.3,81.1,5.8,12,51.4,66,136,349,1656,1307,RB
4350,Adrian Murrell,20,16,36,2000,30,WAS,15,0,20,50,2.5,0,3.3,2,20,22,16,93,5.8,0,6.2,72.7,4.2,1,27.3,36,50,143,357,214,RB
4351,Lorenzo Neal,1,9,10,2000,30,TEN,16,6,1,-2,-2,0,-0.1,0,0,13,9,31,3.4,2,1.9,69.2,2.4,3,38.5,10,-2,29,44,15,FB
4352,Brock Olivo,0,3,3,2000,24,DET,13,0,0,0,,0,0,0,,4,3,50,16.7,0,3.8,75,12.5,3,75,3,0,50,75,25,RB
4353,Winslow Oliver,0,0,0,2000,27,ATL,12,0,0,0,,0,0,0,,0,0,0,,0,0,,,0,,0,0,0,54,54,RB
4354,De'Mond Parker,18,9,27,2000,24,GNB,8,0,18,85,4.7,0,10.6,4,44.4,12,9,50,5.6,0,6.3,75,4.2,3,50,27,85,135,135,0,RB
4355,Bernie Parmalee,27,9,36,2000,33,NYJ,14,0,27,87,3.2,2,6.2,8,40.7,13,9,66,7.3,0,4.7,69.2,5.1,2,38.5,36,87,153,153,0,RB
4356,Patrick Pass,18,4,22,2000,23,NWE,5,2,18,58,3.2,0,11.6,2,50,8,4,17,4.3,0,3.4,50,2.1,0,25,22,58,75,75,0,FB
4357,Jeff Paulk,0,0,0,2000,24,NWE,1,0,0,0,,0,0,0,,0,0,0,,0,0,,,0,,0,0,0,0,0,FB
4358,Michael Pittman,184,73,257,2000,25,ARI,16,12,184,719,3.9,4,44.9,36,44,91,73,579,7.9,2,36.2,80.2,6.4,18,45.1,257,719,1298,1298,0,RB
4359,Travis Prentice,173,37,210,2000,24,CLE,16,11,173,512,3,7,32,30,36.4,43,37,191,5.2,1,11.9,86,4.4,7,39.5,210,512,703,703,0,RB
4360,Stanley Pritchett,58,25,83,2000,27,PHI,16,2,58,225,3.9,1,14.1,11,43.1,30,25,193,7.7,0,12.1,83.3,6.4,15,56.7,83,225,418,433,15,FB
4361,J.R. Redmond,125,20,145,2000,23,NWE,12,5,125,406,3.2,1,33.8,14,35.2,29,20,126,6.3,2,10.5,69,4.3,5,27.6,145,406,532,557,25,RB
4362,Errict Rhett,71,14,85,2000,30,CLE,5,4,71,258,3.6,0,51.6,10,36.6,19,14,78,5.6,0,15.6,73.7,4.1,1,31.6,85,258,336,336,0,RB
4363,Tony Richardson,147,58,205,2000,29,KAN,16,16,147,697,4.7,3,43.6,35,46.9,75,58,468,8.1,3,29.3,77.3,6.2,19,44,205,697,1165,1165,0,FB
4364,Jon Ritchie,0,26,26,2000,26,OAK,13,12,0,0,,0,0,0,,33,26,173,6.7,0,13.3,78.8,5.2,9,42.4,26,0,173,173,0,FB
4365,Ron Rivers,8,0,8,2000,29,ATL,6,0,8,27,3.4,0,4.5,1,37.5,1,0,0,,0,0,0,0,0,0,8,27,27,27,0,RB
4366,Charlie Rogers,0,0,0,2000,24,SEA,15,0,0,0,,0,0,0,,1,0,0,,0,0,0,0,0,0,0,0,0,1992,1992,RB
4367,Cory Schlesinger,1,12,13,2000,28,DET,16,8,1,3,3,0,0.2,1,100,18,12,73,6.1,0,4.6,66.7,4.1,2,44.4,13,3,76,101,25,FB
4368,Harold Shaw,9,2,11,2000,26,NWE,16,0,9,12,1.3,0,0.8,1,22.2,4,2,11,5.5,0,0.7,50,2.8,0,25,11,12,23,23,0,RB
4369,Daimon Shelton,2,4,6,2000,28,JAX,16,9,2,3,1.5,0,0.2,0,0,10,4,48,12,0,3,40,4.8,3,40,6,3,51,51,0,FB
4370,Paul Shields,0,0,0,2000,24,IND,7,0,0,0,,0,0,0,,0,0,0,,0,0,,,0,,0,0,0,0,0,RB
4371,Antowain Smith,101,3,104,2000,28,BUF,11,3,101,354,3.5,4,32.2,19,42.6,5,3,20,6.7,0,1.8,60,4,1,60,104,354,374,374,0,RB
4372,Detron Smith,0,1,1,2000,26,DEN,16,0,0,0,,0,0,0,,3,1,1,1,1,0.1,33.3,0.3,1,33.3,1,0,1,74,73,RB
4373,Emmitt Smith,294,11,305,2000,31,DAL,16,16,294,1203,4.1,9,75.2,66,46.3,14,11,79,7.2,0,4.9,78.6,5.6,2,50,305,1203,1282,1282,0,RB
4374,Lamar Smith,309,31,340,2000,30,MIA,15,15,309,1139,3.7,14,75.9,65,45.3,38,31,201,6.5,2,13.4,81.6,5.3,8,47.4,340,1139,1340,1340,0,RB
4375,Maurice Smith,19,1,20,2000,24,ATL,10,0,19,69,3.6,0,6.9,5,47.4,1,1,5,5,0,0.5,100,5,0,0,20,69,74,74,0,RB
4376,Paul Smith,18,2,20,2000,22,SFO,10,0,18,72,4,0,7.2,3,50,3,2,55,27.5,0,5.5,66.7,18.3,1,66.7,20,72,127,294,167,RB
4377,Robert Smith,295,36,331,2000,28,MIN,16,16,295,1521,5.2,7,95.1,63,50.5,44,36,348,9.7,3,21.8,81.8,7.9,15,52.3,331,1521,1869,1869,0,RB
4378,Terrelle Smith,29,12,41,2000,22,NOR,14,9,29,131,4.5,0,9.4,5,58.6,18,12,65,5.4,0,4.6,66.7,3.6,1,50,41,131,196,196,0,FB
4379,Matt Snider,0,0,0,2000,24,GNB,16,0,0,0,,0,0,0,,0,0,0,,0,0,,,0,,0,0,0,0,0,FB
4380,Jerald Sowell,2,6,8,2000,26,NYJ,16,0,2,0,0,0,0,0,0,7,6,84,14,0,5.3,85.7,12,2,57.1,8,0,84,93,9,FB
4381,Duce Staley,79,25,104,2000,25,PHI,5,5,79,344,4.4,1,68.8,14,43,33,25,201,8,0,40.2,75.8,6.1,12,54.5,104,344,545,545,0,RB
4382,Aaron Stecker,12,1,13,2000,25,TAM,10,0,12,31,2.6,0,3.1,3,25,1,1,15,15,0,1.5,100,15,0,0,13,31,46,709,663,RB
4383,James Stewart,339,32,371,2000,29,DET,16,16,339,1184,3.5,10,74,66,46.3,48,32,287,9,1,17.9,66.7,6,15,37.5,371,1184,1471,1471,0,RB
4384,Shyrone Stith,20,0,20,2000,22,JAX,14,0,20,55,2.8,1,3.9,3,35,0,0,0,,0,0,,,0,,20,55,55,840,785,RB
4385,Mack Strong,3,23,26,2000,29,SEA,16,13,3,9,3,0,0.6,1,66.7,30,23,141,6.1,1,8.8,76.7,4.7,7,40,26,9,150,176,26,FB
4386,Fred Taylor,292,36,328,2000,24,JAX,13,13,292,1399,4.8,12,107.6,73,46.9,53,36,240,6.7,2,18.5,67.9,4.5,11,39.6,328,1399,1639,1638,0,RB
4387,Rodney Thomas,61,8,69,2000,27,TEN,16,0,61,175,2.9,0,10.9,6,27.9,11,8,35,4.4,1,2.2,72.7,3.2,2,27.3,69,175,210,210,0,RB
4388,Robert Thomas,15,23,38,2000,26,DAL,16,15,15,51,3.4,0,3.2,6,53.3,31,23,117,5.1,2,7.3,74.2,3.8,4,45.2,38,51,168,168,0,FB
4389,Thurman Thomas,28,16,44,2000,34,MIA,9,0,28,136,4.9,0,15.1,7,35.7,24,16,117,7.3,1,13,66.7,4.9,6,37.5,44,134,253,253,0,RB
4390,Craig Walendy,0,0,0,2000,23,NYG,12,0,0,0,,0,0,0,,0,0,0,,0,0,,,0,,0,0,0,0,0,RB
4391,Chris Warren,74,32,106,2000,32,"DAL,PHI",14,1,74,296,4,2,21.1,18,44.6,43,32,303,9.5,1,21.6,74.4,7,12,46.5,106,296,599,599,0,RB
4392,Damon Washington,0,0,0,2000,23,NYG,3,0,0,0,,0,0,0,,0,0,0,,0,0,,,0,,0,0,0,0,0,RB
4393,Justin Watson,54,10,64,2000,25,STL,14,2,54,249,4.6,4,17.8,13,40.7,11,10,56,5.6,0,4,90.9,5.1,1,45.5,64,249,305,305,0,RB
4394,Ricky Watters,278,63,341,2000,31,SEA,16,16,278,1242,4.5,7,77.6,60,42.8,92,63,613,9.7,2,38.3,68.5,6.7,28,42.4,341,1242,1855,1855,0,RB
4395,Tyrone Wheatley,232,20,252,2000,28,OAK,14,13,232,1046,4.5,9,74.7,52,45.7,34,20,156,7.8,1,11.1,58.8,4.6,7,38.2,252,1046,1202,1202,0,RB
4396,Jamel White,47,13,60,2000,23,CLE,13,0,47,145,3.1,0,11.2,6,31.9,19,13,100,7.7,0,7.7,68.4,5.3,3,36.8,60,145,245,1180,935,RB
4397,Michael Wiley,24,14,38,2000,22,DAL,10,0,24,88,3.7,0,8.8,5,37.5,18,14,72,5.1,1,7.2,77.8,4,3,38.9,38,88,160,463,303,RB
4398,Clarence Williams,0,1,1,2000,23,ARI,2,0,0,0,,0,0,0,,2,1,5,5,0,2.5,50,2.5,0,0,1,0,5,5,0,RB
4399,Jermaine Williams,2,0,2,2000,27,JAX,7,0,2,8,4,0,1.1,1,50,0,0,0,,0,0,,,0,,2,8,8,58,50,RB
4400,Moe Williams,23,4,27,2000,26,MIN,16,0,23,67,2.9,0,4.2,4,39.1,7,4,31,7.8,0,1.9,57.1,4.4,1,42.9,27,67,98,312,214,RB
4401,Nick Luchey,10,7,17,2000,23,CIN,14,4,10,54,5.4,0,3.9,4,60,19,7,84,12,0,6,36.8,4.4,4,26.3,17,54,138,150,12,FB
4402,Ricky Williams,248,44,292,2000,23,NOR,10,10,248,1000,4,8,100,56,44.4,55,44,409,9.3,1,40.9,80,7.4,19,60,292,1034,1409,1409,0,RB
4403,Jon Witman,3,5,8,2000,28,PIT,6,5,3,5,1.7,0,0.8,0,0,7,5,33,6.6,0,5.5,71.4,4.7,2,57.1,8,5,38,38,0,FB
4404,Amos Zereoue,6,0,6,2000,24,PIT,12,0,6,14,2.3,0,1.2,1,16.7,0,0,0,,0,0,,,0,,6,14,14,14,0,RB
4405,Karim Abdul-Jabbar,143,17,160,1999,25,"CLE,MIA",13,9,143,445,3.1,1,34.2,21,38.5,22,17,84,4.9,1,6.5,77.3,3.8,5,50,160,445,529,529,0,RB
4406,Rabih Abdullah,5,2,7,1999,24,TAM,15,1,5,12,2.4,0,0.8,1,20,3,2,11,5.5,0,0.7,66.7,3.7,0,0,7,12,23,23,0,RB
4407,James Allen,32,9,41,1999,24,CHI,12,3,32,119,3.7,0,9.9,7,43.8,11,9,91,10.1,0,7.6,81.8,8.3,4,63.6,41,119,210,210,0,RB
4408,Terry Allen,254,14,268,1999,31,NWE,16,13,254,896,3.5,8,56,45,39.4,19,14,125,8.9,1,7.8,73.7,6.6,6,42.1,268,896,1021,1021,0,RB
4409,Mike Alstott,242,27,269,1999,26,TAM,16,16,242,949,3.9,7,59.3,48,36.8,33,27,239,8.9,2,14.9,81.8,7.2,11,51.5,269,949,1188,1207,19,FB
4410,Jamal Anderson,19,2,21,1999,27,ATL,2,2,19,59,3.1,0,29.5,1,42.1,2,2,34,17,0,17,100,17,1,50,21,59,93,93,0,RB
4411,Kimble Anders,32,2,34,1999,33,KAN,2,2,32,181,5.7,0,90.5,7,50,5,2,14,7,0,7,40,2.8,1,40,34,181,195,195,0,RB
4412,Richie Anderson,16,29,45,1999,28,NYJ,16,9,16,84,5.3,0,5.3,4,37.5,36,29,302,10.4,3,18.9,80.6,8.4,14,55.6,45,84,386,386,0,FB
4413,John Avery,5,4,9,1999,23,"DEN,MIA",7,0,5,21,4.2,0,3,2,40,9,4,24,6,0,3.4,44.4,2.7,1,22.2,9,21,45,237,192,RB
4414,Obafemi Ayanbadejo,0,1,1,1999,24,"MIN,BAL",14,0,0,0,,0,0,0,,1,1,2,2,0,0.1,100,2,0,0,1,0,2,2,0,RB
4415,Tavian Banks,23,14,37,1999,25,JAX,8,1,23,82,3.6,0,10.3,3,30.4,14,14,137,9.8,0,17.1,100,9.8,6,64.3,37,82,219,297,78,RB
4416,Kantroy Barber,0,0,0,1999,26,MIA,2,0,0,0,,0,0,0,,0,0,0,,0,0,,,0,,0,0,0,0,0,RB
4417,Tiki Barber,62,66,128,1999,24,NYG,16,1,62,258,4.2,0,16.1,13,41.9,91,66,609,9.2,2,38.1,72.5,6.7,32,51.6,128,258,867,1639,772,RB
4418,Michael Basnight,62,16,78,1999,22,CIN,13,1,62,308,5,0,23.7,12,37.1,19,16,172,10.8,0,13.2,84.2,9.1,4,47.4,78,308,480,480,0,RB
4419,Mario Bates,72,5,77,1999,26,ARI,16,2,72,202,2.8,9,12.6,23,44.4,7,5,34,6.8,0,2.1,71.4,4.9,2,42.9,77,202,236,1467,1231,RB
4420,Michael Bates,3,1,4,1999,30,CAR,16,0,3,12,4,0,0.8,1,33.3,1,1,2,2,0,0.1,100,2,0,0,4,12,14,1301,1287,RB
4421,Fred Beasley,58,32,90,1999,25,SFO,13,11,58,276,4.8,4,21.2,18,51.7,51,32,282,8.8,0,21.7,62.7,5.5,16,47.1,90,276,558,558,0,FB
4422,Donnell Bennett,161,10,171,1999,27,KAN,15,1,161,627,3.9,8,41.8,40,41,12,10,41,4.1,0,2.7,83.3,3.4,2,33.3,171,627,668,719,51,RB
4423,Edgar Bennett,6,14,20,1999,30,CHI,16,2,6,28,4.7,0,1.8,1,16.7,21,14,116,8.3,0,7.3,66.7,5.5,5,38.1,20,28,144,197,53,RB
4424,Sean Bennett,29,4,33,1999,24,NYG,9,2,29,126,4.3,1,14,5,41.4,8,4,27,6.8,0,3,50,3.4,1,37.5,33,126,153,153,0,RB
4425,Jerome Bettis,299,21,320,1999,27,PIT,16,16,299,1091,3.6,7,68.2,64,46.2,28,21,110,5.2,0,6.9,75,3.9,2,39.3,320,1112,1201,1202,0,RB
4426,Tim Biakabutuka,138,23,161,1999,25,CAR,11,11,138,718,5.2,6,65.3,27,39.9,29,23,189,8.2,0,17.2,79.3,6.5,9,48.3,161,718,907,907,0,RB
4427,Eric Bieniemy,12,2,14,1999,30,PHI,16,0,12,75,6.3,1,4.7,4,50,2,2,28,14,0,1.8,100,14,1,50,14,75,103,313,210,RB
4428,James Bostic,5,5,10,1999,27,PHI,9,0,5,19,3.8,0,2.1,0,40,7,5,8,1.6,0,0.9,71.4,1.1,2,42.9,10,19,27,27,0,RB
4429,Larry Bowie,0,0,0,1999,26,WAS,2,0,0,0,,0,0,0,,0,0,0,,0,0,,,0,,0,0,0,0,0,RB
4430,Gary Brown,55,2,57,1999,30,NYG,3,2,55,177,3.2,0,59,12,34.5,2,2,2,1,0,0.7,100,1,0,0,57,177,179,179,0,RB
4431,Reggie Brown,14,34,48,1999,26,SEA,16,8,14,38,2.7,0,2.4,1,28.6,47,34,228,6.7,1,14.3,72.3,4.9,11,42.6,48,38,266,266,0,FB
4432,Kenny Bynum,92,16,108,1999,25,SDG,16,5,92,287,3.1,1,17.9,18,39.1,23,16,209,13.1,2,13.1,69.6,9.1,6,39.1,108,287,496,1277,781,RB
4433,Ki-Jana Carter,6,3,9,1999,26,CIN,3,0,6,15,2.5,1,5,1,50,6,3,24,8,0,8,50,4,1,50,9,15,39,39,0,RB
4434,Tony Carter,6,20,26,1999,27,NWE,16,14,6,26,4.3,0,1.6,2,83.3,31,20,108,5.4,0,6.8,64.5,3.5,4,38.7,26,26,134,134,0,FB
4435,Larry Centers,13,69,82,1999,31,WAS,16,12,13,51,3.9,0,3.2,3,53.8,90,69,544,7.9,3,34,76.7,6,31,50,82,51,595,595,0,FB
4436,Robert Chancey,14,0,14,1999,27,DAL,3,0,14,57,4.1,0,19,3,57.1,0,0,0,,0,0,,,0,,14,57,57,57,0,RB
4437,Bob Christian,38,40,78,1999,31,ATL,16,14,38,174,4.6,5,10.9,15,55.3,62,40,354,8.9,2,22.1,64.5,5.7,17,40.3,78,174,528,528,0,FB
4438,Mike Cloud,35,3,38,1999,24,KAN,11,0,35,128,3.7,0,11.6,7,45.7,3,3,25,8.3,0,2.3,100,8.3,1,100,38,128,153,181,28,RB
4439,Cecil Collins,131,6,137,1999,23,MIA,8,6,131,414,3.2,2,51.8,21,37.4,8,6,32,5.3,0,4,75,4,0,37.5,137,414,446,446,0,RB
4440,Greg Comella,1,8,9,1999,24,NYG,16,3,1,0,0,0,0,0,0,10,8,39,4.9,0,2.4,80,3.9,2,30,9,0,39,70,31,FB
4441,Aaron Craver,17,19,36,1999,31,NOR,13,10,17,40,2.4,0,3.1,2,35.3,42,19,154,8.1,0,11.8,45.2,3.7,6,21.4,36,40,194,197,3,FB
4442,Zack Crockett,45,8,53,1999,27,OAK,13,1,45,91,2,4,7,17,53.3,12,8,56,7,1,4.3,66.7,4.7,2,33.3,53,91,147,147,0,FB
4443,Stephen Davis,290,23,313,1999,25,WAS,14,14,290,1405,4.8,17,100.4,88,57.9,28,23,111,4.8,0,7.9,82.1,4,5,39.3,313,1405,1516,1516,0,RB
4444,Terrell Davis,67,3,70,1999,27,DEN,4,4,67,211,3.1,2,52.8,11,37.3,3,3,26,8.7,0,6.5,100,8.7,2,100,70,211,237,237,0,RB
4445,Troy Davis,20,7,27,1999,24,NOR,16,2,20,32,1.6,0,2,2,25,15,7,53,7.6,0,3.3,46.7,3.5,4,13.3,27,32,85,509,424,RB
4446,Autry Denson,28,4,32,1999,23,MIA,6,1,28,98,3.5,0,16.3,6,32.1,6,4,28,7,0,4.7,66.7,4.7,1,50,32,98,126,126,0,RB
4447,Corey Dillon,263,31,294,1999,25,CIN,15,15,263,1200,4.6,5,80,64,43,49,31,290,9.4,1,19.3,63.3,5.9,13,42.9,294,1200,1490,1494,4,RB
4448,Warrick Dunn,195,64,259,1999,24,TAM,15,15,195,616,3.2,0,41.1,31,31.3,82,64,589,9.2,2,39.3,78,7.2,29,50,259,616,1205,1361,156,RB
4449,Marc Edwards,6,27,33,1999,25,CLE,16,14,6,35,5.8,0,2.2,1,33.3,40,27,212,7.9,2,13.3,67.5,5.3,8,40,33,35,247,247,0,FB
4450,Keith Elias,13,4,17,1999,27,IND,14,0,13,28,2.2,0,2,1,23.1,5,4,16,4,0,1.1,80,3.2,0,20,17,28,44,126,82,RB
4451,Jerry Ellison,2,4,6,1999,28,NWE,12,0,2,10,5,0,0.8,1,100,4,4,50,12.5,0,4.2,100,12.5,2,100,6,10,60,73,13,RB
4452,Curtis Enis,287,45,332,1999,23,CHI,15,12,287,916,3.2,3,61.1,58,43.2,68,45,340,7.6,2,22.7,66.2,5,15,33.8,332,916,1256,1256,0,RB
4453,Charles Evans,38,32,70,1999,32,BAL,16,10,38,134,3.5,0,8.4,8,36.8,47,32,235,7.3,1,14.7,68.1,5,12,44.7,70,134,369,369,0,FB
4454,Robert Farmer,0,0,0,1999,25,NYJ,13,0,0,0,,0,0,0,,0,0,0,,0,0,,,0,,0,0,0,84,84,RB
4455,Kevin Faulk,67,12,79,1999,23,NWE,11,2,67,227,3.4,1,20.6,7,34.3,19,12,98,8.2,1,8.9,63.2,5.2,3,36.8,79,227,325,1349,1033,RB
4456,Marshall Faulk,253,87,340,1999,26,STL,16,16,253,1381,5.5,7,86.3,70,48.2,103,87,1048,12,5,65.5,84.5,10.2,40,58.3,340,1381,2429,2429,0,RB
4457,Jermaine Fazande,91,0,91,1999,24,SDG,7,3,91,365,4,2,52.1,20,46.2,0,0,0,,0,0,,,0,,91,365,365,365,0,RB
4458,Terrell Fletcher,48,45,93,1999,26,SDG,15,2,48,126,2.6,0,8.4,5,33.3,65,45,360,8,0,24,69.2,5.5,18,38.5,93,126,486,598,112,RB
4459,Chris Floyd,6,2,8,1999,24,NWE,13,0,6,12,2,0,0.9,0,16.7,5,2,16,8,0,1.2,40,3.2,1,20,8,12,28,28,0,RB
4460,William Floyd,35,21,56,1999,27,CAR,16,16,35,78,2.2,3,4.9,7,37.1,32,21,179,8.5,0,11.2,65.6,5.6,8,46.9,56,78,257,257,0,FB
4461,Chris Fuamatu-Ma'afala,1,0,1,1999,22,PIT,10,0,1,4,4,0,0.4,0,0,0,0,0,,0,0,,,0,,1,4,4,13,9,RB
4462,Charlie Garner,241,56,297,1999,27,SFO,16,15,241,1229,5.1,4,76.8,54,43.6,76,56,535,9.6,2,33.4,73.7,7,23,55.3,297,1221,1764,1764,0,RB
4463,Olandis Gary,276,21,297,1999,24,DEN,12,12,276,1159,4.2,7,96.6,61,42.4,29,21,159,7.6,0,13.3,72.4,5.5,5,55.2,297,1159,1318,1318,0,RB
4464,Sam Gash,0,20,20,1999,30,BUF,15,11,0,0,,0,0,0,,27,20,163,8.2,2,10.9,74.1,6,10,70.4,20,0,163,176,13,FB
4465,Eddie George,320,47,367,1999,26,TEN,16,16,320,1304,4.1,9,81.5,71,44.7,65,47,458,9.7,4,28.6,72.3,7,20,50.8,367,1304,1762,1762,0,RB
4466,Spencer George,0,0,0,1999,26,TEN,8,0,0,0,,0,0,0,,0,0,0,,0,0,,,0,,0,0,0,81,81,RB
4467,Lennox Gordon,11,0,11,1999,21,BUF,8,0,11,38,3.5,0,4.8,2,9.1,0,0,0,,0,0,,,0,,11,38,38,49,11,RB
4468,Jay Graham,0,0,0,1999,24,BAL,4,0,0,0,,0,0,0,,0,0,0,,0,0,,,0,,0,0,0,0,0,RB
4469,Ahman Green,26,0,26,1999,22,SEA,14,0,26,120,4.6,0,8.6,12,53.8,2,0,0,,0,0,0,0,0,0,26,120,120,938,818,RB
4470,Scott Greene,0,1,1,1999,27,IND,5,0,0,0,,0,0,0,,1,1,4,4,0,0.8,100,4,0,0,1,0,4,18,14,RB
4471,Howard Griffith,17,26,43,1999,32,DEN,16,16,17,66,3.9,1,4.1,6,64.7,39,26,192,7.4,1,12,66.7,4.9,13,48.7,43,66,258,258,0,FB
4472,Clif Groce,8,25,33,1999,27,CIN,16,15,8,22,2.8,1,1.4,2,50,40,25,154,6.2,0,9.6,62.5,3.9,6,40,33,22,176,176,0,FB
4473,Ty Hallock,0,6,6,1999,28,CHI,15,4,0,0,,0,0,0,,8,6,22,3.7,0,1.5,75,2.8,1,25,6,0,22,32,10,FB
4474,Byron Hanspard,136,10,146,1999,23,ATL,12,4,136,383,2.8,1,31.9,20,38.2,18,10,93,9.3,0,7.8,55.6,5.2,4,33.3,146,383,476,476,0,RB
4475,Derrick Harris,0,0,0,1999,27,STL,1,0,0,0,,0,0,0,,0,0,0,,0,0,,,0,,0,0,0,0,0,RB
4476,William Henderson,7,30,37,1999,28,GNB,16,13,7,29,4.1,2,1.8,2,57.1,39,30,203,6.8,1,12.7,76.9,5.2,11,48.7,37,29,232,255,23,FB
4477,Chris Hetherington,2,0,2,1999,27,CAR,14,0,2,7,3.5,0,0.5,0,0,0,0,0,,0,0,,,0,,2,7,7,23,16,FB
4478,Skip Hicks,78,8,86,1999,25,WAS,10,2,78,257,3.3,3,25.7,14,41,10,8,72,9,0,7.2,80,7.2,4,60,86,257,329,329,0,RB
4479,Greg Hill,144,13,157,1999,27,DET,14,8,144,542,3.8,2,38.7,21,36.1,23,13,77,5.9,0,5.5,56.5,3.3,1,17.4,157,542,619,619,0,RB
4480,Madre Hill,0,0,0,1999,23,CLE,5,0,0,0,,0,0,0,,0,0,0,,0,0,,,0,,0,0,0,137,137,RB
4481,Leroy Hoard,138,17,155,1999,31,MIN,15,3,138,555,4,10,37,40,47.8,20,17,166,9.8,0,11.1,85,8.3,8,40,155,555,721,721,0,RB
4482,James Hodgins,7,6,13,1999,22,STL,15,0,7,10,1.4,1,0.7,2,57.1,6,6,35,5.8,0,2.3,100,5.8,1,66.7,13,10,45,49,4,FB
4483,Robert Holcombe,78,14,92,1999,24,STL,15,7,78,294,3.8,4,19.6,18,39.7,27,14,163,11.6,1,10.9,51.9,6,9,44.4,92,294,457,457,0,FB
4484,Darick Holmes,0,0,0,1999,28,IND,1,0,0,0,,0,0,0,,0,0,0,,0,0,,,0,,0,0,0,0,0,RB
4485,Priest Holmes,89,13,102,1999,26,BAL,9,4,89,506,5.7,1,56.2,20,52.8,17,13,104,8,1,11.6,76.5,6.1,6,47.1,102,506,610,610,0,RB
4486,Chris Howard,13,1,14,1999,24,JAX,12,0,13,55,4.2,0,4.6,3,46.2,3,1,8,8,0,0.7,33.3,2.7,0,33.3,14,55,63,63,0,RB
4487,Richard Huntley,93,27,120,1999,27,PIT,16,2,93,567,6.1,5,35.4,29,55.9,39,27,253,9.4,3,15.8,69.2,6.5,14,41,120,567,820,1156,336,RB
4488,Sedrick Irvin,36,25,61,1999,21,DET,14,0,36,133,3.7,4,9.5,10,50,32,25,233,9.3,0,16.6,78.1,7.3,11,43.8,61,133,366,402,36,RB
4489,Terry Jackson,15,3,18,1999,23,SFO,16,0,15,75,5,0,4.7,3,53.3,3,3,6,2,0,0.4,100,2,1,33.3,18,75,81,81,0,FB
4490,Edgerrin James,369,62,431,1999,21,IND,16,16,369,1553,4.2,13,97.1,86,42.3,82,62,586,9.5,4,36.6,75.6,7.1,23,45.1,431,1553,2139,2139,0,RB
4491,Travis Jervey,6,1,7,1999,27,SFO,8,0,6,49,8.2,1,6.1,2,50,1,1,2,2,0,0.3,100,2,0,0,7,49,51,242,191,RB
4492,Anthony Johnson,25,13,38,1999,32,CAR,16,0,25,72,2.9,0,4.5,6,40,19,13,103,7.9,0,6.4,68.4,5.4,4,31.6,38,72,175,187,12,RB
4493,Daryl Johnston,0,1,1,1999,33,DAL,1,0,0,0,,0,0,0,,2,1,4,4,0,4,50,2,0,0,1,0,4,4,0,RB
4494,Dustin Johnson,0,0,0,1999,26,SEA,1,0,0,0,,0,0,0,,0,0,0,,0,0,,,0,,0,0,0,0,0,FB
4495,J.J. Johnson,164,15,179,1999,25,MIA,13,4,164,558,3.4,4,42.9,26,40.2,23,15,100,6.7,0,7.7,65.2,4.3,2,21.7,179,558,658,684,26,RB
4496,Leon Johnson,1,0,1,1999,25,NYJ,1,0,1,2,2,0,2,1,100,0,0,0,,0,0,,,0,,1,2,2,39,37,RB
4497,LeShon Johnson,61,12,73,1999,28,NYG,16,4,61,143,2.3,2,8.9,9,36.1,15,12,86,7.2,1,5.4,80,5.7,4,46.7,73,143,229,229,0,RB
4498,George Jones,8,0,8,1999,25,CLE,6,0,8,15,1.9,0,2.5,0,0,0,0,0,,0,0,,,0,,8,15,15,27,12,RB
4499,Randy Jordan,9,8,17,1999,29,OAK,16,0,9,32,3.6,2,2,5,66.7,16,8,82,10.3,0,5.1,50,5.1,3,25,17,32,114,321,207,RB
4500,Napoleon Kaufman,138,18,156,1999,26,OAK,16,5,138,714,5.2,2,44.6,33,44.9,25,18,181,10.1,1,11.3,72,7.2,7,36,156,714,895,1726,831,RB
4501,Terry Kirby,130,58,188,1999,29,CLE,16,10,130,452,3.5,6,28.3,26,42.3,77,58,528,9.1,3,33,75.3,6.9,19,39,188,454,980,1210,230,RB
4502,Jim Kleinsasser,0,6,6,1999,22,MIN,13,7,0,0,,0,0,0,,12,6,13,2.2,0,1,50,1.1,2,33.3,6,0,13,13,0,FB
4503,Rob Konrad,9,34,43,1999,23,MIA,15,9,9,16,1.8,0,1.1,4,44.4,66,34,251,7.4,1,16.7,51.5,3.8,14,39.4,43,16,267,267,0,FB
4504,Fred Lane,115,23,138,1999,24,CAR,15,5,115,475,4.1,1,31.7,29,51.3,30,23,163,7.1,0,10.9,76.7,5.4,5,40,138,475,638,696,58,RB
4505,Amp Lee,3,3,6,1999,28,STL,7,0,3,3,1,0,0.4,0,66.7,4,3,22,7.3,1,3.1,75,5.5,1,50,6,3,25,25,0,RB
4506,Tim Lester,0,2,2,1999,31,DAL,5,1,0,0,,0,0,0,,4,2,9,4.5,0,1.8,50,2.3,0,0,2,0,9,9,0,RB
4507,Dorsey Levens,279,71,350,1999,29,GNB,14,14,279,1034,3.7,9,73.9,58,43,81,71,573,8.1,1,40.9,87.7,7.1,28,54.3,350,1034,1607,1607,0,RB
4508,Jonathan Linton,205,29,234,1999,25,BUF,16,2,205,695,3.4,5,43.4,44,42.4,37,29,228,7.9,1,14.3,78.4,6.2,8,48.6,234,695,923,923,0,RB
4509,Derek Loville,40,11,51,1999,31,DEN,10,0,40,203,5.1,1,20.3,9,42.5,16,11,50,4.5,0,5,68.8,3.1,4,37.5,51,203,253,263,22,RB
4510,Anthony Lynn,2,0,2,1999,31,DEN,16,0,2,2,1,0,0.1,0,0,0,0,0,,0,0,,,0,,2,2,2,2,0,RB
4511,Stacey Mack,7,0,7,1999,24,JAX,12,0,7,40,5.7,0,3.3,2,28.6,0,0,0,,0,0,,,0,,7,40,40,152,112,RB
4512,Joel Makovicka,8,10,18,1999,24,ARI,16,10,8,7,0.9,0,0.4,0,12.5,19,10,70,7,1,4.4,52.6,3.7,4,31.6,18,7,77,87,10,FB
4513,Cecil Martin,3,11,14,1999,24,PHI,12,5,3,3,1,0,0.3,1,33.3,16,11,22,2,0,1.8,68.8,1.4,1,12.5,14,3,25,25,0,FB
4514,Curtis Martin,367,45,412,1999,26,NYJ,16,16,367,1464,4,5,91.5,87,44.7,49,45,259,5.8,0,16.2,91.8,5.3,9,44.9,412,1464,1723,1723,0,RB
4515,Fred McAfee,0,0,0,1999,31,TAM,1,0,0,0,,0,0,0,,0,0,0,,0,0,,,0,,0,0,0,0,0,RB
4516,Fred McCrary,0,37,37,1999,27,SDG,16,14,0,0,,0,0,0,,50,37,201,5.4,1,12.6,74,4,7,42,37,0,201,205,4,FB
4517,Dennis McKinley,0,1,1,1999,23,ARI,16,0,0,0,,0,0,0,,2,1,4,4,0,0.3,50,2,0,0,1,0,4,4,0,FB
4518,Kevin McLeod,0,2,2,1999,25,TAM,7,0,0,0,,0,0,0,,3,2,5,2.5,1,0.7,66.7,1.7,1,33.3,2,0,5,5,0,FB
4519,Natrone Means,112,9,121,1999,27,SDG,7,5,112,277,2.5,4,39.6,16,33.9,13,9,51,5.7,1,7.3,69.2,3.9,2,38.5,121,277,328,328,0,RB
4520,Glyn Milburn,16,20,36,1999,28,CHI,16,1,16,102,6.4,1,6.4,5,37.5,30,20,151,7.6,0,9.4,66.7,5,7,43.3,36,102,253,2025,1772,RB
4521,Brian Milne,3,0,3,1999,26,"CIN,SEA",11,1,3,30,10,0,2.7,1,33.3,0,0,0,,0,0,,,0,,3,30,30,30,0,RB
4522,Basil Mitchell,29,6,35,1999,24,GNB,16,2,29,117,4,0,7.3,7,55.2,9,6,48,8,0,3,66.7,5.3,1,44.4,35,117,165,629,464,RB
4523,Brian Mitchell,40,31,71,1999,31,WAS,16,0,40,220,5.5,1,13.8,12,50,40,31,305,9.8,0,19.1,77.5,7.6,12,42.5,71,220,525,1755,1225,RB
4524,Joe Montgomery,115,0,115,1999,23,NYG,7,5,115,348,3,3,49.7,22,38.3,1,0,0,,0,0,0,0,0,0,115,348,348,348,0,RB
4525,Bam Morris,120,7,127,1999,27,KAN,12,8,120,414,3.5,3,34.5,16,35,11,7,37,5.3,0,3.1,63.6,3.4,0,27.3,127,414,451,451,0,RB
4526,Harold Morrow,2,0,2,1999,26,MIN,16,0,2,1,0.5,0,0.1,0,0,0,0,0,,0,0,,,0,,2,1,1,21,20,FB
4527,Adrian Murrell,193,49,242,1999,29,ARI,16,12,193,553,2.9,0,34.6,27,32.1,71,49,335,6.8,0,20.9,69,4.7,13,40.8,242,553,888,888,0,RB
4528,Lorenzo Neal,2,7,9,1999,29,TEN,16,14,2,1,0.5,1,0.1,1,50,11,7,27,3.9,2,1.7,63.6,2.5,3,36.4,9,1,28,43,15,FB
4529,Brock Olivo,1,4,5,1999,23,DET,14,0,1,1,1,0,0.1,1,100,8,4,24,6,0,1.7,50,3,1,12.5,5,1,25,223,198,RB
4530,Winslow Oliver,8,8,16,1999,26,ATL,14,0,8,32,4,0,2.3,1,12.5,13,8,74,9.3,0,5.3,61.5,5.7,5,38.5,16,32,106,699,593,RB
4531,Ken Oxendine,141,17,158,1999,24,ATL,12,9,141,452,3.2,1,37.7,25,48.9,22,17,172,10.1,1,14.3,77.3,7.8,8,50,158,452,624,624,0,RB
4532,De'Mond Parker,36,4,40,1999,23,GNB,11,0,36,184,5.1,2,16.7,11,44.4,5,4,15,3.8,0,1.4,80,3,0,0,40,184,199,467,268,RB
4533,Bernie Parmalee,27,15,42,1999,32,NYJ,16,0,27,133,4.9,0,8.3,7,40.7,15,15,113,7.5,0,7.1,100,7.5,6,60,42,133,246,246,0,RB
4534,Jeff Paulk,0,0,0,1999,23,ATL,1,0,0,0,,0,0,0,,0,0,0,,0,0,,,0,,0,0,0,0,0,FB
4535,Wilmont Perry,48,4,52,1999,24,NOR,7,3,48,180,3.8,0,25.7,8,39.6,9,4,26,6.5,0,3.7,44.4,2.9,1,33.3,52,180,206,212,6,RB
4536,Dino Philyaw,4,2,6,1999,29,NOR,13,0,4,16,4,0,1.2,1,25,5,2,23,11.5,0,1.8,40,4.6,1,40,6,16,39,1204,1165,RB
4537,Lawrence Phillips,30,15,45,1999,24,SFO,8,0,30,144,4.8,2,18,8,46.7,20,15,152,10.1,0,19,75,7.6,5,45,45,144,296,711,415,RB
4538,Michael Pittman,64,16,80,1999,24,ARI,10,2,64,289,4.5,2,28.9,12,37.5,27,16,196,12.3,0,19.6,59.3,7.3,8,44.4,80,315,485,532,47,RB
4539,Marvin Powell,1,0,1,1999,23,NOR,9,0,1,1,1,0,0.1,0,0,1,0,0,,0,0,0,0,0,0,1,1,1,1,0,FB
4540,Stanley Pritchett,47,43,90,1999,26,MIA,14,7,47,158,3.4,1,11.3,11,36.2,58,43,312,7.3,4,22.3,74.1,5.4,19,43.1,90,158,470,470,0,FB
4541,Travis Reece,0,0,0,1999,24,DET,4,0,0,0,,0,0,0,,0,0,0,,0,0,,,0,,0,0,0,0,0,RB
4542,Errict Rhett,236,24,260,1999,29,BAL,16,10,236,852,3.6,5,53.3,40,43.6,32,24,169,7,2,10.6,75,5.3,7,50,260,852,1021,1021,0,RB
4543,Tony Richardson,84,24,108,1999,28,KAN,16,16,84,387,4.6,1,24.2,28,50,28,24,141,5.9,0,8.8,85.7,5,4,42.9,108,387,528,528,0,FB
4544,Jon Ritchie,5,45,50,1999,25,OAK,16,14,5,12,2.4,0,0.8,4,80,61,45,408,9.1,1,25.5,73.8,6.7,23,54.1,50,12,420,420,0,FB
4545,Ron Rivers,82,22,104,1999,28,DET,7,6,82,295,3.6,0,42.1,16,40.2,24,22,173,7.9,1,24.7,91.7,7.2,8,58.3,104,295,468,468,0,RB
4546,Charlie Rogers,0,0,0,1999,23,SEA,12,0,0,0,,0,0,0,,0,0,0,,0,0,,,0,,0,0,0,783,783,RB
4547,Rashaan Salaam,1,0,1,1999,25,CLE,2,0,1,2,2,0,1,0,0,0,0,0,,0,0,,,0,,1,2,2,2,0,RB
4548,Cory Schlesinger,43,21,64,1999,27,DET,16,11,43,124,2.9,0,7.8,10,32.6,34,21,151,7.2,1,9.4,61.8,4.4,6,35.3,64,124,275,308,33,FB
4549,Mike Sellers,0,7,7,1999,24,WAS,16,2,0,0,,0,0,0,,12,7,105,15,2,6.6,58.3,8.8,4,50,7,0,105,137,32,FB
4550,Harold Shaw,9,2,11,1999,25,NWE,8,0,9,23,2.6,0,2.9,2,33.3,3,2,31,15.5,0,3.9,66.7,10.3,1,33.3,11,23,54,54,0,RB
4551,Sedrick Shaw,7,3,10,1999,26,"CIN,CLE",4,0,7,22,3.1,1,5.5,3,42.9,3,3,4,1.3,0,1,100,1.3,0,33.3,10,22,26,26,0,RB
4552,Rashaan Shehee,65,18,83,1999,24,KAN,9,5,65,238,3.7,1,26.4,12,30.8,19,18,136,7.6,0,15.1,94.7,7.2,5,47.4,83,238,374,374,0,RB
4553,Daimon Shelton,1,12,13,1999,27,JAX,16,9,1,2,2,0,0.1,0,0,13,12,87,7.3,0,5.4,92.3,6.7,4,69.2,13,2,89,89,0,FB
4554,Paul Shields,0,4,4,1999,23,IND,13,3,0,0,,0,0,0,,7,4,37,9.3,0,2.8,57.1,5.3,2,28.6,4,0,37,40,3,RB
4555,Antowain Smith,165,2,167,1999,27,BUF,14,11,165,614,3.7,6,43.9,28,38.2,2,2,32,16,0,2.3,100,16,2,100,167,614,646,646,0,RB
4556,Detron Smith,1,4,5,1999,25,DEN,16,0,1,7,7,0,0.4,0,100,5,4,23,5.8,0,1.4,80,4.6,2,60,5,7,30,42,12,RB
4557,Emmitt Smith,329,27,356,1999,30,DAL,15,15,329,1397,4.2,11,93.1,86,48.6,32,27,119,4.4,2,7.9,84.4,3.7,4,40.6,356,1397,1516,1516,0,RB
4558,Lamar Smith,60,20,80,1999,29,NOR,13,2,60,205,3.4,0,15.8,13,45,30,20,151,7.6,1,11.6,66.7,5,9,36.7,80,205,356,356,0,RB
4559,Robert Smith,221,24,245,1999,27,MIN,13,12,221,1015,4.6,2,78.1,41,47.1,30,24,166,6.9,0,12.8,80,5.5,6,33.3,245,1015,1181,1181,0,RB
4560,Matt Snider,0,0,0,1999,23,GNB,8,0,0,0,,0,0,0,,0,0,0,,0,0,,,0,,0,0,0,0,0,FB
4561,Jerald Sowell,3,0,3,1999,25,NYJ,16,0,3,5,1.7,0,0.3,1,33.3,0,0,0,,0,0,,,0,,3,5,5,5,0,FB
4562,Duce Staley,325,41,366,1999,24,PHI,16,16,325,1273,3.9,4,79.6,50,38.8,66,41,294,7.2,2,18.4,62.1,4.5,19,37.9,366,1265,1567,1567,0,RB
4563,Tremayne Stephens,24,18,42,1999,23,SDG,11,2,24,61,2.5,3,5.5,6,54.2,23,18,133,7.4,1,12.1,78.3,5.8,6,43.5,42,61,194,529,335,RB
4564,James Stewart,249,21,270,1999,28,JAX,14,7,249,931,3.7,13,66.5,55,46.2,24,21,108,5.1,0,7.7,87.5,4.5,4,29.2,270,931,1039,1039,0,RB
4565,Mack Strong,1,1,2,1999,28,SEA,14,1,1,0,0,0,0,0,0,3,1,5,5,0,0.4,33.3,1.7,0,0,2,0,5,5,0,FB
4566,Fred Taylor,159,10,169,1999,23,JAX,10,9,159,732,4.6,6,73.2,40,41.5,15,10,83,8.3,0,8.3,66.7,5.5,4,40,169,732,815,815,0,RB
4567,Rodney Thomas,43,9,52,1999,26,TEN,16,0,43,164,3.8,1,10.3,9,44.2,11,9,72,8,0,4.5,81.8,6.5,4,54.5,52,164,236,236,0,RB
4568,Robert Thomas,8,10,18,1999,25,DAL,16,7,8,35,4.4,0,2.2,3,50,20,10,64,6.4,0,4,50,3.2,2,20,18,35,99,99,0,FB
4569,Thurman Thomas,36,3,39,1999,33,BUF,5,3,36,152,4.2,0,30.4,10,52.8,5,3,37,12.3,1,7.4,60,7.4,2,40,39,152,189,189,0,RB
4570,Kevin Turner,6,9,15,1999,30,PHI,8,7,6,15,2.5,0,1.9,1,33.3,14,9,46,5.1,0,5.8,64.3,3.3,3,28.6,15,15,61,61,0,FB
4571,Tommy Vardell,6,7,13,1999,30,SFO,6,4,6,6,1,1,1,2,50,11,7,36,5.1,0,6,63.6,3.3,1,27.3,13,6,42,42,0,RB
4572,Tony Vinson,0,0,0,1999,28,BAL,3,0,0,0,,0,0,0,,0,0,0,,0,0,,,0,,0,0,0,0,0,RB
4573,Chris Warren,99,34,133,1999,31,DAL,16,1,99,403,4.1,2,25.2,27,39.4,45,34,224,6.6,0,14,75.6,5,10,33.3,133,403,627,627,0,RB
4574,Lamont Warren,35,29,64,1999,26,NWE,16,2,35,120,3.4,0,7.5,5,37.1,48,29,262,9,1,16.4,60.4,5.5,15,39.6,64,113,382,407,25,RB
4575,Eddie Watson,4,0,4,1999,23,PHI,6,0,4,17,4.3,0,2.8,0,0,0,0,0,,0,0,,,0,,4,17,17,17,0,RB
4576,Justin Watson,47,0,47,1999,24,STL,8,0,47,179,3.8,0,22.4,9,29.8,5,0,0,,0,0,0,0,0,0,47,179,179,179,0,RB
4577,Ricky Watters,325,40,365,1999,30,SEA,16,16,325,1210,3.7,5,75.6,51,38.8,62,40,387,9.7,2,24.2,64.5,6.2,17,48.4,365,1210,1597,1597,0,RB
4578,Charles Way,49,11,60,1999,27,NYG,11,8,49,141,2.9,2,12.8,10,40.8,21,11,59,5.4,0,5.4,52.4,2.8,2,28.6,60,141,200,200,0,FB
4579,Tyrone Wheatley,242,21,263,1999,27,OAK,16,9,242,936,3.9,8,58.5,43,45,38,21,196,9.3,3,12.3,55.3,5.2,7,31.6,263,936,1132,1132,0,RB
4580,Jermaine Williams,0,1,1,1999,26,OAK,15,0,0,0,,0,0,0,,2,1,20,20,0,1.3,50,10,0,0,1,0,20,20,0,RB
4581,Moe Williams,24,1,25,1999,25,MIN,14,0,24,69,2.9,1,4.9,6,41.7,3,1,12,12,0,0.9,33.3,4,1,33.3,25,69,81,321,240,RB
4582,Nick Luchey,10,10,20,1999,22,CIN,11,0,10,30,3,0,2.7,2,40,12,10,96,9.6,0,8.7,83.3,8,5,66.7,20,30,126,235,109,FB
4583,Ricky Williams,253,28,281,1999,22,NOR,12,12,253,884,3.5,2,73.7,51,41.9,40,28,172,6.1,0,14.3,70,4.3,8,30,281,884,1056,1056,0,RB
4584,Sherman Williams,0,0,0,1999,26,DAL,1,0,0,0,,0,0,0,,0,0,0,,0,0,,,0,,0,0,0,0,0,RB
4585,Jon Witman,6,12,18,1999,27,PIT,16,11,6,18,3,0,1.1,1,50,22,12,106,8.8,0,6.6,54.5,4.8,2,27.3,18,18,124,124,0,FB
4586,Amos Zereoue,18,2,20,1999,23,PIT,8,0,18,48,2.7,0,6,4,44.4,2,2,17,8.5,0,2.1,100,8.5,1,50,20,48,65,234,169,RB
4587,Karim Abdul-Jabbar,270,21,291,1998,24,MIA,15,15,270,960,3.6,6,64,48,37.4,31,21,102,4.9,0,6.8,67.7,3.3,3,35.5,291,960,1062,1062,0,RB
4588,James Allen,58,8,66,1998,23,CHI,6,2,58,270,4.7,1,45,7,39.7,14,8,77,9.6,1,12.8,57.1,5.5,3,28.6,66,270,347,347,0,RB
4589,Terry Allen,148,17,165,1998,30,WAS,10,10,148,700,4.7,2,70,28,52,22,17,128,7.5,0,12.8,77.3,5.8,6,45.5,165,700,828,828,0,RB
4590,Mike Alstott,215,22,237,1998,25,TAM,16,16,215,846,3.9,8,52.9,49,47.9,30,22,152,6.9,1,9.5,73.3,5.1,7,36.7,237,846,998,1006,8,FB
4591,Jamal Anderson,410,27,437,1998,26,ATL,16,16,410,1846,4.5,14,115.4,94,48.5,46,27,319,11.8,2,19.9,58.7,6.9,13,45.7,437,1846,2165,2165,0,RB
4592,Kimble Anders,58,64,122,1998,32,KAN,16,15,58,230,4,1,14.4,15,41.4,84,64,462,7.2,2,28.9,76.2,5.5,18,39.3,122,230,692,708,16,FB
4593,Richie Anderson,1,3,4,1998,27,NYJ,8,1,1,2,2,0,0.3,0,0,5,3,12,4,0,1.5,60,2.4,1,40,4,2,14,14,0,FB
4594,Mike Archie,6,5,11,1998,26,TEN,16,0,6,24,4,1,1.5,3,50,5,5,25,5,0,1.6,100,5,0,0,11,42,49,1014,965,RB
4595,John Avery,143,10,153,1998,22,MIA,16,0,143,503,3.5,2,31.4,24,42,15,10,67,6.7,1,4.2,66.7,4.5,2,53.3,153,503,570,1655,1085,RB
4596,Obafemi Ayanbadejo,0,0,0,1998,23,MIN,1,0,0,0,,0,0,0,,0,0,0,,0,0,,,0,,0,0,0,0,0,RB
4597,Tavian Banks,26,4,30,1998,24,JAX,6,1,26,140,5.4,1,23.3,4,42.3,4,4,20,5,0,3.3,100,5,0,75,30,140,160,293,133,RB
4598,Tiki Barber,52,42,94,1998,23,NYG,16,4,52,166,3.2,0,10.4,8,36.5,59,42,348,8.3,3,21.8,71.2,5.9,13,37.3,94,166,514,764,250,RB
4599,Mario Bates,60,1,61,1998,25,ARI,16,1,60,165,2.8,6,10.3,16,51.7,1,1,14,14,0,0.9,100,14,1,100,61,165,179,179,0,RB
4600,Michael Bates,0,0,0,1998,29,CAR,14,0,0,0,,0,0,0,,0,0,0,,0,0,,,0,,0,0,0,1480,1480,RB
4601,Fred Beasley,0,1,1,1998,24,SFO,16,0,0,0,,0,0,0,,1,1,11,11,0,0.7,100,11,1,100,1,0,11,11,0,FB
4602,Brandon Bennett,77,8,85,1998,25,CIN,14,1,77,243,3.2,2,17.4,15,40.3,12,8,153,19.1,0,10.9,66.7,12.8,5,50,85,243,396,457,61,RB
4603,Donnell Bennett,148,16,164,1998,26,KAN,16,10,148,527,3.6,5,32.9,30,44.6,20,16,91,5.7,1,5.7,80,4.6,6,45,164,527,618,618,0,RB
4604,Edgar Bennett,173,28,201,1998,29,CHI,16,13,173,611,3.5,2,38.2,28,38.2,44,28,209,7.5,0,13.1,63.6,4.8,7,36.4,201,629,820,820,0,RB
4605,Jerome Bettis,316,16,332,1998,26,PIT,15,15,316,1185,3.8,3,79,61,42.1,23,16,90,5.6,0,6,69.6,3.9,2,43.5,332,1185,1275,1275,0,RB
4606,Tim Biakabutuka,101,8,109,1998,24,CAR,10,3,101,427,4.2,3,42.7,20,48.5,10,8,138,17.3,1,13.8,80,13.8,5,60,109,427,565,565,0,RB
4607,Eric Bieniemy,17,27,44,1998,29,CIN,16,0,17,56,3.3,0,3.5,5,41.2,35,27,153,5.7,0,9.6,77.1,4.4,6,42.9,44,56,209,296,87,RB
4608,Michael Blair,3,3,6,1998,24,"CIN,GNB",13,0,3,7,2.3,0,0.5,0,33.3,3,3,20,6.7,0,1.5,100,6.7,2,66.7,6,7,27,27,0,RB
4609,James Bostic,0,0,0,1998,26,PHI,2,0,0,0,,0,0,0,,0,0,0,,0,0,,,0,,0,0,0,0,0,RB
4610,Larry Bowie,4,7,11,1998,25,WAS,5,4,4,8,2,0,1.6,0,50,10,7,53,7.6,1,10.6,70,5.3,5,60,11,8,61,61,0,RB
4611,Steve Broussard,5,4,9,1998,31,SEA,15,0,5,4,0.8,0,0.3,0,0,7,4,21,5.3,0,1.4,57.1,3,1,14.3,9,4,25,806,781,RB
4612,Gary Brown,247,13,260,1998,29,NYG,16,11,247,1063,4.3,5,66.4,54,48.2,26,13,36,2.8,0,2.3,50,1.4,1,11.5,260,1063,1099,1099,0,RB
4613,Reggie Brown,1,0,1,1998,25,SEA,15,1,1,2,2,0,0.1,0,0,0,0,0,,0,0,,,0,,1,2,2,46,44,RB
4614,Keith Byars,4,26,30,1998,35,NYJ,13,8,4,34,8.5,0,2.6,3,75,40,26,258,9.9,3,19.8,65,6.5,15,45,30,34,292,292,0,FB
4615,Kenny Bynum,11,4,15,1998,24,SDG,10,0,11,23,2.1,0,2.3,1,27.3,5,4,27,6.8,0,2.7,80,5.4,0,40,15,23,50,395,345,RB
4616,Ki-Jana Carter,2,6,8,1998,25,CIN,1,0,2,4,2,0,4,0,0,6,6,25,4.2,0,25,100,4.2,0,0,8,4,29,29,0,RB
4617,Tony Carter,2,18,20,1998,26,NWE,11,7,2,3,1.5,0,0.3,0,0,25,18,166,9.2,0,15.1,72,6.6,7,48,20,3,169,169,0,FB
4618,Larry Centers,31,69,100,1998,30,ARI,16,12,31,110,3.5,0,6.9,10,45.2,94,69,559,8.1,2,34.9,73.4,5.9,22,45.7,100,110,669,669,0,FB
4619,Robert Chancey,29,11,40,1998,26,CHI,16,1,29,122,4.2,2,7.6,10,62.1,15,11,102,9.3,0,6.4,73.3,6.8,6,66.7,40,122,224,242,18,RB
4620,Bob Christian,8,19,27,1998,30,ATL,14,11,8,21,2.6,2,1.5,4,75,28,19,214,11.3,1,15.3,67.9,7.6,12,57.1,27,21,235,235,0,FB
4621,Greg Comella,1,1,2,1998,23,NYG,16,0,1,6,6,0,0.4,0,0,4,1,3,3,0,0.2,25,0.8,0,0,2,6,9,21,12,FB
4622,Kenyon Cotton,2,0,2,1998,24,BAL,12,0,2,8,4,0,0.7,0,0,0,0,0,,0,0,,,0,,2,8,8,41,33,RB
4623,Aaron Craver,45,33,78,1998,30,NOR,16,10,45,180,4,2,11.3,11,51.1,47,33,214,6.5,2,13.4,70.2,4.6,9,38.3,78,180,394,606,212,FB
4624,Zack Crockett,2,2,4,1998,26,"IND,JAX",12,2,2,5,2.5,0,0.4,0,0,4,2,5,2.5,0,0.4,50,1.3,0,0,4,5,10,10,0,FB
4625,Derrick Cullors,18,14,32,1998,26,NWE,16,0,18,48,2.7,0,3,4,27.8,25,14,146,10.4,1,9.1,56,5.8,4,24,32,48,194,1279,1085,RB
4626,Stephen Davis,34,21,55,1998,24,WAS,16,12,34,109,3.2,0,6.8,6,41.2,31,21,263,12.5,2,16.4,67.7,8.5,13,51.6,55,109,372,372,0,FB
4627,Terrell Davis,392,25,417,1998,26,DEN,16,16,392,2008,5.1,21,125.5,101,50.3,38,25,217,8.7,2,13.6,65.8,5.7,12,47.4,417,2008,2225,2225,0,RB
4628,Troy Davis,55,16,71,1998,23,NOR,14,2,55,143,2.6,1,10.2,6,30.9,21,16,99,6.2,0,7.1,76.2,4.7,3,38.1,71,143,242,263,21,RB
4629,Corey Dillon,262,28,290,1998,24,CIN,15,15,262,1130,4.3,4,75.3,57,44.3,44,28,178,6.4,1,11.9,63.6,4,4,31.8,290,1130,1308,1308,0,RB
4630,Gary Downs,1,4,5,1998,26,ATL,16,1,1,4,4,0,0.3,0,0,6,4,31,7.8,0,1.9,66.7,5.2,1,50,5,4,35,35,0,RB
4631,Mike Dulaney,0,0,0,1998,28,CAR,8,0,0,0,,0,0,0,,0,0,0,,0,0,,,0,,0,0,0,0,0,RB
4632,Warrick Dunn,245,44,289,1998,23,TAM,16,14,245,1026,4.2,2,64.1,45,39.2,57,44,344,7.8,0,21.5,77.2,6,22,50.9,289,1026,1370,1395,25,RB
4633,Marc Edwards,22,22,44,1998,24,SFO,16,10,22,94,4.3,1,5.9,4,40.9,32,22,218,9.9,2,13.6,68.8,6.8,10,46.9,44,94,312,312,0,FB
4634,Robert Edwards,291,35,326,1998,24,NWE,16,15,291,1115,3.8,9,69.7,50,46,52,35,331,9.5,3,20.7,67.3,6.4,13,40.4,326,1115,1446,1446,0,RB
4635,Keith Elias,8,1,9,1998,26,IND,13,0,8,24,3,0,1.8,1,25,1,1,11,11,0,0.8,100,11,0,100,9,24,35,352,317,RB
4636,Jerry Ellison,9,0,9,1998,27,TAM,16,0,9,24,2.7,0,1.5,1,22.2,0,0,0,,0,0,,,0,,9,24,24,43,19,RB
4637,Curtis Enis,133,6,139,1998,22,CHI,9,1,133,497,3.7,0,55.2,21,39.8,8,6,20,3.3,0,2.2,75,2.5,0,50,139,497,517,517,0,RB
4638,Charles Evans,23,12,35,1998,31,MIN,16,8,23,67,2.9,1,4.2,5,34.8,13,12,84,7,0,5.3,92.3,6.5,1,61.5,35,67,151,151,0,FB
4639,Marshall Faulk,324,86,410,1998,25,IND,16,15,324,1319,4.1,6,82.4,62,43.2,106,86,908,10.6,4,56.8,81.1,8.6,44,58.5,410,1319,2227,2240,0,RB
4640,Terrell Fletcher,153,30,183,1998,25,SDG,12,5,153,543,3.5,5,45.3,36,44.4,43,30,188,6.3,0,15.7,69.8,4.4,10,39.5,183,566,731,823,71,RB
4641,Chris Floyd,6,1,7,1998,23,NWE,16,2,6,22,3.7,0,1.4,2,66.7,2,1,6,6,0,0.4,50,3,0,0,7,22,28,28,0,RB
4642,William Floyd,28,24,52,1998,26,CAR,16,13,28,71,2.5,3,4.4,7,46.4,37,24,123,5.1,1,7.7,64.9,3.3,6,32.4,52,71,194,216,22,FB
4643,Chris Fuamatu-Ma'afala,7,9,16,1998,21,PIT,12,0,7,30,4.3,2,2.5,2,42.9,12,9,84,9.3,1,7,75,7,3,25,16,30,114,114,0,RB
4644,Charlie Garner,96,19,115,1998,26,PHI,10,3,96,381,4,4,38.1,19,32.3,25,19,110,5.8,0,11,76,4.4,5,36,115,381,491,491,0,RB
4645,Sam Gash,11,19,30,1998,29,BUF,16,13,11,32,2.9,0,2,3,54.5,21,19,165,8.7,3,10.3,90.5,7.9,12,76.2,30,32,197,238,41,FB
4646,Eddie George,348,37,385,1998,25,TEN,16,16,348,1294,3.7,5,80.9,75,39.7,49,37,310,8.4,1,19.4,75.5,6.3,17,49,385,1294,1604,1604,0,RB
4647,Spencer George,0,0,0,1998,25,TEN,5,0,0,0,,0,0,0,,0,0,0,,0,0,,,0,,0,0,0,0,0,RB
4648,Jay Graham,35,5,40,1998,23,BAL,5,1,35,109,3.1,0,21.8,3,34.3,10,5,41,8.2,0,8.2,50,4.1,1,30,40,109,150,202,52,RB
4649,Ahman Green,35,3,38,1998,21,SEA,16,0,35,209,6,1,13.1,8,40,5,3,2,0.7,0,0.1,60,0.4,0,0,38,209,211,831,620,RB
4650,Harold Green,20,2,22,1998,30,ATL,6,0,20,37,1.9,0,6.2,1,15,2,2,34,17,0,5.7,100,17,1,50,22,37,71,95,24,RB
4651,Scott Greene,0,1,1,1998,26,IND,5,0,0,0,,0,0,0,,1,1,2,2,0,0.4,100,2,0,0,1,0,2,2,0,RB
4652,Howard Griffith,4,15,19,1998,31,DEN,14,13,4,13,3.3,0,0.9,1,25,30,15,97,6.5,3,6.9,50,3.2,7,36.7,19,13,110,110,0,FB
4653,Ty Hallock,13,25,38,1998,27,CHI,16,10,13,41,3.2,1,2.6,4,38.5,35,25,166,6.6,0,10.4,71.4,4.7,8,45.7,38,41,207,207,0,FB
4654,Derrick Harris,14,12,26,1998,26,STL,16,14,14,38,2.7,0,2.4,5,50,17,12,57,4.8,2,3.6,70.6,3.4,4,47.1,26,38,95,95,0,FB
4655,Raymont Harris,79,10,89,1998,28,GNB,8,3,79,228,2.9,1,28.5,9,34.2,11,10,68,6.8,0,8.5,90.9,6.2,3,72.7,89,228,296,296,0,RB
4656,Aaron Hayden,0,0,0,1998,25,PHI,1,0,0,0,,0,0,0,,0,0,0,,0,0,,,0,,0,0,0,22,22,RB
4657,Garrison Hearst,310,39,349,1998,27,SFO,16,16,310,1570,5.1,7,98.1,73,50.3,56,39,535,13.7,2,33.4,69.6,9.6,14,39.3,349,1570,2105,2105,0,RB
4658,Vaughn Hebron,9,2,11,1998,28,DEN,15,0,9,31,3.4,1,2.1,2,33.3,3,2,5,2.5,0,0.3,66.7,1.7,0,0,11,31,36,1252,1216,RB
4659,William Henderson,23,37,60,1998,27,GNB,16,10,23,70,3,2,4.4,10,56.5,49,37,241,6.5,1,15.1,75.5,4.9,13,51,60,70,311,311,0,FB
4660,June Henley,88,35,123,1998,23,STL,11,3,88,313,3.6,3,28.5,17,47.7,45,35,252,7.2,0,22.9,77.8,5.6,8,31.1,123,313,565,578,13,RB
4661,Chris Hetherington,0,0,0,1998,26,IND,14,1,0,0,,0,0,0,,0,0,0,,0,0,,,0,,0,0,0,71,71,FB
4662,Craig Heyward,6,1,7,1998,32,IND,4,3,6,15,2.5,0,3.8,2,50,1,1,9,9,0,2.3,100,9,0,100,7,15,24,24,0,RB
4663,Skip Hicks,122,4,126,1998,24,WAS,9,5,122,433,3.5,8,48.1,24,38.5,8,4,23,5.8,0,2.6,50,2.9,0,37.5,126,433,456,456,0,RB
4664,Greg Hill,40,1,41,1998,26,STL,2,2,40,240,6,4,120,13,55,2,1,6,6,0,3,50,3,0,50,41,240,246,246,0,RB
4665,Leroy Hoard,115,22,137,1998,30,MIN,16,1,115,479,4.2,9,29.9,29,51.3,26,22,198,9,1,12.4,84.6,7.6,9,57.7,137,479,677,677,0,RB
4666,Robert Holcombe,98,6,104,1998,23,STL,13,6,98,230,2.3,2,17.7,16,31.6,11,6,34,5.7,0,2.6,54.5,3.1,2,36.4,104,230,264,264,0,RB
4667,Darick Holmes,95,20,115,1998,27,"BUF,GNB",14,4,95,394,4.1,1,28.1,21,52.6,24,20,188,9.4,0,13.4,83.3,7.8,9,62.5,115,394,582,602,20,RB
4668,Priest Holmes,233,43,276,1998,25,BAL,16,13,233,1008,4.3,7,63,54,44.6,62,43,260,6,0,16.3,69.4,4.2,10,29,276,1008,1268,1299,30,RB
4669,Chris Howard,7,1,8,1998,23,JAX,8,0,7,16,2.3,0,2,0,0,1,1,3,3,0,0.4,100,3,0,0,8,16,19,19,0,RB
4670,Richard Huntley,55,3,58,1998,26,PIT,16,1,55,242,4.4,1,15.1,10,47.3,6,3,18,6,0,1.1,50,3,1,33.3,58,242,260,379,119,RB
4671,Travis Jervey,83,9,92,1998,26,GNB,8,5,83,325,3.9,1,40.6,18,42.2,12,9,33,3.7,0,4.1,75,2.8,1,33.3,92,325,358,358,0,RB
4672,Anthony Johnson,36,27,63,1998,31,CAR,16,2,36,135,3.8,0,8.4,6,44.4,35,27,242,9,1,15.1,77.1,6.9,11,48.6,63,135,377,389,12,RB
4673,Daryl Johnston,8,18,26,1998,32,DAL,16,13,8,17,2.1,0,1.1,0,37.5,23,18,60,3.3,1,3.8,78.3,2.6,2,30.4,26,17,77,77,0,FB
4674,Leon Johnson,41,13,54,1998,24,NYJ,12,2,41,185,4.5,2,15.4,8,39,21,13,222,17.1,2,18.5,61.9,10.6,8,42.9,54,178,407,976,569,RB
4675,George Jones,39,1,40,1998,24,JAX,12,0,39,121,3.1,0,10.1,6,28.2,2,1,9,9,0,0.8,50,4.5,0,0,40,121,130,151,21,RB
4676,Randy Jordan,47,3,50,1998,28,OAK,16,0,47,159,3.4,1,9.9,12,38.3,3,3,2,0.7,0,0.1,100,0.7,0,0,50,159,161,161,0,RB
4677,Napoleon Kaufman,217,25,242,1998,25,OAK,13,13,217,921,4.2,2,70.8,41,39.6,36,25,191,7.6,0,14.7,69.4,5.3,6,50,242,921,1112,1112,0,RB
4678,Carlos King,0,0,0,1998,25,PIT,1,0,0,0,,0,0,0,,0,0,0,,0,0,,,0,,0,0,0,0,0,RB
4679,Terry Kirby,48,16,64,1998,28,SFO,9,0,48,258,5.4,3,28.7,14,50,19,16,134,8.4,0,14.9,84.2,7.1,7,47.4,64,286,392,732,340,RB
4680,Jim Kitts,0,0,0,1998,26,"GNB,WAS",5,0,0,0,,0,0,0,,0,0,0,,0,0,,,0,,0,0,0,0,0,RB
4681,Fred Lane,205,12,217,1998,23,CAR,14,11,205,717,3.5,5,51.2,36,34.1,15,12,85,7.1,0,6.1,80,5.7,4,46.7,217,717,802,802,0,RB
4682,Amp Lee,44,64,108,1998,27,STL,14,2,44,175,4,2,12.5,8,38.6,84,64,667,10.4,2,47.6,76.2,7.9,31,52.4,108,175,842,842,0,RB
4683,Tim Lester,0,9,9,1998,30,PIT,9,7,0,0,,0,0,0,,13,9,46,5.1,0,5.1,69.2,3.5,0,0,9,0,46,46,0,FB
4684,Dorsey Levens,115,27,142,1998,28,GNB,7,4,115,378,3.3,1,54,21,38.3,30,27,162,6,0,23.1,90,5.4,7,53.3,142,378,540,540,0,RB
4685,Chuck Levy,25,15,40,1998,26,SFO,12,0,25,112,4.5,1,9.3,3,44,18,15,64,4.3,0,5.3,83.3,3.6,4,33.3,40,112,176,559,383,RB
4686,Jonathan Linton,45,1,46,1998,24,BUF,14,0,45,195,4.3,1,13.9,11,44.4,3,1,10,10,0,0.7,33.3,3.3,0,0,46,195,205,205,0,RB
4687,Derek Loville,53,2,55,1998,30,DEN,16,0,53,161,3,2,10.1,13,50.9,2,2,29,14.5,0,1.8,100,14.5,2,100,55,161,190,295,105,RB
4688,Anthony Lynn,0,0,0,1998,30,DEN,16,0,0,0,,0,0,0,,0,0,0,,0,0,,,0,,0,0,0,0,0,RB
4689,Curtis Martin,369,43,412,1998,25,NYJ,15,15,369,1287,3.5,8,85.8,70,43.4,57,43,365,8.5,1,24.3,75.4,6.4,17,50.9,412,1287,1652,1652,0,RB
4690,Le'Shai Maston,0,0,0,1998,28,WAS,1,0,0,0,,0,0,0,,0,0,0,,0,0,,,0,,0,0,0,0,0,RB
4691,Fred McAfee,18,9,27,1998,30,PIT,14,0,18,111,6.2,0,7.9,5,66.7,13,9,27,3,0,1.9,69.2,2.1,1,7.7,27,111,138,148,10,RB
4692,Jerris McPhail,0,0,0,1998,26,DET,3,0,0,0,,0,0,0,,0,0,0,,0,0,,,0,,0,0,0,71,71,RB
4693,Natrone Means,212,16,228,1998,26,SDG,10,10,212,883,4.2,5,88.3,42,41,22,16,91,5.7,0,9.1,72.7,4.1,3,22.7,228,883,974,974,0,RB
4694,Dave Meggett,7,1,8,1998,32,NYJ,2,0,7,24,3.4,0,12,1,14.3,3,1,15,15,0,7.5,33.3,5,1,33.3,8,24,39,95,56,RB
4695,Eric Metcalf,0,31,31,1998,30,ARI,16,3,0,0,,0,0,0,,49,31,324,10.5,0,20.3,63.3,6.6,18,51,31,0,324,1837,1513,RB
4696,Glyn Milburn,4,4,8,1998,27,CHI,16,1,4,8,2,0,0.5,0,25,6,4,37,9.3,0,2.3,66.7,6.2,2,33.3,8,8,45,1886,1841,RB
4697,Brian Milne,10,26,36,1998,25,CIN,14,14,10,41,4.1,1,2.9,5,80,39,26,124,4.8,0,8.9,66.7,3.2,5,28.2,36,41,165,165,0,FB
4698,Brian Mitchell,39,44,83,1998,30,WAS,16,0,39,208,5.3,2,13,11,48.7,62,44,306,7,0,19.1,71,4.9,14,35.5,83,208,514,2357,1843,RB
4699,Jerald Moore,55,9,64,1998,24,STL,11,4,55,137,2.5,2,12.5,12,41.8,12,9,60,6.7,0,5.5,75,5,2,50,64,137,197,197,0,RB
4700,Ronald Moore,4,1,5,1998,28,MIA,1,1,4,12,3,0,12,0,0,1,1,1,1,0,1,100,1,0,0,5,12,13,13,0,RB
4701,Bam Morris,132,12,144,1998,26,"CHI,KAN",12,5,132,489,3.7,8,40.8,27,41.7,13,12,95,7.9,0,7.9,92.3,7.3,1,61.5,144,489,584,584,0,RB
4702,Harold Morrow,3,0,3,1998,25,MIN,11,0,3,7,2.3,0,0.6,0,0,0,0,0,,0,0,,,0,,3,7,7,7,0,FB
4703,Adrian Murrell,274,18,292,1998,28,ARI,15,14,274,1042,3.8,8,69.5,46,38.7,27,18,169,9.4,2,11.3,66.7,6.3,7,44.4,292,1042,1211,1211,0,RB
4704,Lorenzo Neal,5,5,10,1998,28,TAM,16,1,5,25,5,0,1.6,1,60,8,5,14,2.8,1,0.9,62.5,1.8,2,37.5,10,25,39,39,0,FB
4705,Brock Olivo,0,0,0,1998,22,DET,1,0,0,0,,0,0,0,,0,0,0,,0,0,,,0,,0,0,0,0,0,RB
4706,Winslow Oliver,0,0,0,1998,25,CAR,16,0,0,0,,0,0,0,,0,0,0,,0,0,,,0,,0,0,0,507,507,RB
4707,Ken Oxendine,18,1,19,1998,23,ATL,9,0,18,50,2.8,0,5.6,2,27.8,1,1,11,11,0,1.2,100,11,1,100,19,50,61,61,0,RB
4708,Bernie Parmalee,8,21,29,1998,31,MIA,15,0,8,20,2.5,0,1.3,2,37.5,25,21,221,10.5,0,14.7,84,8.8,9,56,29,20,241,241,0,RB
4709,Wilmont Perry,30,1,31,1998,23,NOR,6,2,30,122,4.1,0,20.3,10,60,6,1,2,2,0,0.3,16.7,0.3,0,0,31,122,124,124,0,RB
4710,Michael Pittman,29,0,29,1998,23,ARI,15,0,29,91,3.1,0,6.1,4,34.5,0,0,0,,0,0,,,0,,29,91,91,175,84,RB
4711,Roosevelt Potts,36,30,66,1998,27,BAL,16,15,36,115,3.2,0,7.2,8,38.9,38,30,168,5.6,2,10.5,78.9,4.4,6,36.8,66,115,283,286,3,FB
4712,Stanley Pritchett,6,17,23,1998,25,MIA,16,12,6,19,3.2,1,1.2,3,50,30,17,97,5.7,0,6.1,56.7,3.2,2,26.7,23,19,116,116,0,FB
4713,Travis Reece,0,0,0,1998,23,DET,3,0,0,0,,0,0,0,,0,0,0,,0,0,,,0,,0,0,0,0,0,RB
4714,Mike Reed,0,0,0,1998,23,PHI,4,0,0,0,,0,0,0,,0,0,0,,0,0,,,0,,0,0,0,0,0,RB
4715,Errict Rhett,44,11,55,1998,28,BAL,13,2,44,180,4.1,0,13.8,5,43.2,14,11,65,5.9,0,5,78.6,4.6,2,42.9,55,180,245,245,0,RB
4716,Tony Richardson,20,2,22,1998,27,KAN,14,1,20,45,2.3,2,3.2,10,55,3,2,13,6.5,0,0.9,66.7,4.3,0,33.3,22,45,58,58,0,FB
4717,Jon Ritchie,9,29,38,1998,24,OAK,15,10,9,23,2.6,0,1.5,3,22.2,47,29,225,7.8,0,15,61.7,4.8,7,42.6,38,23,248,248,0,FB
4718,Ron Rivers,19,3,22,1998,27,DET,15,0,19,102,5.4,1,6.8,4,42.1,3,3,58,19.3,0,3.9,100,19.3,3,100,22,102,160,175,15,RB
4719,Barry Sanders,343,37,380,1998,30,DET,16,16,343,1491,4.3,4,93.2,65,38.8,57,37,289,7.8,0,18.1,64.9,5.1,10,31.6,380,1491,1780,1780,0,RB
4720,Cory Schlesinger,5,3,8,1998,26,DET,15,2,5,17,3.4,0,1.1,1,40,6,3,16,5.3,1,1.1,50,2.7,2,33.3,8,17,33,33,0,FB
4721,Harold Shaw,0,0,0,1998,24,NWE,11,0,0,0,,0,0,0,,0,0,0,,0,0,,,0,,0,0,0,0,0,RB
4722,Sedrick Shaw,48,6,54,1998,25,NWE,13,1,48,236,4.9,0,18.2,5,20.8,11,6,30,5,0,2.3,54.5,2.7,2,36.4,54,236,266,275,16,RB
4723,Rashaan Shehee,22,10,32,1998,23,KAN,16,0,22,57,2.6,0,3.6,4,31.8,22,10,73,7.3,0,4.6,45.5,3.3,2,36.4,32,57,130,202,72,RB
4724,Daimon Shelton,30,10,40,1998,26,JAX,14,8,30,95,3.2,1,6.8,6,33.3,15,10,79,7.9,0,5.6,66.7,5.3,3,53.3,40,95,174,174,0,FB
4725,Antowain Smith,300,5,305,1998,26,BUF,16,14,300,1124,3.7,8,70.3,61,45.7,11,5,11,2.2,0,0.7,45.5,1,0,27.3,305,1124,1135,1135,0,RB
4726,Detron Smith,0,3,3,1998,24,DEN,15,2,0,0,,0,0,0,,6,3,24,8,0,1.6,50,4,1,33.3,3,0,24,75,51,RB
4727,Emmitt Smith,319,27,346,1998,29,DAL,16,16,319,1332,4.2,13,83.3,90,52.7,32,27,175,6.5,2,10.9,84.4,5.5,8,62.5,346,1332,1507,1507,0,RB
4728,Lamar Smith,138,24,162,1998,28,NOR,14,9,138,457,3.3,1,32.6,21,29.7,36,24,249,10.4,2,17.8,66.7,6.9,12,41.7,162,477,706,706,0,RB
4729,Robert Smith,249,28,277,1998,26,MIN,14,14,249,1187,4.8,6,84.8,46,39.8,35,28,291,10.4,2,20.8,80,8.3,12,57.1,277,1187,1478,1478,0,RB
4730,Jerald Sowell,40,10,50,1998,24,NYJ,16,2,40,164,4.1,0,10.3,6,27.5,12,10,59,5.9,0,3.7,83.3,4.9,3,50,50,164,223,223,0,FB
4731,Duce Staley,258,57,315,1998,23,PHI,16,13,258,1065,4.1,5,66.6,55,45,70,57,432,7.6,1,27,81.4,6.2,19,38.6,315,1065,1497,1516,19,RB
4732,Tremayne Stephens,35,2,37,1998,22,SDG,13,1,35,122,3.5,1,9.4,4,48.6,6,2,9,4.5,0,0.7,33.3,1.5,1,33.3,37,122,131,480,349,RB
4733,James Stewart,53,6,59,1998,27,JAX,3,3,53,217,4.1,2,72.3,13,45.3,8,6,42,7,1,14,75,5.3,4,50,59,217,259,248,0,RB
4734,Mack Strong,15,8,23,1998,27,SEA,16,5,15,47,3.1,0,2.9,3,40,14,8,48,6,2,3,57.1,3.4,2,42.9,23,47,95,95,0,FB
4735,Nicky Sualua,0,0,0,1998,23,DAL,16,0,0,0,,0,0,0,,1,0,0,,0,0,0,0,0,0,0,0,0,0,0,RB
4736,Fred Taylor,264,44,308,1998,22,JAX,15,12,264,1223,4.6,14,81.5,57,40.9,53,44,421,9.6,3,28.1,83,7.9,13,41.5,308,1223,1644,1653,0,RB
4737,David Thompson,0,0,0,1998,23,STL,1,0,0,0,,0,0,0,,0,0,0,,0,0,,,0,,0,0,0,0,0,RB
4738,Rodney Thomas,24,6,30,1998,25,TEN,11,0,24,100,4.2,2,9.1,5,41.7,8,6,55,9.2,0,5,75,6.9,3,50,30,100,155,219,64,RB
4739,Thurman Thomas,93,26,119,1998,32,BUF,14,3,93,381,4.1,2,27.2,16,39.8,32,26,220,8.5,1,15.7,81.3,6.9,10,53.1,119,381,601,601,0,RB
4740,Kevin Turner,20,34,54,1998,29,PHI,16,15,20,94,4.7,0,5.9,3,45,59,34,232,6.8,0,14.5,57.6,3.9,15,39,54,94,326,341,15,FB
4741,Tommy Vardell,18,14,32,1998,29,DET,14,9,18,37,2.1,6,2.6,9,55.6,24,14,143,10.2,1,10.2,58.3,6,7,37.5,32,37,180,203,23,FB
4742,Corey Walker,12,2,14,1998,25,PHI,14,0,12,55,4.6,0,3.9,2,33.3,2,2,35,17.5,0,2.5,100,17.5,1,50,14,55,90,240,150,RB
4743,Chris Warren,59,13,72,1998,30,DAL,9,0,59,291,4.9,4,32.3,14,39,16,13,66,5.1,1,7.3,81.3,4.1,6,37.5,72,291,357,458,101,RB
4744,Lamont Warren,25,11,36,1998,25,IND,12,2,25,61,2.4,1,5.1,5,40,17,11,44,4,1,3.7,64.7,2.6,4,35.3,36,61,105,257,152,RB
4745,Ricky Watters,319,52,371,1998,29,SEA,16,16,319,1239,3.9,9,77.4,76,45.5,73,52,373,7.2,0,23.3,71.2,5.1,15,41.1,371,1240,1612,1612,0,RB
4746,Charles Way,113,31,144,1998,26,NYG,16,15,113,432,3.8,3,27,30,46,40,31,131,4.2,1,8.2,77.5,3.3,5,25,144,432,563,563,0,FB
4747,Tyrone Wheatley,14,0,14,1998,26,NYG,5,0,14,52,3.7,0,10.4,2,35.7,0,0,0,,0,0,,,0,,14,52,52,68,16,RB
4748,Harvey Williams,128,26,154,1998,31,OAK,16,3,128,496,3.9,2,31,30,44.5,39,26,173,6.7,0,10.8,66.7,4.4,6,33.3,154,523,669,669,0,RB
4749,Jermaine Williams,0,0,0,1998,25,OAK,10,0,0,0,,0,0,0,,2,0,0,,0,0,0,0,0,0,0,0,0,0,0,RB
4750,Moe Williams,0,1,1,1998,24,MIN,12,1,0,0,,0,0,0,,1,1,64,64,0,5.3,100,64,1,100,1,0,64,83,19,RB
4751,Pooh Bear Williams,2,0,2,1998,23,BUF,3,0,2,5,2.5,0,1.7,0,0,0,0,0,,0,0,,,0,,2,5,5,5,0,RB
4752,Sherman Williams,64,11,75,1998,25,DAL,16,2,64,220,3.4,1,13.8,11,35.9,14,11,104,9.5,0,6.5,78.6,7.4,4,50,75,220,324,427,103,RB
4753,Jon Witman,1,13,14,1998,26,PIT,16,9,1,2,2,0,0.1,0,0,20,13,74,5.7,0,4.6,65,3.7,3,30,14,2,76,76,0,FB
4754,Ray Zellars,56,10,66,1998,25,NOR,11,7,56,162,2.9,1,14.7,7,33.9,16,10,50,5,0,4.5,62.5,3.1,1,37.5,66,162,212,212,0,FB
4755,Karim Abdul-Jabbar,283,29,312,1997,23,MIA,16,14,283,892,3.2,15,55.8,66,44.9,49,29,261,9,1,16.3,59.2,5.3,10,38.8,312,892,1153,1153,0,RB
4756,Marcus Allen,124,11,135,1997,37,KAN,16,0,124,505,4.1,11,31.6,42,60.5,14,11,86,7.8,0,5.4,78.6,6.1,6,50,135,520,591,591,0,RB
4757,Terry Allen,210,20,230,1997,29,WAS,10,10,210,724,3.4,4,72.4,31,38.6,29,20,172,8.6,1,17.2,69,5.9,7,51.7,230,724,896,896,0,RB
4758,Mike Alstott,176,23,199,1997,24,TAM,15,15,176,665,3.8,7,44.3,35,42.6,33,23,178,7.7,3,11.9,69.7,5.4,13,48.5,199,665,843,843,0,FB
4759,Jamal Anderson,290,29,319,1997,25,ATL,16,15,290,1002,3.5,7,62.6,53,43.8,37,29,284,9.8,3,17.8,78.4,7.7,14,56.8,319,1029,1286,1286,0,RB
4760,Kimble Anders,79,59,138,1997,31,KAN,15,14,79,397,5,0,26.5,17,50.6,72,59,453,7.7,2,30.2,81.9,6.3,22,40.3,138,397,850,850,0,FB
4761,Richie Anderson,21,26,47,1997,26,NYJ,16,3,21,70,3.3,0,4.4,4,28.6,35,26,150,5.8,1,9.4,74.3,4.3,6,42.9,47,70,220,220,0,FB
4762,Mike Archie,0,0,0,1997,25,TEN,5,0,0,0,,0,0,0,,0,0,0,,0,0,,,0,,0,0,0,29,29,RB
4763,Joe Aska,12,0,12,1997,25,OAK,7,0,12,10,0.8,0,1.4,1,25,0,0,0,,0,0,,,0,,12,10,10,56,46,RB
4764,Darnell Autry,112,9,121,1997,21,CHI,13,3,112,319,2.8,1,24.5,13,31.3,14,9,59,6.6,0,4.5,64.3,4.2,2,28.6,121,319,378,378,0,RB
4765,Tiki Barber,136,34,170,1997,22,NYG,12,6,136,511,3.8,3,42.6,32,42.6,54,34,299,8.8,1,24.9,63,5.5,13,42.6,170,511,810,810,0,RB
4766,Mario Bates,119,5,124,1997,24,NOR,12,7,119,440,3.7,4,36.7,24,40.3,11,5,42,8.4,0,3.5,45.5,3.8,2,27.3,124,461,482,482,0,RB
4767,Michael Bates,0,0,0,1997,28,CAR,16,0,0,0,,0,0,0,,0,0,0,,0,0,,,0,,0,0,0,1289,1289,RB
4768,Wes Bender,5,0,5,1997,27,NOR,11,0,5,9,1.8,0,0.8,0,0,4,0,0,,0,0,0,0,0,0,5,9,9,9,0,RB
4769,Donnell Bennett,94,7,101,1997,25,KAN,14,1,94,369,3.9,1,26.4,19,53.2,9,7,5,0.7,0,0.4,77.8,0.6,1,11.1,101,369,374,374,0,RB
4770,Jerome Bettis,375,15,390,1997,25,PIT,15,15,375,1665,4.4,7,111,94,51.7,24,15,110,7.3,2,7.3,62.5,4.6,5,33.3,390,1665,1775,1775,0,RB
4771,Tim Biakabutuka,75,0,75,1997,23,CAR,8,2,75,299,4,2,37.4,12,45.3,3,0,0,,0,0,0,0,0,0,75,299,299,299,0,RB
4772,Eric Bieniemy,21,31,52,1997,28,CIN,16,0,21,97,4.6,1,6.1,3,19,37,31,249,8,0,15.6,83.8,6.7,13,48.6,52,97,346,1135,789,RB
4773,Kevin Bouie,11,0,11,1997,26,ARI,5,0,11,26,2.4,0,5.2,2,45.5,0,0,0,,0,0,,,0,,11,26,26,162,136,RB
4774,Larry Bowie,28,34,62,1997,24,WAS,15,12,28,100,3.6,2,6.7,8,53.6,40,34,388,11.4,2,25.9,85,9.7,19,62.5,62,100,488,503,15,FB
4775,Steve Broussard,70,24,94,1997,30,SEA,16,1,70,418,6,5,26.1,24,51.4,30,24,143,6,1,8.9,80,4.8,6,36.7,94,418,561,1637,1076,RB
4776,Gary Brown,253,21,274,1997,28,SDG,15,14,253,945,3.7,4,63,47,41.9,30,21,137,6.5,0,9.1,70,4.6,8,43.3,274,945,1082,1082,0,RB
4777,Reggie Brown,0,0,0,1997,24,SEA,11,0,0,0,,0,0,0,,0,0,0,,0,0,,,0,,0,0,0,16,16,RB
4778,Keith Byars,11,20,31,1997,34,NWE,16,8,11,24,2.2,0,1.5,4,45.5,40,20,189,9.5,3,11.8,50,4.7,8,30,31,24,213,213,0,FB
4779,Earnest Byner,84,21,105,1997,35,BAL,16,5,84,313,3.7,0,19.6,18,51.2,31,21,128,6.1,0,8,67.7,4.1,7,29,105,313,441,441,0,RB
4780,Kenny Bynum,30,2,32,1997,23,SDG,13,0,30,97,3.2,0,7.5,5,30,2,2,4,2,0,0.3,100,2,0,0,32,97,101,915,814,RB
4781,Ki-Jana Carter,128,21,149,1997,24,CIN,15,10,128,464,3.6,7,30.9,22,39.8,31,21,157,7.5,0,10.5,67.7,5.1,7,32.3,149,464,621,630,9,RB
4782,Tony Carter,9,24,33,1997,25,CHI,16,10,9,56,6.2,0,3.5,3,33.3,34,24,152,6.3,0,9.5,70.6,4.5,11,47.1,33,56,208,242,34,FB
4783,Larry Centers,101,54,155,1997,29,ARI,15,14,101,276,2.7,1,18.4,19,33.7,75,54,409,7.6,1,27.3,72,5.5,22,48,155,276,685,685,0,FB
4784,Robert Chancey,0,0,0,1997,25,SDG,6,0,0,0,,0,0,0,,0,0,0,,0,0,,,0,,0,0,0,0,0,RB
4785,Bob Christian,7,22,29,1997,29,ATL,16,12,7,8,1.1,0,0.5,1,14.3,31,22,154,7,1,9.6,71,5,6,54.8,29,8,162,162,0,FB
4786,Kenyon Cotton,2,0,2,1997,23,BAL,15,0,2,2,1,1,0.1,1,50,0,0,0,,0,0,,,0,,2,2,2,2,0,RB
4787,Aaron Craver,20,4,24,1997,29,SDG,15,5,20,71,3.6,0,4.7,2,30,6,4,26,6.5,0,1.7,66.7,4.3,1,33.3,24,71,97,165,68,FB
4788,Zack Crockett,95,15,110,1997,25,IND,16,11,95,300,3.2,1,18.8,18,45.3,24,15,112,7.5,0,7,62.5,4.7,5,41.7,110,300,412,412,0,FB
4789,Derrick Cullors,22,2,24,1997,25,NWE,15,1,22,101,4.6,0,6.7,4,40.9,5,2,8,4,0,0.5,40,1.6,0,0,24,101,109,495,386,RB
4790,Jerone Davison,2,2,4,1997,27,OAK,8,1,2,4,2,0,0.5,0,0,6,2,34,17,0,4.3,33.3,5.7,1,33.3,4,4,38,38,0,RB
4791,Stephen Davis,141,18,159,1997,23,WAS,14,6,141,567,4,3,40.5,30,51.1,24,18,134,7.4,0,9.6,75,5.6,8,45.8,159,567,701,763,62,RB
4792,Terrell Davis,369,42,411,1997,25,DEN,15,15,369,1750,4.7,15,116.7,99,54.2,58,42,287,6.8,0,19.1,72.4,4.9,11,37.9,411,1750,2037,2030,0,RB
4793,Troy Davis,75,13,88,1997,22,NOR,16,7,75,271,3.6,0,16.9,11,40,18,13,85,6.5,0,5.3,72.2,4.7,4,33.3,88,271,356,529,173,RB
4794,Corey Dillon,233,27,260,1997,23,CIN,16,6,233,1129,4.8,10,70.6,58,48.1,33,27,259,9.6,0,16.2,81.8,7.8,8,66.7,260,1129,1388,1574,182,RB
4795,Ty Douthard,0,0,0,1997,24,CIN,1,0,0,0,,0,0,0,,0,0,0,,0,0,,,0,,0,0,0,0,0,RB
4796,Gary Downs,0,0,0,1997,25,ATL,16,0,0,0,,0,0,0,,0,0,0,,0,0,,,0,,0,0,0,0,0,RB
4797,Mike Dulaney,0,0,0,1997,27,CHI,7,0,0,0,,0,0,0,,1,0,0,,0,0,0,0,0,0,0,0,0,0,0,RB
4798,Warrick Dunn,224,39,263,1997,22,TAM,16,10,224,978,4.4,4,61.1,37,37.1,56,39,462,11.8,3,28.9,69.6,8.3,19,41.1,263,978,1440,1617,177,RB
4799,Marc Edwards,5,6,11,1997,23,SFO,15,1,5,17,3.4,0,1.1,1,60,10,6,48,8,0,3.2,60,4.8,2,40,11,17,65,95,30,FB
4800,Jerry Ellison,2,1,3,1997,26,TAM,16,0,2,10,5,0,0.6,1,50,2,1,8,8,0,0.5,50,4,0,0,3,10,18,79,61,RB
4801,Charles Evans,43,21,64,1997,30,MIN,16,13,43,157,3.7,2,9.8,0,0,30,21,152,7.2,0,9.5,70,5.1,0,0,64,157,309,309,0,FB
4802,Marshall Faulk,264,47,311,1997,24,IND,16,16,264,1054,4,7,65.9,64,48.1,73,47,471,10,1,29.4,64.4,6.5,15,35.6,311,1054,1525,1525,0,RB
4803,Derrick Fenner,7,14,21,1997,30,OAK,9,7,7,24,3.4,0,2.7,1,42.9,17,14,92,6.6,0,10.2,82.4,5.4,3,23.5,21,24,116,116,0,FB
4804,Terrell Fletcher,51,39,90,1997,24,SDG,13,1,51,161,3.2,0,12.4,6,33.3,48,39,292,7.5,0,22.5,81.3,6.1,17,47.9,90,161,453,453,0,RB
4805,William Floyd,78,37,115,1997,25,SFO,15,15,78,231,3,3,15.4,18,37.2,54,37,321,8.7,1,21.4,68.5,5.9,13,46.3,115,231,552,552,0,FB
4806,Carwell Gardner,7,2,9,1997,31,SDG,5,2,7,20,2.9,0,4,1,28.6,2,2,10,5,0,2,100,5,0,50,9,20,30,30,0,FB
4807,Charlie Garner,116,24,140,1997,25,PHI,16,2,116,547,4.7,3,34.2,32,51.7,34,24,225,9.4,0,14.1,70.6,6.6,8,58.8,140,547,772,772,0,RB
4808,Sam Gash,6,22,28,1997,28,NWE,16,5,6,10,1.7,0,0.6,0,0,29,22,154,7,3,9.6,75.9,5.3,12,62.1,28,10,164,164,0,FB
4809,Eddie George,357,7,364,1997,24,TEN,16,16,357,1399,3.9,6,87.4,65,46.2,12,7,44,6.3,1,2.8,58.3,3.7,3,25,364,1399,1443,1443,0,RB
4810,Spencer George,0,0,0,1997,24,TEN,5,0,0,0,,0,0,0,,0,0,0,,0,0,,,0,,0,0,0,0,0,RB
4811,Jay Graham,81,12,93,1997,22,BAL,13,3,81,299,3.7,2,23,23,48.1,14,12,51,4.3,0,3.9,85.7,3.6,1,35.7,93,299,350,465,115,RB
4812,Scottie Graham,1,1,2,1997,28,CIN,5,0,1,-1,-1,0,-0.2,0,0,1,1,1,1,0,0.2,100,1,0,0,2,-1,0,0,0,RB
4813,Harold Green,36,29,65,1997,29,ATL,16,1,36,78,2.2,1,4.9,7,25,36,29,360,12.4,0,22.5,80.6,10,12,44.4,65,78,438,461,23,RB
4814,Robert Green,6,1,7,1997,27,MIN,3,1,6,22,3.7,0,7.3,0,0,1,1,5,5,0,1.7,100,5,0,0,7,22,27,27,0,RB
4815,Scott Greene,45,40,85,1997,25,CAR,16,14,45,157,3.5,1,9.8,16,57.8,57,40,277,6.9,1,17.3,70.2,4.9,13,45.6,85,157,434,452,18,FB
4816,Marrio Grier,33,0,33,1997,26,NWE,16,0,33,75,2.3,1,4.7,4,27.3,0,0,0,,0,0,,,0,,33,75,75,75,0,RB
4817,Howard Griffith,9,11,20,1997,30,DEN,15,13,9,34,3.8,0,2.3,2,66.7,17,11,55,5,0,3.7,64.7,3.2,3,23.5,20,34,89,89,0,FB
4818,Clif Groce,10,0,10,1997,25,IND,7,0,10,66,6.6,0,9.4,3,30,0,0,0,,0,0,,,0,,10,66,66,81,15,RB
4819,Tim Hall,23,1,24,1997,23,OAK,16,0,23,120,5.2,0,7.5,8,43.5,4,1,9,9,0,0.6,25,2.3,0,25,24,120,129,311,182,RB
4820,Ty Hallock,4,18,22,1997,26,JAX,15,7,4,21,5.3,0,1.4,2,50,23,18,131,7.3,1,8.7,78.3,5.7,6,52.2,22,21,152,158,6,FB
4821,Rodney Hampton,23,0,23,1997,28,NYG,2,0,23,81,3.5,1,40.5,5,47.8,0,0,0,,0,0,,,0,,23,81,81,81,0,RB
4822,Byron Hanspard,53,6,59,1997,21,ATL,16,0,53,335,6.3,0,20.9,9,34,7,6,53,8.8,1,3.3,85.7,7.6,3,71.4,59,335,388,1375,987,RB
4823,Ronnie Harmon,10,18,28,1997,33,"CHI,TEN",12,0,10,36,3.6,0,3,3,40,21,18,197,10.9,0,16.4,85.7,9.4,9,61.9,28,36,233,249,16,RB
4824,Raymont Harris,275,28,303,1997,27,CHI,13,13,275,1033,3.8,10,79.5,53,42.9,41,28,115,4.1,0,8.8,68.3,2.8,6,26.8,303,1033,1148,1148,0,RB
4825,Aaron Hayden,32,2,34,1997,24,GNB,14,0,32,148,4.6,1,10.6,6,46.9,2,2,11,5.5,0,0.8,100,5.5,2,100,34,148,159,300,141,RB
4826,Garrison Hearst,234,21,255,1997,26,SFO,13,13,234,1019,4.4,4,78.4,41,42.7,27,21,194,9.2,2,14.9,77.8,7.2,8,37,255,1019,1213,1213,0,RB
4827,Vaughn Hebron,49,3,52,1997,27,DEN,16,1,49,222,4.5,1,13.9,12,46.9,5,3,36,12,0,2.3,60,7.2,2,40,52,222,258,1267,1009,RB
4828,William Henderson,31,41,72,1997,26,GNB,16,14,31,113,3.6,0,7.1,11,51.6,48,41,367,9,1,22.9,85.4,7.6,17,60.4,72,113,480,480,0,FB
4829,Chris Hetherington,0,0,0,1997,25,IND,16,0,0,0,,0,0,0,,1,0,0,,0,0,0,0,0,0,0,0,0,23,23,FB
4830,Craig Heyward,34,8,42,1997,31,STL,16,12,34,84,2.5,1,5.3,5,47.1,13,8,77,9.6,0,4.8,61.5,5.9,4,46.2,42,84,161,161,0,FB
4831,Michael Hicks,4,0,4,1997,24,CHI,3,0,4,14,3.5,0,4.7,0,0,0,0,0,,0,0,,,0,,4,14,14,14,0,RB
4832,Greg Hill,157,12,169,1997,25,KAN,16,16,157,550,3.5,0,34.4,23,36.3,24,12,126,10.5,0,7.9,50,5.3,4,41.7,169,550,676,676,0,RB
4833,Leroy Hoard,80,11,91,1997,29,MIN,12,1,80,235,2.9,4,19.6,16,40,15,11,84,7.6,0,7,73.3,5.6,1,46.7,91,235,319,319,0,RB
4834,Darick Holmes,22,13,35,1997,26,BUF,13,0,22,106,4.8,2,8.2,11,63.6,20,13,106,8.2,0,8.2,65,5.3,2,60,35,106,212,642,430,RB
4835,Priest Holmes,0,0,0,1997,24,BAL,7,0,0,0,,0,0,0,,0,0,0,,0,0,,,0,,0,0,0,14,14,RB
4836,Travis Jervey,0,0,0,1997,25,GNB,16,0,0,0,,0,0,0,,0,0,0,,0,0,,,0,,0,0,0,0,0,RB
4837,Anthony Johnson,97,21,118,1997,30,CAR,16,7,97,358,3.7,0,22.4,11,40.2,33,21,158,7.5,1,9.9,63.6,4.8,5,30.3,118,358,516,516,0,RB
4838,Daryl Johnston,2,18,20,1997,31,DAL,6,6,2,3,1.5,0,0.5,1,50,29,18,166,9.2,1,27.7,62.1,5.7,8,48.3,20,3,169,169,0,FB
4839,Leon Johnson,48,16,64,1997,23,NYJ,16,1,48,158,3.3,2,9.9,13,35.4,21,16,142,8.9,0,8.9,76.2,6.8,8,42.9,64,158,300,1238,938,RB
4840,LeShon Johnson,23,3,26,1997,26,ARI,14,0,23,81,3.5,0,5.8,3,47.8,3,3,4,1.3,0,0.3,100,1.3,0,33.3,26,81,85,111,26,RB
4841,George Jones,72,16,88,1997,24,PIT,16,1,72,235,3.3,1,14.7,12,27.8,18,16,96,6,1,6,88.9,5.3,4,33.3,88,235,331,331,0,RB
4842,Randy Jordan,1,0,1,1997,27,JAX,7,0,1,2,2,0,0.3,0,0,0,0,0,,0,0,,,0,,1,2,2,2,0,RB
4843,Napoleon Kaufman,272,40,312,1997,24,OAK,16,16,272,1294,4.8,6,80.9,55,38.6,50,40,403,10.1,2,25.2,80,8.1,13,48,312,1294,1697,1697,0,RB
4844,Randy Kinder,0,0,0,1997,22,"GNB,PHI",12,0,0,0,,0,0,0,,0,0,0,,0,0,,,0,,0,0,0,0,0,RB
4845,Terry Kirby,125,23,148,1997,27,SFO,16,3,125,418,3.3,6,26.1,25,38.4,34,23,279,12.1,1,17.4,67.6,8.2,10,38.2,148,418,697,821,124,RB
4846,Jim Kitts,0,0,0,1997,25,MIA,10,0,0,0,,0,0,0,,0,0,0,,0,0,,,0,,0,0,0,0,0,RB
4847,Eric Lane,5,0,5,1997,23,NYG,15,0,5,13,2.6,0,0.9,0,0,0,0,0,,0,0,,,0,,5,13,13,13,0,RB
4848,Fred Lane,182,8,190,1997,22,CAR,13,7,182,809,4.4,7,62.2,41,51.1,13,8,27,3.4,0,2.1,61.5,2.1,0,30.8,190,809,836,836,0,RB
4849,Amp Lee,28,61,89,1997,26,STL,16,1,28,104,3.7,0,6.5,3,28.6,93,61,825,13.5,3,51.6,65.6,8.9,32,44.1,89,104,929,1000,71,RB
4850,Tim Lester,2,10,12,1997,29,PIT,16,13,2,9,4.5,0,0.6,0,50,15,10,51,5.1,0,3.2,66.7,3.4,3,46.7,12,9,60,60,0,FB
4851,Dorsey Levens,329,53,382,1997,27,GNB,16,16,329,1435,4.4,7,89.7,71,42.2,67,53,370,7,5,23.1,79.1,5.5,18,46.3,382,1435,1805,1798,0,RB
4852,Chad Levitt,2,2,4,1997,22,OAK,10,2,2,3,1.5,0,0.3,0,0,9,2,24,12,0,2.4,22.2,2.7,1,11.1,4,3,27,39,12,RB
4853,Chuck Levy,16,5,21,1997,25,SFO,14,0,16,90,5.6,0,6.4,4,50,9,5,68,13.6,0,4.9,55.6,7.6,3,33.3,21,90,158,1060,902,RB
4854,Marc Logan,4,3,7,1997,32,WAS,15,1,4,5,1.3,0,0.3,0,0,6,3,6,2,0,0.4,50,1,0,0,7,5,11,81,70,RB
4855,Derek Loville,25,2,27,1997,29,DEN,16,0,25,124,5,1,7.8,7,56,2,2,10,5,0,0.6,100,5,0,0,27,124,134,270,136,RB
4856,Anthony Lynn,0,1,1,1997,29,DEN,16,0,0,0,,0,0,0,,1,1,21,21,0,1.3,100,21,1,100,1,0,21,21,0,RB
4857,Curtis Martin,274,41,315,1997,24,NWE,13,13,274,1160,4.2,4,89.2,47,44.2,51,41,296,7.2,1,22.8,80.4,5.8,12,51,315,1160,1456,1456,0,RB
4858,Fred McAfee,13,2,15,1997,29,PIT,14,0,13,41,3.2,0,2.9,1,38.5,2,2,44,22,0,3.1,100,22,2,100,15,41,85,85,0,RB
4859,Fred McCrary,8,4,12,1997,25,NOR,7,0,8,15,1.9,0,2.1,0,37.5,4,4,17,4.3,0,2.4,100,4.3,2,50,12,15,32,58,26,FB
4860,Leeland McElroy,135,7,142,1997,23,ARI,14,8,135,424,3.1,2,30.3,22,38.5,12,7,32,4.6,0,2.3,58.3,2.7,1,25,142,424,456,456,0,RB
4861,Jerris McPhail,17,34,51,1997,25,MIA,14,1,17,146,8.6,1,10.4,6,52.9,48,34,262,7.7,1,18.7,70.8,5.5,12,41.7,51,146,408,726,314,RB
4862,Natrone Means,244,15,259,1997,25,JAX,14,11,244,823,3.4,9,58.8,46,49.2,20,15,104,6.9,0,7.4,75,5.2,3,45,259,823,927,927,0,RB
4863,Dave Meggett,20,19,39,1997,31,NWE,16,2,20,60,3,1,3.8,0,0,24,19,203,10.7,1,12.7,79.2,8.5,0,0,39,95,263,1546,1283,RB
4864,Brian Milne,13,23,36,1997,24,CIN,16,16,13,32,2.5,2,2,3,38.5,32,23,138,6,0,8.6,71.9,4.3,8,40.6,36,32,170,170,0,FB
4865,Brian Mitchell,23,36,59,1997,29,WAS,16,1,23,107,4.7,1,6.7,4,30.4,50,36,438,12.2,1,27.4,72,8.8,20,58,59,107,545,2081,1536,RB
4866,Jerald Moore,104,8,112,1997,23,STL,9,5,104,380,3.7,3,42.2,22,42.3,12,8,69,8.6,0,7.7,66.7,5.8,2,50,112,380,449,449,0,RB
4867,Ronald Moore,81,4,85,1997,27,"ARI,STL",13,4,81,278,3.4,1,21.4,14,33.3,5,4,34,8.5,0,2.6,80,6.8,3,80,85,278,312,329,17,RB
4868,Bam Morris,204,29,233,1997,25,BAL,11,8,204,774,3.8,4,70.4,45,49,38,29,176,6.1,0,16,76.3,4.6,8,39.5,233,774,950,973,23,RB
4869,Harold Morrow,0,0,0,1997,24,MIN,16,0,0,0,,0,0,0,,0,0,0,,0,0,,,0,,0,0,0,99,99,FB
4870,Adrian Murrell,300,27,327,1997,27,NYJ,16,15,300,1086,3.6,7,67.9,61,41,41,27,106,3.9,0,6.6,65.9,2.6,4,26.8,327,1086,1192,1192,0,RB
4871,Leon Neal,0,0,0,1997,25,IND,1,0,0,0,,0,0,0,,0,0,0,,0,0,,,0,,0,0,0,23,23,RB
4872,Lorenzo Neal,10,8,18,1997,27,NYJ,16,3,10,28,2.8,0,1.8,2,50,13,8,40,5,1,2.5,61.5,3.1,3,30.8,18,28,68,90,22,FB
4873,Ray Nealy,1,0,1,1997,22,MIA,1,0,1,2,2,0,2,0,0,0,0,0,,0,0,,,0,,1,2,2,2,0,RB
4874,Winslow Oliver,1,6,7,1997,24,CAR,6,0,1,0,0,0,0,0,0,7,6,47,7.8,0,7.8,85.7,6.7,2,57.1,7,0,47,158,111,RB
4875,Chris Parker,0,0,0,1997,24,JAX,1,0,0,0,,0,0,0,,0,0,0,,0,0,,,0,,0,0,0,9,9,RB
4876,Bernie Parmalee,18,28,46,1997,30,MIA,16,4,18,59,3.3,0,3.7,5,38.9,35,28,301,10.8,1,18.8,80,8.6,17,65.7,46,59,360,358,0,RB
4877,Erric Pegram,28,21,49,1997,28,"NYG,SDG",15,0,28,95,3.4,2,6.3,5,35.7,29,21,90,4.3,0,6,72.4,3.1,4,20.7,49,95,185,567,382,RB
4878,Lawrence Phillips,201,11,212,1997,22,"MIA,STL",12,9,201,677,3.4,8,56.4,40,41.3,19,11,39,3.5,0,3.3,57.9,2.1,2,21.1,212,677,716,716,0,RB
4879,Roosevelt Potts,2,3,5,1997,26,"IND,MIA",8,1,2,4,2,0,0.5,0,0,5,3,27,9,0,3.4,60,5.4,2,40,5,4,31,47,16,RB
4880,Stanley Pritchett,3,5,8,1997,24,MIA,6,5,3,7,2.3,0,1.2,0,0,8,5,35,7,0,5.8,62.5,4.4,2,37.5,8,7,42,42,0,FB
4881,Errict Rhett,31,0,31,1997,27,TAM,11,0,31,96,3.1,3,8.7,8,41.9,0,0,0,,0,0,,,0,,31,96,96,112,16,RB
4882,Tony Richardson,2,3,5,1997,26,KAN,14,0,2,11,5.5,0,0.8,1,100,3,3,6,2,3,0.4,100,2,3,100,5,11,17,17,0,FB
4883,Ron Rivers,29,0,29,1997,26,DET,16,0,29,166,5.7,1,10.4,6,48.3,0,0,0,,0,0,,,0,,29,166,166,200,34,RB
4884,Rashaan Salaam,31,2,33,1997,23,CHI,3,3,31,112,3.6,0,37.3,4,32.3,3,2,20,10,0,6.7,66.7,6.7,1,33.3,33,112,132,132,0,RB
4885,Barry Sanders,335,33,368,1997,29,DET,16,16,335,2053,6.1,11,128.3,86,45.1,50,33,305,9.2,3,19.1,66,6.1,12,42,368,2053,2358,2358,0,RB
4886,Cory Schlesinger,7,5,12,1997,25,DET,16,2,7,11,1.6,0,0.7,0,14.3,7,5,69,13.8,1,4.3,71.4,9.9,3,42.9,12,11,80,80,0,FB
4887,Sedrick Shaw,0,0,0,1997,24,NWE,1,0,0,0,,0,0,0,,1,0,0,,0,0,0,0,0,0,0,0,0,0,0,RB
4888,Daimon Shelton,6,0,6,1997,25,JAX,13,0,6,4,0.7,0,0.3,0,0,0,0,0,,0,0,,,0,,6,4,4,4,0,FB
4889,Antowain Smith,194,28,222,1997,25,BUF,16,0,194,840,4.3,8,52.5,46,44.3,47,28,177,6.3,0,11.1,59.6,3.8,10,34,222,840,1017,1017,0,RB
4890,Cedric Smith,4,2,6,1997,29,ARI,16,3,4,5,1.3,1,0.3,1,50,3,2,20,10,0,1.3,66.7,6.7,1,33.3,6,5,25,75,50,FB
4891,Detron Smith,4,4,8,1997,23,DEN,16,0,4,10,2.5,0,0.6,1,25,5,4,41,10.3,1,2.6,80,8.2,2,60,8,10,51,51,0,RB
4892,Emmitt Smith,261,40,301,1997,28,DAL,16,16,261,1074,4.1,4,67.1,52,44.4,48,40,234,5.9,0,14.6,83.3,4.9,6,35.4,301,1074,1308,1308,0,RB
4893,Lamar Smith,91,23,114,1997,27,SEA,12,2,91,392,4.3,2,32.7,25,45.1,28,23,183,8,0,15.3,82.1,6.5,10,50,114,392,575,589,14,RB
4894,Robert Smith,232,37,269,1997,25,MIN,14,14,232,1266,5.5,6,90.4,45,46.1,44,37,197,5.3,1,14.1,84.1,4.5,10,36.4,269,1266,1463,1463,0,RB
4895,Jerald Sowell,7,1,8,1997,23,NYJ,9,0,7,35,5,0,3.9,3,85.7,2,1,8,8,0,0.9,50,4,1,50,8,35,43,43,0,FB
4896,Irving Spikes,63,7,70,1997,27,MIA,12,1,63,180,2.9,2,15,9,33.3,10,7,70,10,0,5.8,70,7,3,70,70,180,250,815,565,RB
4897,Duce Staley,7,2,9,1997,22,PHI,16,0,7,29,4.1,0,1.8,2,42.9,3,2,22,11,0,1.4,66.7,7.3,1,33.3,9,29,51,1190,1139,RB
4898,James Stewart,136,41,177,1997,26,JAX,16,5,136,555,4.1,8,34.7,39,47.8,49,41,336,8.2,1,21,83.7,6.9,16,51,177,555,891,891,0,RB
4899,Mack Strong,4,13,17,1997,26,SEA,16,9,4,8,2,0,0.5,3,75,21,13,91,7,2,5.7,61.9,4.3,6,42.9,17,8,99,115,16,FB
4900,Nicky Sualua,0,0,0,1997,22,DAL,10,1,0,0,,0,0,0,,0,0,0,,0,0,,,0,,0,0,0,0,0,RB
4901,David Thompson,16,0,16,1997,22,STL,11,0,16,30,1.9,1,2.7,2,25,2,0,0,,0,0,0,0,0,0,16,30,30,1140,1110,RB
4902,Rodney Thomas,67,14,81,1997,24,TEN,16,1,67,310,4.6,3,19.4,16,44.8,18,14,111,7.9,0,6.9,77.8,6.2,5,38.9,81,310,421,767,346,RB
4903,Thurman Thomas,154,30,184,1997,31,BUF,16,16,154,643,4.2,1,40.2,33,41.6,43,30,208,6.9,0,13,69.8,4.8,8,44.2,184,643,851,851,0,RB
4904,Tim Tindale,0,4,4,1997,26,BUF,7,0,0,0,,0,0,0,,5,4,105,26.3,0,15,80,21,2,80,4,0,105,105,0,FB
4905,Kevin Turner,18,48,66,1997,28,PHI,16,10,18,96,5.3,0,6,5,61.1,62,48,443,9.2,3,27.7,77.4,7.1,24,53.2,66,96,539,587,48,FB
4906,Tommy Vardell,32,16,48,1997,28,DET,16,10,32,122,3.8,6,7.6,14,56.3,30,16,218,13.6,0,13.6,53.3,7.3,9,33.3,48,122,340,355,15,FB
4907,Tony Vinson,0,0,0,1997,26,BAL,13,0,0,0,,0,0,0,,0,0,0,,0,0,,,0,,0,0,0,0,0,RB
4908,Herschel Walker,6,14,20,1997,35,DAL,16,6,6,20,3.3,0,1.3,2,33.3,23,14,149,10.6,2,9.3,60.9,6.5,7,43.5,20,20,169,1336,1167,FB
4909,Chris Warren,200,45,245,1997,29,SEA,15,13,200,847,4.2,4,56.5,40,46.5,54,45,257,5.7,0,17.1,83.3,4.8,12,42.6,245,847,1104,1104,0,RB
4910,Lamont Warren,28,20,48,1997,24,IND,13,0,28,80,2.9,2,6.2,7,50,26,20,192,9.6,0,14.8,76.9,7.4,9,50,48,80,272,291,19,RB
4911,Ricky Watters,285,48,333,1997,28,PHI,16,16,285,1110,3.9,7,69.4,53,43.9,73,48,440,9.2,0,27.5,65.8,6,20,43.8,333,1110,1550,1550,0,RB
4912,Charles Way,151,37,188,1997,25,NYG,16,16,151,698,4.6,4,43.6,38,50.3,51,37,304,8.2,1,19,72.5,6,12,45.1,188,698,1002,1048,46,FB
4913,Tyrone Wheatley,152,16,168,1997,25,NYG,14,7,152,583,3.8,4,41.6,34,42.1,25,16,140,8.8,0,10,64,5.6,5,40,168,583,723,723,0,RB
4914,Harvey Williams,18,16,34,1997,30,OAK,14,6,18,70,3.9,3,5,6,61.1,39,16,147,9.2,2,10.5,41,3.8,7,28.2,34,70,217,217,0,FB
4915,Moe Williams,22,4,26,1997,23,MIN,14,0,22,59,2.7,1,4.2,5,45.5,5,4,14,3.5,0,1,80,2.8,0,40,26,59,73,461,388,RB
4916,Sherman Williams,121,21,142,1997,24,DAL,16,0,121,468,3.9,2,29.3,25,43,28,21,159,7.6,0,9.9,75,5.7,6,57.1,142,468,627,627,0,RB
4917,Derrick Witherspoon,0,0,0,1997,26,PHI,3,0,0,0,,0,0,0,,0,0,0,,0,0,,,0,,0,0,0,171,171,RB
4918,Jon Witman,5,1,6,1997,25,PIT,16,2,5,11,2.2,0,0.7,0,0,4,1,3,3,0,0.2,25,0.8,0,0,6,11,14,14,0,RB
4919,Ray Zellars,156,31,187,1997,24,NOR,16,16,156,552,3.5,4,34.5,30,40.4,43,31,263,8.5,0,16.4,72.1,6.1,6,37.2,187,552,815,815,0,FB
4920,Karim Abdul-Jabbar,307,23,330,1996,22,MIA,16,14,307,1116,3.6,11,69.8,68,46.3,46,23,139,6,0,8.7,50,3,6,34.8,330,1113,1255,1255,0,RB
4921,Marcus Allen,206,27,233,1996,36,KAN,16,15,206,830,4,9,51.9,56,50.5,35,27,270,10,0,16.9,77.1,7.7,13,60,233,830,1100,1100,0,RB
4922,Terry Allen,347,32,379,1996,28,WAS,16,16,347,1353,3.9,21,84.6,75,42.7,42,32,194,6.1,0,12.1,76.2,4.6,7,38.1,379,1353,1547,1547,0,RB
4923,Mike Alstott,96,65,161,1996,23,TAM,16,16,96,377,3.9,3,23.6,22,45.8,81,65,557,8.6,3,34.8,80.2,6.9,27,64.2,161,377,934,948,14,FB
4924,Jamal Anderson,232,49,281,1996,24,ATL,16,12,232,1055,4.5,5,65.9,46,47.4,67,49,473,9.7,1,29.6,73.1,7.1,19,49.3,281,1055,1528,1608,80,RB
4925,Kimble Anders,54,60,114,1996,30,KAN,16,15,54,201,3.7,2,12.6,12,38.9,88,60,529,8.8,2,33.1,68.2,6,25,44.3,114,201,730,767,37,FB
4926,Richie Anderson,47,44,91,1996,25,NYJ,16,13,47,150,3.2,1,9.4,15,51.1,71,44,385,8.8,0,24.1,62,5.4,16,33.8,91,150,535,535,0,FB
4927,Mike Archie,0,0,0,1996,24,HOU,2,0,0,0,,0,0,0,,0,0,0,,0,0,,,0,,0,0,0,24,24,RB
4928,Joe Aska,62,8,70,1996,24,OAK,15,2,62,326,5.3,1,21.7,14,35.5,12,8,63,7.9,0,4.2,66.7,5.3,4,50,70,326,389,406,17,RB
4929,Randy Baldwin,0,0,0,1996,29,BAL,9,0,0,0,,0,0,0,,0,0,0,,0,0,,,0,,0,0,0,405,405,RB
4930,Mario Bates,164,13,177,1996,23,NOR,14,10,164,584,3.6,4,41.7,33,38.4,16,13,44,3.4,0,3.1,81.3,2.8,2,31.3,177,584,628,628,0,RB
4931,Michael Bates,0,0,0,1996,27,CAR,14,0,0,0,,0,0,0,,0,0,0,,0,0,,,0,,0,0,0,998,998,RB
4932,William Bell,0,3,3,1996,25,WAS,16,0,0,0,,0,0,0,,5,3,23,7.7,0,1.4,60,4.6,2,40,3,0,23,153,130,RB
4933,Carey Bender,0,0,0,1996,24,BUF,1,0,0,0,,0,0,0,,0,0,0,,0,0,,,0,,0,0,0,0,0,RB
4934,Donnell Bennett,36,8,44,1996,24,KAN,16,0,36,166,4.6,0,10.4,5,36.1,14,8,21,2.6,0,1.3,57.1,1.5,1,21.4,44,166,187,187,0,RB
4935,Edgar Bennett,222,31,253,1996,27,GNB,16,15,222,899,4,2,56.2,53,48.2,39,31,176,5.7,1,11,79.5,4.5,7,46.2,253,899,1075,1075,0,RB
4936,Jerome Bettis,320,22,342,1996,24,PIT,16,12,320,1431,4.5,11,89.4,77,51.3,32,22,122,5.5,0,7.6,68.8,3.8,6,37.5,342,1431,1553,1553,0,RB
4937,Tim Biakabutuka,71,0,71,1996,22,CAR,4,4,71,229,3.2,0,57.3,10,38,0,0,0,,0,0,,,0,,71,229,229,229,0,RB
4938,Eric Bieniemy,56,32,88,1996,27,CIN,16,0,56,269,4.8,2,16.8,21,48.2,46,32,272,8.5,0,17,69.6,5.9,13,43.5,88,269,541,541,0,RB
4939,Kevin Bouie,0,0,0,1996,25,SDG,1,0,0,0,,0,0,0,,0,0,0,,0,0,,,0,,0,0,0,0,0,RB
4940,Larry Bowie,0,3,3,1996,23,WAS,3,0,0,0,,0,0,0,,4,3,17,5.7,0,5.7,75,4.3,0,0,3,0,17,17,0,RB
4941,Freddie Bradley,32,1,33,1996,26,SDG,10,1,32,109,3.4,0,10.9,5,37.5,2,1,20,20,0,2,50,10,1,50,33,109,129,129,0,RB
4942,Jason Bratton,4,0,4,1996,24,BUF,2,0,4,8,2,0,4,1,50,0,0,0,,0,0,,,0,,4,8,8,8,0,RB
4943,Reggie Brooks,112,3,115,1996,25,TAM,11,4,112,368,3.3,2,33.5,19,39.3,6,3,13,4.3,0,1.2,50,2.2,1,33.3,115,368,381,381,0,RB
4944,Steve Broussard,15,6,21,1996,29,SEA,12,0,15,106,7.1,1,8.8,4,73.3,9,6,26,4.3,0,2.2,66.7,2.9,1,33.3,21,106,132,1111,979,RB
4945,Derek Brown,13,8,21,1996,25,NOR,11,0,13,30,2.3,0,2.7,1,7.7,20,8,54,6.8,0,4.9,40,2.7,2,15,21,30,84,94,10,RB
4946,Reggie Brown,0,0,0,1996,23,SEA,7,0,0,0,,0,0,0,,0,0,0,,0,0,,,0,,0,0,0,51,51,RB
4947,Earnest Byner,159,30,189,1996,34,BAL,16,8,159,634,4,4,39.6,35,50.9,44,30,270,9,1,16.9,68.2,6.1,8,34.1,189,634,904,965,61,RB
4948,Dexter Carter,19,0,19,1996,29,SFO,16,0,19,66,3.5,1,4.1,6,52.6,1,0,0,,0,0,0,0,0,0,19,66,66,1292,1226,RB
4949,Ki-Jana Carter,91,22,113,1996,23,CIN,16,4,91,264,2.9,8,16.5,21,37.4,35,22,169,7.7,1,10.6,62.9,4.8,7,40,113,264,433,425,0,RB
4950,Tony Carter,11,41,52,1996,24,CHI,16,11,11,43,3.9,0,2.7,5,54.5,59,41,233,5.7,0,14.6,69.5,3.9,8,44.1,52,43,276,276,0,FB
4951,Larry Centers,116,99,215,1996,28,ARI,16,14,116,425,3.7,2,26.6,20,39.7,130,99,766,7.7,7,47.9,76.2,5.9,46,51.5,215,425,1191,1191,0,FB
4952,Ryan Christopherson,0,0,0,1996,24,"ARI,JAX",8,0,0,0,,0,0,0,,0,0,0,,0,0,,,0,,0,0,0,0,0,RB
4953,Reggie Cobb,25,4,29,1996,28,NYJ,15,0,25,85,3.4,1,5.7,5,52,4,4,23,5.8,0,1.5,100,5.8,1,50,29,85,108,596,488,RB
4954,Jeff Cothran,15,7,22,1996,25,CIN,11,11,15,44,2.9,1,4,4,46.7,10,7,49,7,0,4.5,70,4.9,3,40,22,44,93,104,11,FB
4955,Aaron Craver,59,39,98,1996,28,DEN,15,15,59,232,3.9,2,15.5,9,47.5,51,39,297,7.6,1,19.8,76.5,5.8,13,49,98,232,529,529,0,FB
4956,Zack Crockett,31,11,42,1996,24,IND,5,5,31,164,5.3,0,32.8,6,61.3,15,11,96,8.7,1,19.2,73.3,6.4,4,60,42,164,260,260,0,FB
4957,Lou D'Agostino,0,0,0,1996,23,NYJ,9,0,0,0,,0,0,0,,0,0,0,,0,0,,,0,,0,0,0,0,0,FB
4958,Jerone Davison,0,4,4,1996,26,OAK,2,0,0,0,,0,0,0,,5,4,21,5.3,0,10.5,80,4.2,0,0,4,0,21,21,0,RB
4959,Stephen Davis,23,0,23,1996,22,WAS,12,0,23,139,6,2,11.6,7,56.5,0,0,0,,0,0,,,0,,23,139,139,139,0,RB
4960,Terrell Davis,345,36,381,1996,24,DEN,16,16,345,1538,4.5,13,96.1,91,44.6,52,36,310,8.6,2,19.4,69.2,6,16,51.9,381,1538,1848,1848,0,RB
4961,Gary Downs,29,3,32,1996,24,NYG,6,1,29,94,3.2,0,15.7,4,34.5,5,3,20,6.7,0,3.3,60,4,0,20,32,94,114,114,0,RB
4962,Mike Dulaney,0,1,1,1996,26,CHI,16,0,0,0,,0,0,0,,1,1,1,1,1,0.1,100,1,0,0,1,0,1,64,63,RB
4963,Keith Elias,9,8,17,1996,24,NYG,9,0,9,24,2.7,0,2.7,0,11.1,11,8,51,6.4,0,5.7,72.7,4.6,1,36.4,17,24,75,75,0,RB
4964,Jerry Ellison,35,18,53,1996,25,TAM,16,2,35,106,3,0,6.6,9,31.4,25,18,208,11.6,0,13,72,8.3,9,44,53,106,314,314,0,RB
4965,Charles Evans,13,22,35,1996,29,MIN,16,6,13,29,2.2,0,1.8,0,0,25,22,135,6.1,0,8.4,88,5.4,0,0,35,29,164,164,0,FB
4966,Marshall Faulk,198,56,254,1996,23,IND,13,13,198,587,3,7,45.2,42,39.9,80,56,428,7.6,0,32.9,70,5.4,18,47.5,254,587,1015,1015,0,RB
4967,Derrick Fenner,67,31,98,1996,29,OAK,16,11,67,245,3.7,4,15.3,23,52.2,45,31,252,8.1,4,15.8,68.9,5.6,12,48.9,98,245,497,497,0,FB
4968,Terrell Fletcher,77,61,138,1996,23,SDG,16,0,77,282,3.7,0,17.6,14,39,86,61,476,7.8,2,29.8,70.9,5.5,21,41.9,138,282,758,758,0,RB
4969,William Floyd,47,26,73,1996,24,SFO,9,8,47,186,4,2,20.7,16,53.2,36,26,197,7.6,1,21.9,72.2,5.5,8,41.7,73,186,383,383,0,FB
4970,Carwell Gardner,26,7,33,1996,30,BAL,13,3,26,108,4.2,0,8.3,4,57.7,10,7,28,4,0,2.2,70,2.8,0,20,33,108,136,136,0,FB
4971,Charlie Garner,66,14,80,1996,24,PHI,15,1,66,346,5.2,1,23.1,18,57.6,17,14,92,6.6,0,6.1,82.4,5.4,4,64.7,80,346,438,555,117,RB
4972,Sam Gash,8,33,41,1996,27,NWE,14,9,8,15,1.9,0,1.1,1,12.5,44,33,276,8.4,2,19.7,75,6.3,15,59.1,41,15,291,291,0,FB
4973,Eddie George,335,23,358,1996,23,HOU,16,16,335,1368,4.1,8,85.5,68,46.6,28,23,182,7.9,0,11.4,82.1,6.5,12,57.1,358,1368,1550,1550,0,RB
4974,Roger Graham,0,0,0,1996,24,JAX,1,0,0,0,,0,0,0,,0,0,0,,0,0,,,0,,0,0,0,0,0,RB
4975,Scottie Graham,57,7,64,1996,27,MIN,11,0,57,138,2.4,0,12.5,4,35.1,9,7,48,6.9,0,4.4,77.8,5.3,2,44.4,64,138,186,186,0,RB
4976,Oscar Gray,2,1,3,1996,24,SEA,9,0,2,4,2,0,0.4,1,50,3,1,5,5,0,0.6,33.3,1.7,0,33.3,3,4,9,9,0,RB
4977,Harold Green,127,37,164,1996,28,STL,16,5,127,523,4.1,4,32.7,30,48,58,37,246,6.6,1,15.4,63.8,4.2,15,37.9,164,523,769,769,0,RB
4978,Robert Green,60,13,73,1996,26,CHI,10,3,60,249,4.2,0,24.9,11,33.3,24,13,78,6,0,7.8,54.2,3.3,2,16.7,73,249,327,327,0,RB
4979,Scott Greene,0,2,2,1996,24,CAR,8,0,0,0,,0,0,0,,2,2,7,3.5,1,0.9,100,3.5,1,100,2,0,7,17,10,RB
4980,Marrio Grier,27,1,28,1996,25,NWE,16,0,27,105,3.9,1,6.6,8,33.3,1,1,8,8,0,0.5,100,8,0,100,28,105,113,117,0,RB
4981,Howard Griffith,12,27,39,1996,29,CAR,16,14,12,7,0.6,1,0.4,1,8.3,48,27,223,8.3,1,13.9,56.3,4.6,11,41.7,39,7,230,230,0,FB
4982,Clif Groce,46,13,59,1996,24,IND,15,8,46,184,4,0,12.3,8,39.1,32,13,106,8.2,0,7.1,40.6,3.3,5,34.4,59,184,290,308,18,FB
4983,Tim Hall,3,0,3,1996,22,OAK,2,0,3,7,2.3,0,3.5,0,0,0,0,0,,0,0,,,0,,3,7,7,7,0,RB
4984,Rodney Hampton,254,15,269,1996,27,NYG,15,15,254,827,3.3,1,55.1,46,40.6,22,15,82,5.5,0,5.5,68.2,3.7,4,40.9,269,827,909,909,0,RB
4985,Ronnie Harmon,29,42,71,1996,32,HOU,16,6,29,131,4.5,1,8.2,9,44.8,59,42,488,11.6,2,30.5,71.2,8.3,25,55.9,71,131,619,688,69,RB
4986,Derrick Harris,3,4,7,1996,24,STL,11,6,3,5,1.7,0,0.5,1,33.3,6,4,17,4.3,0,1.5,66.7,2.8,0,16.7,7,5,22,22,0,FB
4987,Raymont Harris,194,32,226,1996,26,CHI,12,10,194,748,3.9,4,62.3,40,42.3,43,32,296,9.3,1,24.7,74.4,6.9,14,44.2,226,748,1044,1044,0,RB
4988,Aaron Hayden,55,1,56,1996,23,SDG,11,0,55,166,3,0,15.1,11,45.5,4,1,10,10,0,0.9,25,2.5,1,25,56,166,176,176,0,RB
4989,Garrison Hearst,225,12,237,1996,25,CIN,16,12,225,847,3.8,0,52.9,42,50.2,22,12,131,10.9,1,8.2,54.5,6,7,45.5,237,847,978,978,0,RB
4990,Vaughn Hebron,49,7,56,1996,26,DEN,16,0,49,262,5.3,0,16.4,10,46.9,11,7,43,6.1,0,2.7,63.6,3.9,2,27.3,56,262,305,1404,1099,RB
4991,William Henderson,39,27,66,1996,25,GNB,16,11,39,130,3.3,0,8.1,12,53.8,33,27,203,7.5,1,12.7,81.8,6.2,12,45.5,66,130,333,371,38,FB
4992,Chris Hetherington,0,0,0,1996,24,IND,6,0,0,0,,0,0,0,,0,0,0,,0,0,,,0,,0,0,0,16,16,FB
4993,Craig Heyward,72,16,88,1996,30,ATL,15,5,72,321,4.5,3,21.4,16,52.8,19,16,168,10.5,0,11.2,84.2,8.8,8,57.9,88,321,489,507,18,RB
4994,Michael Hicks,27,1,28,1996,23,CHI,4,0,27,92,3.4,0,23,4,40.7,1,1,-1,-1,0,-0.3,100,-1,0,0,28,92,91,91,0,RB
4995,Greg Hill,135,3,138,1996,24,KAN,15,1,135,645,4.8,4,43,35,49.6,5,3,60,20,1,4,60,12,3,60,138,645,705,705,0,RB
4996,Leroy Hoard,125,11,136,1996,28,"CAR,MIN,BAL",11,7,125,492,3.9,3,44.7,32,46.4,16,11,133,12.1,0,12.1,68.8,8.3,5,56.3,136,492,625,644,19,RB
4997,Marcus Holliday,0,0,0,1996,23,STL,1,0,0,0,,0,0,0,,0,0,0,,0,0,,,0,,0,0,0,0,0,RB
4998,Darick Holmes,189,16,205,1996,25,BUF,16,1,189,571,3,4,35.7,39,42.9,21,16,102,6.4,1,6.4,76.2,4.9,6,38.1,205,571,673,673,0,RB
4999,Earnest Hunter,15,18,33,1996,26,"NOR,BAL",11,0,15,44,2.9,0,4,2,40,23,18,163,9.1,0,14.8,78.3,7.1,6,39.1,33,44,207,405,198,RB
5000,Richard Huntley,2,1,3,1996,24,ATL,1,0,2,8,4,0,8,0,100,1,1,14,14,0,14,100,14,1,100,3,8,22,22,0,RB
5001,Dou Innocent,0,0,0,1996,24,SEA,4,0,0,0,,0,0,0,,0,0,0,,0,0,,,0,,0,0,0,0,0,RB
5002,Travis Jervey,26,0,26,1996,24,GNB,16,0,26,106,4.1,0,6.6,5,46.2,0,0,0,,0,0,,,0,,26,106,106,123,17,RB
5003,Anthony Johnson,300,26,326,1996,29,CAR,16,11,300,1120,3.7,6,70,63,45.7,33,26,192,7.4,0,12,78.8,5.8,5,45.5,326,1120,1312,1312,0,RB
5004,Daryl Johnston,22,43,65,1996,30,DAL,16,15,22,48,2.2,0,3,6,50,55,43,278,6.5,1,17.4,78.2,5.1,8,36.4,65,48,326,326,0,FB
5005,LeShon Johnson,141,15,156,1996,25,ARI,15,8,141,634,4.5,3,42.3,22,37.6,20,15,176,11.7,1,11.7,75,8.8,10,65,156,634,810,1008,198,RB
5006,Tracy Johnson,0,0,0,1996,30,TAM,10,0,0,0,,0,0,0,,0,0,0,,0,0,,,0,,0,0,0,0,0,RB
5007,Calvin Jones,0,0,0,1996,26,GNB,1,0,0,0,,0,0,0,,0,0,0,,0,0,,,0,,0,0,0,0,0,RB
5008,Randy Jordan,0,0,0,1996,26,JAX,15,0,0,0,,0,0,0,,0,0,0,,0,0,,,0,,0,0,0,553,553,RB
5009,Napoleon Kaufman,150,22,172,1996,23,OAK,16,9,150,874,5.8,1,54.6,33,48,26,22,143,6.5,1,8.9,84.6,5.5,7,38.5,172,874,1017,1565,548,RB
5010,Terry Kirby,134,52,186,1996,26,SFO,14,10,134,559,4.2,3,39.9,25,41.8,69,52,439,8.4,1,31.4,75.4,6.4,17,43.5,186,583,998,1023,25,RB
5011,Amp Lee,51,54,105,1996,25,MIN,16,3,51,161,3.2,0,10.1,5,31.4,71,54,422,7.8,2,26.4,76.1,5.9,25,46.5,105,161,583,752,169,RB
5012,Tim Lester,8,7,15,1996,28,PIT,16,13,8,20,2.5,1,1.3,2,50,14,7,70,10,0,4.4,50,5,5,50,15,20,90,90,0,FB
5013,Dorsey Levens,121,31,152,1996,26,GNB,16,1,121,566,4.7,5,35.4,32,51.2,33,31,226,7.3,5,14.1,93.9,6.8,14,63.6,152,566,792,876,84,RB
5014,Marc Logan,20,23,43,1996,31,WAS,14,9,20,111,5.6,2,7.9,8,55,34,23,269,11.7,0,19.2,67.6,7.9,13,50,43,111,380,380,0,FB
5015,Derek Loville,70,16,86,1996,28,SFO,12,6,70,229,3.3,2,19.1,15,41.4,26,16,138,8.6,2,11.5,61.5,5.3,4,30.8,86,229,367,596,229,RB
5016,Eric Lynch,2,0,2,1996,26,DET,16,0,2,2,1,0,0.1,0,0,0,0,0,,0,0,,,0,,2,2,2,17,15,RB
5017,Anthony Lynn,24,2,26,1996,28,SFO,16,1,24,164,6.8,0,10.3,6,45.8,4,2,14,7,0,0.9,50,3.5,0,50,26,164,178,178,0,RB
5018,Curtis Martin,316,46,362,1996,23,NWE,16,15,316,1152,3.6,14,72,79,46.5,52,46,333,7.2,3,20.8,88.5,6.4,15,51.9,362,1152,1485,1485,0,RB
5019,Le'Shai Maston,8,6,14,1996,26,JAX,15,7,8,22,2.8,0,1.5,1,62.5,11,6,54,9,0,3.6,54.5,4.9,3,45.5,14,22,76,76,0,FB
5020,Sherriden May,0,0,0,1996,23,NYJ,8,0,0,0,,0,0,0,,0,0,0,,0,0,,,0,,0,0,0,0,0,RB
5021,Fred McAfee,7,5,12,1996,28,PIT,14,0,7,17,2.4,0,1.2,0,14.3,6,5,21,4.2,0,1.5,83.3,3.5,1,16.7,12,17,38,38,0,RB
5022,Leeland McElroy,89,5,94,1996,22,ARI,16,6,89,305,3.4,1,19.1,10,43.8,10,5,41,8.2,1,2.6,50,4.1,4,40,94,305,346,1494,1148,RB
5023,Todd McNair,9,21,30,1996,31,KAN,16,0,9,32,3.6,0,2,0,22.2,28,21,181,8.6,1,11.3,75,6.5,12,53.6,30,32,213,234,21,RB
5024,Jerris McPhail,6,20,26,1996,24,MIA,9,1,6,28,4.7,0,3.1,2,50,29,20,282,14.1,0,31.3,69,9.7,14,48.3,26,28,310,645,335,RB
5025,Natrone Means,152,7,159,1996,24,JAX,14,4,152,507,3.3,2,36.2,27,44.1,9,7,45,6.4,1,3.2,77.8,5,3,55.6,159,507,552,552,0,RB
5026,Dave Meggett,40,33,73,1996,30,NWE,16,1,40,122,3.1,0,7.6,0,0,57,33,292,8.8,0,18.3,57.9,5.1,0,0,73,122,414,1783,1369,RB
5027,Arnold Mickens,0,0,0,1996,24,IND,3,0,0,0,,0,0,0,,0,0,0,,0,0,,,0,,0,0,0,0,0,RB
5028,Brian Milne,8,3,11,1996,23,CIN,6,5,8,22,2.8,1,3.7,2,37.5,4,3,29,9.7,0,4.8,75,7.3,1,75,11,22,51,51,0,RB
5029,Brian Mitchell,39,32,71,1996,28,WAS,16,2,39,193,4.9,0,12.1,11,35.9,40,32,286,8.9,0,17.9,80,7.2,13,37.5,71,193,479,1995,1516,RB
5030,Jerald Moore,11,3,14,1996,22,STL,11,4,11,32,2.9,0,2.9,1,45.5,7,3,13,4.3,0,1.2,42.9,1.9,1,28.6,14,32,45,45,0,RB
5031,Ronald Moore,1,0,1,1996,26,NYJ,16,0,1,1,1,0,0.1,0,0,0,0,0,,0,0,,,0,,1,1,1,119,118,RB
5032,Bam Morris,172,25,197,1996,24,BAL,11,7,172,737,4.3,4,67,46,53.5,31,25,242,9.7,1,22,80.6,7.8,13,48.4,197,737,979,982,3,RB
5033,Harold Morrow,0,0,0,1996,23,MIN,8,0,0,0,,0,0,0,,0,0,0,,0,0,,,0,,0,0,0,117,117,FB
5034,Adrian Murrell,301,17,318,1996,26,NYJ,16,16,301,1249,4.1,6,78.1,65,44.9,36,17,81,4.8,1,5.1,47.2,2.3,3,22.2,318,1249,1330,1314,0,RB
5035,Lorenzo Neal,21,31,52,1996,26,NOR,16,11,21,58,2.8,1,3.6,5,52.4,42,31,194,6.3,1,12.1,73.8,4.6,10,47.6,52,58,252,252,0,FB
5036,Winslow Oliver,47,15,62,1996,23,CAR,16,0,47,183,3.9,0,11.4,7,29.8,22,15,144,9.6,0,9,68.2,6.5,6,36.4,62,183,327,1085,758,RB
5037,Bernie Parmalee,25,21,46,1996,29,MIA,16,0,25,80,3.2,0,5,3,36,27,21,189,9,0,11.8,77.8,7,9,44.4,46,80,269,269,0,RB
5038,Erric Pegram,97,17,114,1996,27,PIT,12,4,97,509,5.2,1,42.4,30,55.7,27,17,112,6.6,0,9.3,63,4.1,9,44.4,114,509,621,1040,419,RB
5039,Dino Philyaw,12,0,12,1996,26,CAR,9,0,12,38,3.2,1,4.2,3,50,0,0,0,,0,0,,,0,,12,38,38,38,0,RB
5040,Lawrence Phillips,193,8,201,1996,21,STL,15,11,193,632,3.3,4,42.1,32,34.7,12,8,28,3.5,1,1.9,66.7,2.3,3,33.3,201,620,660,734,74,RB
5041,Stanley Pritchett,7,33,40,1996,23,MIA,16,16,7,27,3.9,0,1.7,2,28.6,50,33,354,10.7,2,22.1,66,7.1,11,38,40,27,381,381,0,FB
5042,Errict Rhett,176,4,180,1996,26,TAM,9,7,176,539,3.1,3,59.9,30,43.2,4,4,11,2.8,1,1.2,100,2.8,1,25,180,539,550,550,0,RB
5043,Terry Richardson,5,0,5,1996,25,PIT,1,0,5,17,3.4,0,17,2,40,0,0,0,,0,0,,,0,,5,17,17,17,0,RB
5044,Tony Richardson,4,2,6,1996,25,KAN,13,0,4,10,2.5,0,0.8,2,50,2,2,18,9,1,1.4,100,9,2,100,6,10,28,28,0,FB
5045,Reggie Rivers,2,1,3,1996,28,DEN,16,0,2,6,3,0,0.4,0,0,1,1,-1,-1,0,-0.1,100,-1,0,0,3,6,5,5,0,RB
5046,Ron Rivers,19,2,21,1996,25,DET,15,0,19,86,4.5,0,5.7,7,47.4,2,2,28,14,0,1.9,100,14,1,100,21,86,114,122,8,RB
5047,Greg Robinson,32,1,33,1996,27,STL,11,0,32,134,4.2,1,12.2,7,43.8,2,1,6,6,0,0.5,50,3,0,50,33,134,140,140,0,RB
5048,Dominique Ross,0,0,0,1996,24,DAL,2,0,0,0,,0,0,0,,0,0,0,,0,0,,,0,,0,0,0,0,0,RB
5049,Leonard Russell,219,13,232,1996,27,SDG,15,15,219,713,3.3,7,47.5,45,39.3,18,13,180,13.8,0,12,72.2,10,7,50,232,713,893,896,10,RB
5050,Rashaan Salaam,143,7,150,1996,22,CHI,12,6,143,496,3.5,3,41.3,29,36.4,8,7,44,6.3,1,3.7,87.5,5.5,1,50,150,496,540,540,0,RB
5051,Barry Sanders,307,24,331,1996,28,DET,16,16,307,1553,5.1,11,97.1,81,50.2,32,24,147,6.1,0,9.2,75,4.6,6,37.5,331,1553,1700,1700,0,RB
5052,Brian Satterfield,0,0,0,1996,27,GNB,1,0,0,0,,0,0,0,,0,0,0,,0,0,,,0,,0,0,0,0,0,RB
5053,Cory Schlesinger,0,0,0,1996,24,DET,16,1,0,0,,0,0,0,,0,0,0,,0,0,,,0,,0,0,0,0,0,FB
5054,Cedric Smith,14,3,17,1996,28,ARI,15,2,14,15,1.1,1,1,4,28.6,3,3,3,1,1,0.2,100,1,1,33.3,17,15,18,32,14,FB
5055,Detron Smith,0,0,0,1996,22,DEN,13,0,0,0,,0,0,0,,0,0,0,,0,0,,,0,,0,0,0,0,0,RB
5056,Emmitt Smith,327,47,374,1996,27,DAL,15,15,327,1204,3.7,12,80.3,76,47.1,57,47,249,5.3,3,16.6,82.5,4.4,11,38.6,374,1204,1453,1453,0,RB
5057,Lamar Smith,153,9,162,1996,26,SEA,16,2,153,680,4.4,8,42.5,39,47.1,16,9,58,6.4,0,3.6,56.3,3.6,2,18.8,162,680,738,738,0,RB
5058,Robert Smith,162,7,169,1996,24,MIN,8,7,162,692,4.3,3,86.5,26,51.2,14,7,39,5.6,0,4.9,50,2.8,1,14.3,169,692,731,731,0,RB
5059,Irving Spikes,87,8,95,1996,26,MIA,15,1,87,316,3.6,3,21.1,17,40.2,11,8,81,10.1,1,5.4,72.7,7.4,4,54.5,95,316,397,1078,681,RB
5060,Robert Staten,0,0,0,1996,27,TAM,6,0,0,0,,0,0,0,,0,0,0,,0,0,,,0,,0,0,0,0,0,RB
5061,James Stewart,190,30,220,1996,25,JAX,13,11,190,723,3.8,8,55.6,36,43.2,40,30,177,5.9,2,13.6,75,4.4,7,35,220,723,900,900,0,RB
5062,Mack Strong,5,9,14,1996,25,SEA,14,8,5,8,1.6,0,0.6,0,0,13,9,78,8.7,0,5.6,69.2,6,4,53.8,14,8,86,86,0,FB
5063,Ryan Terry,0,1,1,1996,25,ARI,5,0,0,0,,0,0,0,,1,1,0,0,0,0,100,0,0,0,1,0,0,84,84,RB
5064,Leroy Thompson,14,5,19,1996,27,TAM,5,0,14,25,1.8,0,5,2,14.3,14,5,36,7.2,0,7.2,35.7,2.6,1,21.4,19,25,61,61,0,RB
5065,Rodney Thomas,49,13,62,1996,23,HOU,16,0,49,151,3.1,1,9.4,9,34.7,17,13,128,9.8,0,8,76.5,7.5,4,41.2,62,151,279,359,80,RB
5066,Thurman Thomas,281,26,307,1996,30,BUF,15,15,281,1033,3.7,8,68.9,69,46.3,42,26,254,9.8,0,16.9,61.9,6,9,38.1,307,1033,1287,1287,0,RB
5067,Tim Tindale,14,1,15,1996,25,BUF,14,3,14,49,3.5,0,3.5,3,50,3,1,-1,-1,0,-0.1,33.3,-0.3,0,0,15,49,48,48,0,FB
5068,Kevin Turner,18,43,61,1996,27,PHI,16,12,18,39,2.2,0,2.4,5,50,56,43,409,9.5,1,25.6,76.8,7.3,17,53.6,61,39,448,448,0,FB
5069,Tommy Vardell,58,28,86,1996,27,SFO,11,7,58,192,3.3,2,17.5,13,44.8,38,28,179,6.4,0,16.3,73.7,4.7,8,44.7,86,192,371,371,0,FB
5070,Adam Walker,0,0,0,1996,28,PHI,13,0,0,0,,0,0,0,,0,0,0,,0,0,,,0,,0,0,0,0,0,RB
5071,Herschel Walker,10,7,17,1996,34,DAL,16,1,10,83,8.3,1,5.2,4,40,10,7,89,12.7,0,5.6,70,8.9,5,60,17,83,172,951,779,RB
5072,Robert Walker,0,0,0,1996,24,NYG,1,0,0,0,,0,0,0,,0,0,0,,0,0,,,0,,0,0,0,0,0,RB
5073,Chris Warren,203,40,243,1996,28,SEA,14,14,203,855,4.2,5,61.1,32,37.4,46,40,273,6.8,0,19.5,87,5.9,11,41.3,243,855,1128,1132,0,RB
5074,Lamont Warren,67,22,89,1996,23,IND,13,3,67,230,3.4,1,17.7,13,40.3,34,22,174,7.9,0,13.4,64.7,5.1,8,41.2,89,230,404,458,54,RB
5075,Ricky Watters,353,51,404,1996,27,PHI,16,16,353,1411,4,13,88.2,72,47.6,70,51,444,8.7,0,27.8,72.9,6.3,19,50,404,1411,1855,1855,0,RB
5076,Charles Way,22,32,54,1996,24,NYG,16,12,22,79,3.6,1,4.9,4,45.5,45,32,328,10.3,1,20.5,71.1,7.3,17,60,54,79,407,426,19,FB
5077,Tyrone Wheatley,112,12,124,1996,24,NYG,14,0,112,400,3.6,1,28.6,21,37.5,17,12,51,4.3,2,3.6,70.6,3,5,41.2,124,424,451,936,503,RB
5078,Ricky Whittle,20,26,46,1996,25,NOR,10,0,20,52,2.6,0,5.2,3,20,34,26,162,6.2,0,16.2,76.5,4.8,5,26.5,46,52,214,214,0,RB
5079,Harvey Williams,121,22,143,1996,29,OAK,13,5,121,431,3.6,0,33.2,13,37.2,29,22,143,6.5,0,11,75.9,4.9,5,41.4,143,449,574,574,0,RB
5080,Moe Williams,0,0,0,1996,22,MIN,9,0,0,0,,0,0,0,,0,0,0,,0,0,,,0,,0,0,0,0,0,RB
5081,Sherman Williams,69,5,74,1996,23,DAL,16,1,69,269,3.9,0,16.8,9,43.5,11,5,41,8.2,0,2.6,45.5,3.7,2,36.4,74,269,310,310,0,RB
5082,Robert Wilson,1,2,3,1996,27,MIA,15,0,1,0,0,0,0,0,0,2,2,5,2.5,1,0.3,100,2.5,1,50,3,0,5,17,12,RB
5083,Derrick Witherspoon,0,0,0,1996,25,PHI,16,0,0,0,,0,0,0,,0,0,0,,0,0,,,0,,0,0,0,1271,1271,RB
5084,Jon Witman,17,2,19,1996,24,PIT,16,4,17,69,4.1,0,4.3,2,35.3,3,2,15,7.5,0,0.9,66.7,5,2,66.7,19,69,84,104,20,RB
5085,Vince Workman,24,4,28,1996,28,IND,9,0,24,70,2.9,0,7.8,4,37.5,4,4,36,9,0,4,100,9,1,75,28,70,106,106,0,RB
5086,Ray Zellars,120,9,129,1996,23,NOR,9,6,120,475,4,4,52.8,28,47.5,15,9,45,5,0,5,60,3,1,33.3,129,475,520,520,0,FB
5087,Marcus Allen,207,27,234,1995,35,KAN,16,15,207,890,4.3,5,55.6,51,53.6,42,27,210,7.8,0,13.1,64.3,5,11,40.5,234,890,1100,1100,0,RB
5088,Terry Allen,338,31,369,1995,27,WAS,16,16,338,1309,3.9,10,81.8,68,44.1,40,31,232,7.5,1,14.5,77.5,5.8,11,57.5,369,1309,1541,1541,0,RB
5089,Jamal Anderson,39,4,43,1995,23,ATL,16,0,39,161,4.1,1,10.1,10,53.8,6,4,42,10.5,0,2.6,66.7,7,2,50,43,161,203,744,541,RB
5090,Kimble Anders,58,55,113,1995,29,KAN,16,13,58,398,6.9,2,24.9,11,37.9,82,55,349,6.3,1,21.8,67.1,4.3,14,32.9,113,398,747,747,0,FB
5091,Richie Anderson,5,5,10,1995,24,NYJ,10,0,5,17,3.4,0,1.7,1,20,8,5,26,5.2,0,2.6,62.5,3.3,1,50,10,17,43,43,0,FB
5092,Joe Aska,0,0,0,1995,23,OAK,1,0,0,0,,0,0,0,,0,0,0,,0,0,,,0,,0,0,0,0,0,RB
5093,Steve Avery,1,11,12,1995,29,PIT,11,2,1,3,3,0,0.3,1,100,14,11,82,7.5,1,7.5,78.6,5.9,3,64.3,12,3,85,85,0,RB
5094,Johnny Bailey,36,38,74,1995,28,STL,12,1,36,182,5.1,2,15.2,15,63.9,55,38,265,7,0,22.1,69.1,4.8,12,38.2,74,182,447,586,139,RB
5095,Randy Baldwin,23,0,23,1995,28,CAR,7,2,23,61,2.7,0,8.7,2,39.1,0,0,0,,0,0,,,0,,23,61,61,377,316,RB
5096,Eric Ball,2,0,2,1995,29,OAK,16,0,2,10,5,0,0.6,0,0,0,0,0,,0,0,,,0,,2,10,10,10,0,RB
5097,Mario Bates,244,18,262,1995,22,NOR,16,16,244,951,3.9,7,59.4,50,45.1,21,18,114,6.3,0,7.1,85.7,5.4,1,52.4,262,951,1065,1065,0,RB
5098,Michael Bates,0,0,0,1995,26,CLE,13,0,0,0,,0,0,0,,1,0,0,,0,0,0,0,0,0,0,0,0,176,176,RB
5099,Brad Baxter,85,26,111,1995,28,NYJ,15,13,85,296,3.5,1,19.7,21,44.7,39,26,160,6.2,0,10.7,66.7,4.1,7,38.5,111,296,456,456,0,FB
5100,Tom Beer,0,0,0,1995,26,DET,16,0,0,0,,0,0,0,,0,0,0,,0,0,,,0,,0,0,0,0,0,RB
5101,William Bell,4,0,4,1995,24,WAS,16,0,4,13,3.3,0,0.8,0,0,0,0,0,,0,0,,,0,,4,13,13,134,121,RB
5102,Donnell Bennett,7,1,8,1995,23,KAN,3,1,7,11,1.6,0,3.7,3,28.6,1,1,12,12,0,4,100,12,1,100,8,11,23,23,0,RB
5103,Edgar Bennett,316,61,377,1995,26,GNB,16,16,316,1067,3.4,3,66.7,50,39.6,79,61,648,10.6,4,40.5,77.2,8.2,27,50.6,377,1067,1715,1715,0,FB
5104,Rod Bernstine,23,5,28,1995,30,DEN,3,3,23,76,3.3,1,25.3,4,47.8,8,5,54,10.8,0,18,62.5,6.8,2,37.5,28,76,130,130,0,FB
5105,Jerome Bettis,183,18,201,1995,23,STL,15,13,183,637,3.5,3,42.5,24,37.7,23,18,106,5.9,0,7.1,78.3,4.6,4,34.8,201,637,743,743,0,RB
5106,Eric Bieniemy,98,43,141,1995,26,CIN,16,1,98,381,3.9,3,23.8,19,40.8,60,43,424,9.9,0,26.5,71.7,7.1,20,53.3,141,381,805,1020,215,RB
5107,Reggie Brooks,2,0,2,1995,24,WAS,1,0,2,-2,-1,0,-2,0,0,0,0,0,,0,0,,,0,,2,-2,-2,-2,0,RB
5108,Steve Broussard,46,10,56,1995,28,SEA,15,1,46,222,4.8,1,14.8,14,47.8,18,10,94,9.4,0,6.3,55.6,5.2,4,27.8,56,222,316,1380,1064,RB
5109,Derek Brown,49,35,84,1995,24,NOR,16,0,49,159,3.2,1,9.9,5,26.5,49,35,266,7.6,1,16.6,71.4,5.4,12,36.7,84,159,425,425,0,RB
5110,Gary Brown,86,6,92,1995,26,HOU,10,4,86,293,3.4,0,29.3,16,46.5,8,6,16,2.7,0,1.6,75,2,0,25,92,293,309,309,0,RB
5111,Jason Burns,1,0,1,1995,23,CIN,1,0,1,1,1,0,1,0,0,0,0,0,,0,0,,,0,,1,1,1,1,0,RB
5112,Marion Butts,71,2,73,1995,29,HOU,12,2,71,185,2.6,4,15.4,24,56.3,2,2,10,5,0,0.8,100,5,0,50,73,185,195,209,14,RB
5113,Keith Byars,15,51,66,1995,32,MIA,16,16,15,44,2.9,1,2.8,6,46.7,70,51,362,7.1,2,22.6,72.9,5.2,18,48.6,66,44,406,406,0,FB
5114,Earnest Byner,115,61,176,1995,33,CLE,16,2,115,432,3.8,2,27,22,38.3,84,61,494,8.1,2,30.9,72.6,5.9,30,44,176,432,926,1024,98,RB
5115,Butler By'not'e,0,0,0,1995,23,CAR,7,0,0,0,,0,0,0,,0,0,0,,0,0,,,0,,0,0,0,335,335,RB
5116,Dexter Carter,7,2,9,1995,28,"NYJ,SFO",17,0,7,22,3.1,0,1.3,1,28.6,5,2,4,2,0,0.2,40,0.8,0,20,9,22,26,1562,1536,RB
5117,Tony Carter,10,40,50,1995,23,CHI,16,11,10,34,3.4,0,2.1,3,50,57,40,329,8.2,1,20.6,70.2,5.8,18,50.9,50,34,363,387,24,FB
5118,Larry Centers,78,101,179,1995,27,ARI,16,10,78,254,3.3,2,15.9,11,43.6,119,101,962,9.5,2,60.1,84.9,8.1,45,55.5,179,254,1216,1231,15,FB
5119,Bob Christian,41,29,70,1995,27,CAR,14,12,41,158,3.9,0,11.3,4,41.5,35,29,255,8.8,1,18.2,82.9,7.3,13,62.9,70,158,413,413,0,FB
5120,Ryan Christopherson,16,1,17,1995,23,JAX,11,0,16,16,1,1,1.5,6,31.3,1,1,-1,-1,0,-0.1,100,-1,0,0,17,16,15,15,0,RB
5121,Reggie Cobb,9,0,9,1995,27,JAX,1,0,9,18,2,0,18,2,55.6,1,0,0,,0,0,0,0,0,0,9,18,18,18,0,RB
5122,Jeff Cothran,16,8,24,1995,24,CIN,14,13,16,62,3.9,0,4.4,5,50,18,8,44,5.5,0,3.1,44.4,2.4,2,27.8,24,62,106,106,0,FB
5123,Aaron Craver,73,43,116,1995,27,DEN,16,10,73,333,4.6,5,20.8,26,61.6,57,43,369,8.6,1,23.1,75.4,6.5,21,52.6,116,333,702,752,50,FB
5124,Zack Crockett,1,2,3,1995,23,IND,16,0,1,0,0,0,0,0,0,4,2,35,17.5,0,2.2,50,8.8,2,50,3,0,35,35,0,FB
5125,Corey Croom,13,1,14,1995,24,NWE,13,1,13,54,4.2,0,4.2,2,53.8,1,1,8,8,0,0.6,100,8,0,100,14,54,62,62,0,RB
5126,Rodney Culver,47,5,52,1995,26,SDG,8,2,47,155,3.3,3,19.4,15,53.2,5,5,21,4.2,0,2.6,100,4.2,1,40,52,155,176,176,0,RB
5127,Terrell Davis,237,49,286,1995,23,DEN,14,14,237,1117,4.7,7,79.8,58,50.2,82,49,367,7.5,1,26.2,59.8,4.5,19,39,286,1117,1484,1484,0,RB
5128,Gary Downs,0,0,0,1995,23,DEN,2,0,0,0,,0,0,0,,0,0,0,,0,0,,,0,,0,0,0,0,0,RB
5129,Mike Dulaney,0,2,2,1995,25,CHI,5,1,0,0,,0,0,0,,2,2,22,11,0,4.4,100,11,0,0,2,0,22,22,0,RB
5130,Vaughn Dunbar,110,2,112,1995,27,"JAX,NOR",15,6,110,361,3.3,2,24.1,23,41.8,4,2,11,5.5,0,0.7,50,2.8,0,25,112,361,372,404,32,RB
5131,Bobby Joe Edmonds,5,1,6,1995,31,TAM,16,0,5,28,5.6,0,1.8,0,0,0,1,8,8,0,0.5,,,0,,6,28,36,1476,1440,RB
5132,Keith Elias,10,9,19,1995,23,NYG,15,0,10,44,4.4,0,2.9,0,50,12,9,69,7.7,0,4.6,75,5.8,4,50,19,44,113,113,0,RB
5133,Jerry Ellison,26,7,33,1995,24,TAM,16,3,26,218,8.4,5,13.6,11,53.8,13,7,44,6.3,0,2.8,53.8,3.4,2,30.8,33,218,262,523,261,RB
5134,Ricky Ervins,23,2,25,1995,27,SFO,14,0,23,88,3.8,0,6.3,4,34.8,3,2,21,10.5,0,1.5,66.7,7,2,66.7,25,88,109,141,32,RB
5135,Charles Evans,19,18,37,1995,28,MIN,16,8,19,59,3.1,1,3.7,0,0,28,18,119,6.6,1,7.4,64.3,4.3,0,0,37,59,178,178,0,FB
5136,Marshall Faulk,289,56,345,1995,22,IND,16,16,289,1078,3.7,11,67.4,69,46.7,74,56,475,8.5,3,29.7,75.7,6.4,18,51.4,345,1078,1553,1553,0,RB
5137,Derrick Fenner,39,35,74,1995,28,OAK,16,10,39,110,2.8,0,6.9,3,25.6,45,35,252,7.2,3,15.8,77.8,5.6,16,51.1,74,110,362,362,0,FB
5138,Terrell Fletcher,26,3,29,1995,22,SDG,16,0,26,140,5.4,1,8.8,6,50,5,3,26,8.7,0,1.6,60,5.2,0,0,29,140,166,243,77,RB
5139,William Floyd,64,47,111,1995,23,SFO,8,8,64,237,3.7,2,29.6,18,57.8,62,47,348,7.4,1,43.5,75.8,5.6,19,51.6,111,237,585,585,0,FB
5140,Carwell Gardner,20,2,22,1995,29,BUF,15,4,20,77,3.9,0,5.1,8,45,8,2,17,8.5,0,1.1,25,2.1,0,12.5,22,77,94,94,0,FB
5141,Charlie Garner,108,10,118,1995,23,PHI,15,3,108,588,5.4,6,39.2,25,53.7,15,10,61,6.1,0,4.1,66.7,4.1,4,46.7,118,588,649,1239,590,RB
5142,Sam Gash,8,26,34,1995,26,NWE,15,12,8,24,3,0,1.6,4,62.5,43,26,242,9.3,1,16.1,60.5,5.6,15,53.5,34,24,266,266,0,FB
5143,Scottie Graham,110,4,114,1995,26,MIN,16,6,110,406,3.7,2,25.4,21,46.4,5,4,30,7.5,0,1.9,80,6,2,40,114,406,436,436,0,RB
5144,Rupert Grant,0,1,1,1995,22,NWE,7,1,0,0,,0,0,0,,2,1,4,4,0,0.6,50,2,0,0,1,0,4,11,7,RB
5145,David Green,0,0,0,1995,23,NWE,2,0,0,0,,0,0,0,,0,0,0,,0,0,,,0,,0,0,0,0,0,RB
5146,Harold Green,171,27,198,1995,27,CIN,15,15,171,661,3.9,2,44.1,35,47.4,41,27,182,6.7,1,12.1,65.9,4.4,10,43.9,198,661,843,843,0,RB
5147,Robert Green,107,28,135,1995,25,CHI,12,3,107,570,5.3,3,47.5,27,51.4,38,28,246,8.8,0,20.5,73.7,6.5,11,39.5,135,570,816,845,29,RB
5148,Howard Griffith,65,11,76,1995,28,CAR,15,7,65,197,3,1,13.1,11,40,14,11,63,5.7,1,4.2,78.6,4.5,5,42.9,76,197,260,260,0,FB
5149,Clif Groce,0,0,0,1995,23,IND,1,0,0,0,,0,0,0,,0,0,0,,0,0,,,0,,0,0,0,0,0,RB
5150,Rodney Hampton,306,24,330,1995,26,NYG,16,15,306,1182,3.9,10,73.9,74,55.9,28,24,142,5.9,0,8.9,85.7,5.1,9,46.4,330,1182,1324,1324,0,RB
5151,Ronnie Harmon,51,63,114,1995,31,SDG,16,1,51,187,3.7,1,11.7,11,39.2,88,63,673,10.7,5,42.1,71.6,7.6,34,47.7,114,187,860,885,25,RB
5152,Raymont Harris,0,1,1,1995,25,CHI,1,1,0,0,,0,0,0,,1,1,4,4,0,4,100,4,0,0,1,0,4,4,0,RB
5153,Aaron Hayden,128,5,133,1995,22,SDG,6,4,128,470,3.7,3,78.3,21,43,5,5,53,10.6,0,8.8,100,10.6,4,80,133,470,523,523,0,RB
5154,Garrison Hearst,284,29,313,1995,24,ARI,16,15,284,1070,3.8,1,66.9,56,44.4,47,29,243,8.4,1,15.2,61.7,5.2,12,42.6,313,1086,1313,1313,0,RB
5155,Steve Hendrickson,0,0,0,1995,29,HOU,5,1,0,0,,0,0,0,,0,0,0,,0,0,,,0,,0,0,0,0,0,RB
5156,William Henderson,7,3,10,1995,24,GNB,15,1,7,35,5,0,2.3,2,42.9,5,3,21,7,0,1.4,60,4.2,0,60,10,35,56,56,0,FB
5157,Craig Heyward,236,37,273,1995,29,ATL,16,16,236,1083,4.6,6,67.7,65,49.6,46,37,350,9.5,2,21.9,80.4,7.6,21,60.9,273,1083,1433,1433,0,RB
5158,Mark Higgs,0,0,0,1995,29,ARI,1,0,0,0,,0,0,0,,0,0,0,,0,0,,,0,,0,0,0,26,26,RB
5159,Greg Hill,155,7,162,1995,23,KAN,16,1,155,667,4.3,1,41.7,27,47.1,14,7,45,6.4,0,2.8,50,3.2,3,28.6,162,667,712,712,0,RB
5160,Leroy Hoard,136,13,149,1995,27,CLE,12,12,136,547,4,0,45.6,26,47.8,16,13,103,7.9,0,8.6,81.3,6.4,4,62.5,149,547,650,663,13,RB
5161,Darick Holmes,172,24,196,1995,24,BUF,16,2,172,698,4.1,4,43.6,42,48.8,34,24,214,8.9,0,13.4,70.6,6.3,5,35.3,196,698,912,1711,799,RB
5162,Ronald Humphrey,2,2,4,1995,26,IND,11,0,2,6,3,0,0.5,0,0,2,2,11,5.5,0,1,100,5.5,0,0,4,6,17,470,453,RB
5163,Earnest Hunter,30,5,35,1995,25,CLE,10,0,30,100,3.3,0,10,4,36.7,8,5,42,8.4,0,4.2,62.5,5.3,2,50,35,100,142,690,548,RB
5164,Travis Jervey,0,0,0,1995,23,GNB,16,0,0,0,,0,0,0,,0,0,0,,0,0,,,0,,0,0,0,165,165,RB
5165,Anthony Johnson,30,29,59,1995,28,"CAR,CHI",15,0,30,140,4.7,1,9.3,8,50,34,29,207,7.1,0,13.8,85.3,6.1,10,44.1,59,140,347,347,0,RB
5166,Daryl Johnston,25,30,55,1995,29,DAL,16,16,25,111,4.4,2,6.9,12,68,46,30,248,8.3,1,15.5,65.2,5.4,11,50,55,111,359,359,0,FB
5167,LeShon Johnson,2,0,2,1995,24,"ARI,GNB",5,0,2,-2,-1,0,-0.4,0,0,0,0,0,,0,0,,,0,,2,-2,-2,257,259,RB
5168,Tracy Johnson,1,1,2,1995,29,SEA,15,4,1,2,2,1,0.1,1,100,4,1,-2,-2,0,-0.1,25,-0.5,0,0,2,2,0,0,0,RB
5169,Calvin Jones,5,0,5,1995,25,OAK,8,0,5,19,3.8,0,2.4,1,20,0,0,0,,0,0,,,0,,5,19,19,111,92,RB
5170,Randy Jordan,21,5,26,1995,25,JAX,12,3,21,62,3,0,5.2,2,38.1,12,5,89,17.8,1,7.4,41.7,7.4,4,25,26,62,151,192,41,RB
5171,James Joseph,16,20,36,1995,28,CIN,16,3,16,40,2.5,0,2.5,1,37.5,25,20,118,5.9,0,7.4,80,4.7,5,60,36,40,158,177,17,RB
5172,Yonel Jourdain,8,1,9,1995,24,BUF,8,0,8,31,3.9,0,3.9,3,37.5,1,1,7,7,0,0.9,100,7,1,100,9,31,38,386,348,RB
5173,Napoleon Kaufman,108,9,117,1995,22,OAK,16,1,108,490,4.5,1,30.6,29,48.1,16,9,62,6.9,0,3.9,56.3,3.9,3,37.5,117,490,552,1124,572,RB
5174,Terry Kirby,108,66,174,1995,25,MIA,16,4,108,414,3.8,4,25.9,25,41.7,83,66,618,9.4,3,38.6,79.5,7.4,28,53,174,445,1032,1032,0,RB
5175,David Lang,1,0,1,1995,27,DAL,16,0,1,7,7,0,0.4,0,0,0,0,0,,0,0,,,0,,1,7,7,7,0,RB
5176,Amp Lee,69,71,140,1995,24,MIN,16,3,69,371,5.4,2,23.2,18,42,95,71,558,7.9,1,34.9,74.7,5.9,29,52.6,140,371,929,1082,150,RB
5177,Tim Lester,5,0,5,1995,27,PIT,6,1,5,9,1.8,1,1.5,2,40,0,0,0,,0,0,,,0,,5,9,9,9,0,RB
5178,Dorsey Levens,36,48,84,1995,25,GNB,15,12,36,120,3.3,3,8,19,58.3,57,48,434,9,4,28.9,84.2,7.6,22,64.9,84,120,554,554,0,RB
5179,Marc Logan,23,25,48,1995,30,WAS,16,8,23,72,3.1,1,4.5,6,56.5,39,25,276,11,2,17.3,64.1,7.1,14,46.2,48,72,348,348,0,FB
5180,Derek Loville,218,87,305,1995,27,SFO,16,16,218,723,3.3,10,45.2,48,46.3,110,87,662,7.6,3,41.4,79.1,6,38,62.7,305,723,1385,1385,0,RB
5181,Dennis Lundy,0,1,1,1995,23,"CHI,HOU",9,0,0,0,,0,0,0,,1,1,11,11,0,1.2,100,11,1,100,1,0,11,64,35,RB
5182,Eric Lynch,0,0,0,1995,25,DET,4,0,0,0,,0,0,0,,0,0,0,,0,0,,,0,,0,0,0,0,0,RB
5183,Anthony Lynn,2,0,2,1995,27,SFO,6,0,2,11,5.5,0,1.8,0,0,0,0,0,,0,0,,,0,,2,11,11,11,0,RB
5184,Curtis Martin,368,30,398,1995,22,NWE,16,15,368,1487,4,14,92.9,79,41.8,50,30,261,8.7,1,16.3,60,5.2,9,34,398,1487,1748,1748,0,RB
5185,Le'Shai Maston,41,18,59,1995,25,JAX,16,10,41,186,4.5,0,11.6,8,46.3,25,18,131,7.3,0,8.2,72,5.2,3,28,59,186,317,326,5,FB
5186,Sherriden May,2,0,2,1995,22,NYJ,5,1,2,5,2.5,0,1,0,0,0,0,0,,0,0,,,0,,2,5,5,5,0,RB
5187,Fred McAfee,39,15,54,1995,27,PIT,16,1,39,156,4,1,9.8,11,41,19,15,88,5.9,0,5.5,78.9,4.6,2,42.1,54,156,244,300,56,RB
5188,Fred McCrary,3,9,12,1995,23,PHI,13,4,3,1,0.3,1,0.1,1,33.3,13,9,60,6.7,0,4.6,69.2,4.6,2,53.8,12,1,61,62,1,FB
5189,Dexter McNabb,0,0,0,1995,26,PHI,1,0,0,0,,0,0,0,,0,0,0,,0,0,,,0,,0,0,0,0,0,FB
5190,Todd McNair,19,60,79,1995,30,HOU,15,7,19,136,7.2,0,9.1,9,63.2,84,60,501,8.4,1,33.4,71.4,6,19,48.8,79,136,637,637,0,FB
5191,Natrone Means,186,7,193,1995,23,SDG,10,9,186,730,3.9,5,73,39,41.9,9,7,46,6.6,0,4.6,77.8,5.1,1,66.7,193,730,776,776,0,RB
5192,Dave Meggett,60,52,112,1995,29,NWE,16,0,60,250,4.2,2,15.6,0,0,86,52,334,6.4,0,20.9,60.5,3.9,0,0,112,250,584,1931,1347,RB
5193,Brian Mitchell,46,38,84,1995,27,WAS,16,1,46,301,6.5,1,18.8,18,56.5,50,38,324,8.5,1,20.3,76,6.5,13,44,84,301,625,2348,1723,RB
5194,Derrick Moore,195,4,199,1995,28,CAR,13,10,195,740,3.8,4,56.9,35,40.5,8,4,12,3,0,0.9,50,1.5,1,37.5,199,740,752,752,0,RB
5195,Ronald Moore,43,8,51,1995,25,NYJ,15,3,43,121,2.8,0,8.1,7,34.9,11,8,50,6.3,0,3.3,72.7,4.5,3,45.5,51,121,171,337,166,RB
5196,Bam Morris,148,8,156,1995,23,PIT,13,4,148,559,3.8,9,43,38,48.6,10,8,36,4.5,0,2.8,80,3.6,2,30,156,559,595,595,0,RB
5197,Brent Moss,22,1,23,1995,23,STL,4,0,22,90,4.1,0,22.5,3,40.9,2,1,-3,-3,0,-0.8,50,-1.5,0,0,23,90,87,87,0,RB
5198,Adrian Murrell,192,71,263,1995,25,NYJ,15,9,192,795,4.1,1,53,45,49.5,100,71,465,6.5,2,31,71,4.7,19,33,263,795,1260,1265,5,RB
5199,Lorenzo Neal,5,12,17,1995,25,NOR,16,5,5,3,0.6,0,0.2,2,40,13,12,123,10.3,1,7.7,92.3,9.5,5,76.9,17,3,126,154,28,FB
5200,Derrick Ned,3,3,6,1995,26,NOR,12,0,3,1,0.3,0,0.1,1,33.3,3,3,9,3,0,0.8,100,3,0,33.3,6,1,10,43,33,FB
5201,Brian O'Neal,0,0,0,1995,25,SFO,3,0,0,0,,0,0,0,,0,0,0,,0,0,,,0,,0,0,0,0,0,FB
5202,Bernie Parmalee,236,39,275,1995,28,MIA,16,12,236,878,3.7,9,54.9,57,49.6,46,39,345,8.8,1,21.6,84.8,7.5,15,65.2,275,878,1223,1223,0,RB
5203,Erric Pegram,213,26,239,1995,26,PIT,15,11,213,813,3.8,5,54.2,39,45.5,35,26,206,7.9,1,13.7,74.3,5.9,11,40,239,813,1019,1104,85,RB
5204,Bobby Phillips,14,0,14,1995,26,MIN,8,0,14,26,1.9,0,3.3,1,35.7,0,0,0,,0,0,,,0,,14,26,26,86,60,RB
5205,Dino Philyaw,0,0,0,1995,25,CAR,1,0,0,0,,0,0,0,,0,0,0,,0,0,,,0,,0,0,0,23,23,RB
5206,Roosevelt Potts,65,21,86,1995,24,IND,15,15,65,309,4.8,0,20.6,13,44.6,33,21,228,10.9,1,15.2,63.6,6.9,7,48.5,86,309,537,537,0,FB
5207,Ricky Powers,14,1,15,1995,25,CLE,3,0,14,51,3.6,0,17,3,35.7,1,1,6,6,0,2,100,6,0,100,15,51,57,111,54,RB
5208,Kenyon Rasheed,1,2,3,1995,25,NYJ,3,0,1,3,3,0,1,0,100,2,2,15,7.5,0,5,100,7.5,1,50,3,3,18,18,0,FB
5209,Errict Rhett,332,14,346,1995,25,TAM,16,16,332,1207,3.6,11,75.4,78,46.7,29,14,110,7.9,0,6.9,48.3,3.8,6,27.6,346,1207,1317,1317,0,RB
5210,Tony Richardson,8,0,8,1995,24,KAN,14,1,8,18,2.3,0,1.3,4,50,1,0,0,,0,0,0,0,0,0,8,18,18,18,0,FB
5211,Reggie Rivers,2,3,5,1995,27,DEN,16,0,2,2,1,0,0.1,0,0,3,3,32,10.7,0,2,100,10.7,1,66.7,5,2,34,34,0,RB
5212,Ron Rivers,18,1,19,1995,24,DET,16,0,18,73,4.1,1,4.6,5,66.7,1,1,5,5,0,0.3,100,5,1,100,19,73,78,498,420,RB
5213,Greg Robinson,40,2,42,1995,26,STL,5,1,40,165,4.1,0,33,7,42.5,5,2,12,6,0,2.4,40,2.4,0,40,42,165,177,177,0,RB
5214,Dominique Ross,0,0,0,1995,23,DAL,1,0,0,0,,0,0,0,,0,0,0,,0,0,,,0,,0,0,0,0,0,RB
5215,Leonard Russell,66,16,82,1995,26,STL,13,3,66,203,3.1,0,15.6,14,33.3,31,16,89,5.6,0,6.8,51.6,2.9,4,19.4,82,203,292,292,0,RB
5216,Rashaan Salaam,296,7,303,1995,21,CHI,16,11,296,1074,3.6,10,67.1,61,47.3,13,7,56,8,0,3.5,53.8,4.3,3,53.8,303,1074,1130,1130,0,RB
5217,Barry Sanders,314,48,362,1995,27,DET,16,16,314,1500,4.8,11,93.8,72,42.4,70,48,398,8.3,1,24.9,68.6,5.7,17,35.7,362,1511,1898,1898,0,RB
5218,James Saxon,1,0,1,1995,29,PHI,9,3,1,0,0,0,0,0,0,0,0,0,,0,0,,,0,,1,0,0,3,3,FB
5219,Cory Schlesinger,1,1,2,1995,23,DET,16,2,1,1,1,0,0.1,0,0,3,1,2,2,0,0.1,33.3,0.7,0,0,2,1,3,14,0,FB
5220,Cedric Smith,3,0,3,1995,27,WAS,6,0,3,13,4.3,0,2.2,1,66.7,0,0,0,,0,0,,,0,,3,13,13,13,0,FB
5221,Emmitt Smith,377,62,439,1995,26,DAL,16,16,377,1773,4.7,25,110.8,107,51.2,78,62,375,6,0,23.4,79.5,4.8,14,32.1,439,1773,2148,2148,0,RB
5222,Lamar Smith,36,1,37,1995,25,SEA,12,0,36,215,6,0,17.9,8,44.4,2,1,10,10,0,0.8,50,5,1,50,37,215,225,245,20,RB
5223,Robert Smith,139,7,146,1995,23,MIN,9,7,139,632,4.5,5,70.2,31,43.9,11,7,35,5,0,3.9,63.6,3.2,1,36.4,146,632,667,667,0,RB
5224,Steve Smith,9,7,16,1995,31,SEA,9,7,9,19,2.1,0,2.1,5,55.6,10,7,59,8.4,1,6.6,70,5.9,4,40,16,19,78,89,11,FB
5225,Irving Spikes,32,5,37,1995,25,MIA,9,0,32,126,3.9,1,14,7,56.3,6,5,18,3.6,1,2,83.3,3,2,50,37,126,144,522,378,RB
5226,James Stewart,137,21,158,1995,24,JAX,14,8,137,525,3.8,2,37.5,25,46.7,27,21,190,9,1,13.6,77.8,7,8,44.4,158,525,715,715,0,RB
5227,James Stewart,31,1,32,1995,24,MIN,4,0,31,144,4.6,0,36,6,41.9,1,1,3,3,0,0.8,100,3,0,0,32,144,147,147,0,RB
5228,Mack Strong,8,12,20,1995,24,SEA,16,2,8,23,2.9,1,1.4,4,50,16,12,117,9.8,3,7.3,75,7.3,7,56.3,20,23,140,205,65,FB
5229,Ryan Terry,0,0,0,1995,24,ARI,15,0,0,0,,0,0,0,,0,0,0,,0,0,,,0,,0,0,0,808,808,RB
5230,Blair Thomas,22,3,25,1995,28,CAR,7,0,22,90,4.1,0,12.9,6,45.5,5,3,24,8,0,3.4,60,4.8,1,20,25,90,114,114,0,RB
5231,Leroy Thompson,28,9,37,1995,26,KAN,16,0,28,73,2.6,0,4.6,5,21.4,13,9,37,4.1,0,2.3,69.2,2.8,3,38.5,37,73,110,262,152,RB
5232,Rodney Thomas,251,39,290,1995,22,HOU,16,10,251,947,3.8,5,59.2,48,40.2,59,39,204,5.2,2,12.8,66.1,3.5,10,32.2,290,947,1151,1199,48,RB
5233,Thurman Thomas,267,26,293,1995,29,BUF,14,14,267,1005,3.8,6,71.8,64,46.1,41,26,220,8.5,2,15.7,63.4,5.4,10,43.9,293,1005,1225,1225,0,RB
5234,Lewis Tillman,29,0,29,1995,29,CHI,13,1,29,78,2.7,0,6,4,31,0,0,0,,0,0,,,0,,29,78,78,98,20,RB
5235,Tim Tindale,5,0,5,1995,24,BUF,16,0,5,16,3.2,0,1,2,80,0,0,0,,0,0,,,0,,5,16,16,80,62,FB
5236,Kevin Turner,2,4,6,1995,26,PHI,2,2,2,9,4.5,0,4.5,1,50,4,4,29,7.3,0,14.5,100,7.3,2,75,6,9,38,38,0,FB
5237,Tommy Vardell,4,6,10,1995,26,CLE,5,0,4,9,2.3,0,1.8,1,25,10,6,18,3,0,3.6,60,1.8,0,20,10,9,27,27,0,RB
5238,Adam Walker,14,11,25,1995,27,SFO,13,7,14,44,3.1,1,3.4,3,42.9,21,11,78,7.1,0,6,52.4,3.7,5,42.9,25,44,122,139,17,FB
5239,Herschel Walker,31,31,62,1995,33,NYG,16,3,31,126,4.1,0,7.9,6,32.3,44,31,234,7.5,1,14.6,70.5,5.3,13,52.3,62,126,360,1241,881,RB
5240,Chris Warren,310,35,345,1995,27,SEA,16,16,310,1346,4.3,15,84.1,78,44.5,50,35,247,7.1,1,15.4,70,4.9,14,36,345,1346,1593,1593,0,RB
5241,Lamont Warren,47,17,64,1995,22,IND,12,1,47,152,3.2,1,12.7,11,46.8,24,17,159,9.4,0,13.3,70.8,6.6,9,54.2,64,152,311,626,315,RB
5242,Ricky Watters,337,62,399,1995,26,PHI,16,16,337,1273,3.8,11,79.6,76,48.1,93,62,434,7,1,27.1,66.7,4.7,19,37.6,399,1273,1707,1707,0,RB
5243,Charles Way,2,7,9,1995,23,NYG,16,4,2,6,3,0,0.4,0,50,12,7,76,10.9,1,4.8,58.3,6.3,5,41.7,9,6,82,90,8,RB
5244,Tyrone Wheatley,78,5,83,1995,23,NYG,13,1,78,245,3.1,3,18.8,15,50,5,5,27,5.4,0,2.1,100,5.4,2,60,83,245,272,458,186,RB
5245,Lorenzo White,62,8,70,1995,29,CLE,12,2,62,163,2.6,1,13.6,10,46.8,8,8,64,8,0,5.3,100,8,3,62.5,70,163,227,227,0,RB
5246,Allen Williams,0,0,0,1995,23,DET,5,0,0,0,,0,0,0,,0,0,0,,0,0,,,0,,0,0,0,100,100,RB
5247,Harvey Williams,255,54,309,1995,28,OAK,16,16,255,1114,4.4,9,69.6,59,48.2,60,54,375,6.9,0,23.4,90,6.3,15,46.7,309,1127,1489,1489,0,RB
5248,Jamal Willis,12,3,15,1995,23,SFO,11,1,12,35,2.9,0,3.2,2,33.3,3,3,8,2.7,0,0.7,100,2.7,0,0,15,35,43,470,427,RB
5249,John Williams,29,24,53,1995,31,PIT,11,7,29,110,3.8,0,10,0,0,36,24,127,5.3,1,11.5,66.7,3.5,0,0,53,110,237,237,0,FB
5250,Sherman Williams,48,3,51,1995,22,DAL,11,0,48,205,4.3,1,18.6,12,27.1,3,3,28,9.3,0,2.5,100,9.3,1,33.3,51,205,233,233,0,RB
5251,Marcus Wilson,0,0,0,1995,27,GNB,14,0,0,0,,0,0,0,,0,0,0,,0,0,,,0,,0,0,0,0,0,RB
5252,Robert Wilson,1,1,2,1995,26,MIA,16,0,1,5,5,0,0.3,0,0,1,1,3,3,0,0.2,100,3,0,0,2,5,8,8,0,RB
5253,Derrick Witherspoon,2,0,2,1995,24,PHI,15,0,2,7,3.5,0,0.5,0,0,0,0,0,,0,0,,,0,,2,7,7,466,459,RB
5254,Ron Wolfley,3,0,3,1995,33,STL,9,0,3,9,3,0,1,3,100,0,0,0,,0,0,,,0,,3,9,9,9,0,RB
5255,Vince Workman,44,13,57,1995,27,"CAR,IND",10,0,44,165,3.8,1,16.5,7,31.8,22,13,74,5.7,0,7.4,59.1,3.4,2,27.3,57,165,239,239,0,RB
5256,Ray Zellars,50,7,57,1995,22,NOR,12,0,50,162,3.2,2,13.5,11,44,11,7,33,4.7,0,2.8,63.6,3,1,36.4,57,162,195,195,0,RB
5257,Tommie Agee,5,1,6,1994,30,DAL,15,0,5,4,0.8,0,0.3,1,20,3,1,2,2,0,0.1,33.3,0.7,0,0,6,4,6,6,0,RB
5258,Marcus Allen,189,42,231,1994,34,KAN,13,13,189,709,3.8,7,54.5,48,50.8,60,42,349,8.3,0,26.8,70,5.8,13,48.3,231,709,1058,1058,0,RB
5259,Terry Allen,255,17,272,1994,26,MIN,16,16,255,1031,4,8,64.4,57,44.7,30,17,148,8.7,0,9.3,56.7,4.9,4,33.3,272,1031,1179,1183,0,RB
5260,Jamal Anderson,2,0,2,1994,22,ATL,3,0,2,-1,-0.5,0,-0.3,0,0,0,0,0,,0,0,,,0,,2,-1,-1,10,11,RB
5261,Kimble Anders,62,67,129,1994,28,KAN,16,13,62,231,3.7,2,14.4,15,41.9,93,67,525,7.8,1,32.8,72,5.6,26,51.6,129,231,756,792,36,FB
5262,Richie Anderson,43,25,68,1994,23,NYJ,13,5,43,207,4.8,1,15.9,10,44.2,33,25,212,8.5,1,16.3,75.8,6.4,12,54.5,68,207,419,462,43,FB
5263,Steve Avery,2,1,3,1994,28,PIT,14,1,2,4,2,0,0.3,0,0,3,1,2,2,0,0.1,33.3,0.7,0,0,3,4,6,6,0,RB
5264,Johnny Bailey,11,58,69,1994,27,RAM,14,0,11,35,3.2,1,2.5,4,36.4,67,58,516,8.9,0,36.9,86.6,7.7,17,53.7,69,35,551,964,413,RB
5265,Randy Baldwin,23,3,26,1994,27,CLE,16,0,23,78,3.4,0,4.9,2,26.1,4,3,15,5,0,0.9,75,3.8,1,25,26,78,93,846,753,RB
5266,Eric Ball,2,1,3,1994,28,CIN,16,0,2,0,0,0,0,0,0,2,1,4,4,0,0.3,50,2,0,0,3,0,4,919,915,RB
5267,Mario Bates,151,8,159,1994,21,NOR,11,7,151,579,3.8,6,52.6,32,47,9,8,62,7.8,0,5.6,88.9,6.9,1,66.7,159,579,641,661,20,RB
5268,Michael Bates,2,5,7,1994,25,SEA,15,0,2,-4,-2,0,-0.3,1,50,17,5,112,22.4,1,7.5,29.4,6.6,4,23.5,7,-4,108,616,508,RB
5269,Brad Baxter,60,10,70,1994,27,NYJ,15,9,60,170,2.8,4,11.3,14,50,11,10,40,4,0,2.7,90.9,3.6,1,45.5,70,170,210,210,0,FB
5270,Tom Beer,0,0,0,1994,25,DET,9,0,0,0,,0,0,0,,0,0,0,,0,0,,,0,,0,0,0,0,0,FB
5271,William Bell,0,0,0,1994,23,WAS,7,0,0,0,,0,0,0,,0,0,0,,0,0,,,0,,0,0,0,43,43,RB
5272,Wes Bender,0,2,2,1994,24,RAI,9,0,0,0,,0,0,0,,2,2,14,7,0,1.6,100,7,0,0,2,0,14,14,0,RB
5273,Donnell Bennett,46,7,53,1994,22,KAN,15,0,46,178,3.9,2,11.9,9,43.5,11,7,53,7.6,0,3.5,63.6,4.8,4,45.5,53,178,231,243,12,RB
5274,Edgar Bennett,178,78,256,1994,25,GNB,16,15,178,623,3.5,5,38.9,40,43.8,97,78,546,7,4,34.1,80.4,5.6,30,52.6,256,623,1169,1169,0,FB
5275,Rod Bernstine,17,9,26,1994,29,DEN,3,3,17,91,5.4,0,30.3,5,47.1,11,9,70,7.8,0,23.3,81.8,6.4,4,54.5,26,91,161,161,0,RB
5276,Jerome Bettis,319,31,350,1994,22,RAM,16,16,319,1025,3.2,3,64.1,57,42.9,45,31,293,9.5,1,18.3,68.9,6.5,16,48.9,350,1025,1318,1318,0,RB
5277,Eric Bieniemy,73,5,78,1994,25,SDG,16,0,73,295,4,0,18.4,11,43.8,5,5,48,9.6,0,3,100,9.6,1,40,78,295,343,343,0,RB
5278,Dewell Brewer,0,0,0,1994,24,IND,16,0,0,0,,0,0,0,,0,0,0,,0,0,,,0,,0,0,0,697,697,RB
5279,Reggie Brooks,100,13,113,1994,23,WAS,13,5,100,297,3,2,22.8,18,41,21,13,68,5.2,0,5.2,61.9,3.2,1,28.6,113,297,365,365,0,RB
5280,Steve Broussard,94,34,128,1994,27,CIN,13,3,94,403,4.3,2,31,21,39.4,48,34,218,6.4,0,16.8,70.8,4.5,10,39.6,128,403,621,736,115,RB
5281,Derek Brown,146,44,190,1994,23,NOR,16,9,146,489,3.3,3,30.6,29,39.7,57,44,428,9.7,1,26.8,77.2,7.5,19,49.1,190,489,917,920,3,RB
5282,Gary Brown,169,18,187,1994,25,HOU,12,8,169,648,3.8,4,54,34,51.5,32,18,194,10.8,1,16.2,56.3,6.1,10,37.5,187,648,842,842,0,RB
5283,Beno Bryant,1,0,1,1994,23,SEA,2,0,1,6,6,0,3,0,0,0,0,0,,0,0,,,0,,1,6,6,173,167,RB
5284,Jarrod Bunch,0,0,0,1994,26,RAI,3,0,0,0,,0,0,0,,0,0,0,,0,0,,,0,,0,0,0,0,0,FB
5285,Marion Butts,243,9,252,1994,28,NWE,16,15,243,703,2.9,8,43.9,40,39.1,14,9,54,6,0,3.4,64.3,3.9,2,42.9,252,703,757,757,0,RB
5286,Keith Byars,19,49,68,1994,31,MIA,9,9,19,64,3.4,2,7.1,4,52.6,65,49,418,8.5,5,46.4,75.4,6.4,21,53.8,68,64,482,482,0,FB
5287,Earnest Byner,75,11,86,1994,32,CLE,16,1,75,219,2.9,2,13.7,11,42.7,15,11,102,9.3,0,6.4,73.3,6.8,5,26.7,86,219,321,321,0,RB
5288,Butler By'not'e,0,0,0,1994,22,DEN,9,0,0,0,,0,0,0,,0,0,0,,0,0,,,0,,0,0,0,545,545,RB
5289,Dexter Carter,8,7,15,1994,27,SFO,16,0,8,34,4.3,0,2.1,3,62.5,7,7,99,14.1,0,6.2,100,14.1,4,100,15,34,133,1559,1426,RB
5290,Tony Carter,0,1,1,1994,22,CHI,14,0,0,0,,0,0,0,,1,1,24,24,0,1.7,100,24,1,100,1,0,24,123,99,RB
5291,Larry Centers,115,77,192,1994,26,ARI,16,5,115,336,2.9,5,21,20,39.1,96,77,647,8.4,2,40.4,80.2,6.7,38,54.2,192,336,983,1010,0,FB
5292,Bob Christian,7,2,9,1994,26,CHI,12,0,7,29,4.1,0,2.4,2,42.9,4,2,30,15,0,2.5,50,7.5,2,50,9,29,59,59,0,RB
5293,Derrick Clark,56,9,65,1994,23,DEN,16,4,56,168,3,3,10.5,16,57.1,9,9,47,5.2,0,2.9,100,5.2,2,88.9,65,168,215,249,34,RB
5294,Reggie Cobb,153,35,188,1994,26,GNB,16,13,153,579,3.8,3,36.2,33,39.9,51,35,299,8.5,1,18.7,68.6,5.9,11,35.3,188,579,878,878,0,RB
5295,Trevor Cobb,0,0,0,1994,24,CHI,1,0,0,0,,0,0,0,,0,0,0,,0,0,,,0,,0,0,0,0,0,RB
5296,Lincoln Coleman,64,8,72,1994,25,DAL,11,0,64,180,2.8,1,16.4,11,39.1,8,8,46,5.8,0,4.2,100,5.8,2,50,72,180,226,226,0,FB
5297,Jeff Cothran,26,4,30,1994,23,CIN,14,4,26,85,3.3,0,6.1,2,34.6,6,4,24,6,1,1.7,66.7,4,2,50,30,85,109,109,0,FB
5298,Aaron Craver,6,24,30,1994,26,MIA,8,0,6,43,7.2,0,5.4,2,66.7,27,24,237,9.9,0,29.6,88.9,8.8,11,70.4,30,43,280,280,0,RB
5299,Corey Croom,0,0,0,1994,23,NWE,16,0,0,0,,0,0,0,,1,0,0,,0,0,0,0,0,0,0,0,0,172,172,RB
5300,Rodney Culver,8,0,8,1994,25,SDG,3,0,8,63,7.9,0,21,3,62.5,1,0,0,,0,0,0,0,0,0,8,63,63,63,0,RB
5301,Randy Cuthbert,0,0,0,1994,24,PIT,1,0,0,0,,0,0,0,,0,0,0,,0,0,,,0,,0,0,0,0,0,RB
5302,Anthony Daigle,0,0,0,1994,24,PIT,1,0,0,0,,0,0,0,,0,0,0,,0,0,,,0,,0,0,0,0,0,RB
5303,Kenneth Davis,91,18,109,1994,32,BUF,16,1,91,381,4.2,2,23.8,16,38.5,23,18,82,4.6,0,5.1,78.3,3.6,2,30.4,109,381,463,463,0,RB
5304,Gary Downs,15,2,17,1994,22,NYG,14,0,15,51,3.4,0,3.6,2,46.7,4,2,15,7.5,0,1.1,50,3.8,1,25,17,51,66,66,0,RB
5305,Vaughn Dunbar,3,0,3,1994,26,NOR,8,0,3,9,3,0,1.1,2,66.7,0,0,0,,0,0,,,0,,3,9,9,37,28,RB
5306,Keith Elias,2,0,2,1994,22,NYG,2,0,2,4,2,0,2,0,0,0,0,0,,0,0,,,0,,2,4,4,4,0,RB
5307,Ricky Ervins,185,51,236,1994,26,WAS,16,10,185,650,3.5,3,40.6,32,40,67,51,293,5.7,1,18.3,76.1,4.4,12,41.8,236,650,943,960,17,RB
5308,Charles Evans,6,1,7,1994,27,MIN,14,0,6,20,3.3,0,1.4,0,0,1,1,2,2,0,0.1,100,2,0,0,7,20,22,26,4,RB
5309,Marshall Faulk,314,52,366,1994,21,IND,16,16,314,1282,4.1,11,80.1,60,43.3,74,52,522,10,1,32.6,70.3,7.1,21,43.2,366,1282,1804,1804,0,RB
5310,Derrick Fenner,141,36,177,1994,27,CIN,16,13,141,468,3.3,1,29.3,18,37.6,50,36,276,7.7,1,17.3,72,5.5,11,42,177,468,744,744,0,FB
5311,William Floyd,87,19,106,1994,22,SFO,16,11,87,305,3.5,6,19.1,22,51.7,26,19,145,7.6,0,9.1,73.1,5.6,5,61.5,106,305,450,450,0,FB
5312,Barry Foster,216,20,236,1994,26,PIT,11,10,216,851,3.9,5,77.4,46,47.2,28,20,124,6.2,0,11.3,71.4,4.4,8,46.4,236,851,975,975,0,RB
5313,Carwell Gardner,41,11,52,1994,28,BUF,16,7,41,135,3.3,4,8.4,20,63.4,14,11,89,8.1,0,5.6,78.6,6.4,3,64.3,52,135,224,230,6,FB
5314,Charlie Garner,109,8,117,1994,22,PHI,10,8,109,399,3.7,3,39.9,25,45,12,8,74,9.3,0,7.4,66.7,6.2,3,33.3,117,399,473,473,0,FB
5315,Cleveland Gary,7,2,9,1994,28,MIA,2,0,7,11,1.6,0,5.5,0,0,5,2,19,9.5,0,9.5,40,3.8,1,40,9,11,30,30,0,RB
5316,Sam Gash,30,9,39,1994,25,NWE,13,6,30,86,2.9,0,6.6,5,33.3,13,9,61,6.8,0,4.7,69.2,4.7,3,46.2,39,86,147,156,9,FB
5317,Scottie Graham,64,1,65,1994,25,MIN,16,0,64,207,3.2,2,12.9,15,48.4,1,1,1,1,0,0.1,100,1,0,0,65,207,208,208,0,RB
5318,Harold Green,76,27,103,1994,26,CIN,14,11,76,223,2.9,1,15.9,17,38.2,41,27,267,9.9,1,19.1,65.9,6.5,12,41.5,103,223,490,603,113,RB
5319,Robert Green,25,24,49,1994,24,CHI,15,0,25,122,4.9,0,8.1,7,40,33,24,199,8.3,2,13.3,72.7,6,6,33.3,49,122,321,398,77,RB
5320,Howard Griffith,9,16,25,1994,27,RAM,16,10,9,30,3.3,0,1.9,1,44.4,27,16,113,7.1,1,7.1,59.3,4.2,5,44.4,25,30,143,178,35,FB
5321,Rodney Hampton,327,14,341,1994,25,NYG,14,13,327,1075,3.3,6,76.8,60,42.5,20,14,103,7.4,0,7.4,70,5.2,5,45,341,1075,1178,1178,0,RB
5322,Ronnie Harmon,25,58,83,1994,30,SDG,16,0,25,94,3.8,1,5.9,6,44,89,58,615,10.6,1,38.4,65.2,6.9,34,47.2,83,94,709,866,157,RB
5323,Raymont Harris,123,39,162,1994,24,CHI,16,11,123,464,3.8,1,29,26,56.9,56,39,236,6.1,0,14.8,69.6,4.2,11,41.1,162,464,700,718,18,FB
5324,Rudy Harris,2,2,4,1994,23,TAM,8,0,2,0,0,0,0,0,0,2,2,11,5.5,0,1.4,100,5.5,0,0,4,0,11,23,12,RB
5325,Frank Harvey,0,0,0,1994,23,ARI,2,0,0,0,,0,0,0,,0,0,0,,0,0,,,0,,0,0,0,0,0,RB
5326,Garrison Hearst,37,6,43,1994,23,ARI,8,0,37,169,4.6,1,21.1,10,43.2,7,6,49,8.2,0,6.1,85.7,7,2,57.1,43,179,218,218,0,RB
5327,Vaughn Hebron,82,18,100,1994,24,PHI,16,2,82,325,4,2,20.3,20,45.1,22,18,137,7.6,0,8.6,81.8,6.2,7,54.5,100,325,462,905,443,RB
5328,Brian Henesey,0,0,0,1994,25,ARI,3,0,0,0,,0,0,0,,0,0,0,,0,0,,,0,,0,0,0,108,108,RB
5329,Craig Heyward,183,32,215,1994,28,ATL,16,11,183,779,4.3,7,48.7,42,51.4,40,32,335,10.5,1,20.9,80,8.4,16,60,215,779,1114,1121,7,RB
5330,Mark Higgs,62,0,62,1994,28,"ARI,MIA",11,1,62,195,3.1,0,17.7,10,30.6,0,0,0,,0,0,,,0,,62,195,195,220,25,RB
5331,Greg Hill,141,16,157,1994,22,KAN,16,1,141,574,4.1,1,35.9,21,37.6,22,16,92,5.8,0,5.8,72.7,4.2,4,27.3,157,574,666,666,0,RB
5332,Leroy Hoard,209,45,254,1994,26,CLE,16,12,209,890,4.3,5,55.6,42,50.2,68,45,445,9.9,4,27.8,66.2,6.5,21,45.6,254,890,1335,1365,30,FB
5333,Merril Hoge,6,13,19,1994,29,CHI,5,5,6,24,4,0,4.8,1,66.7,23,13,79,6.1,0,15.8,56.5,3.4,6,43.5,19,24,103,103,0,FB
5334,Ronald Humphrey,18,3,21,1994,25,IND,15,0,18,85,4.7,0,5.7,5,44.4,3,3,19,6.3,0,1.3,100,6.3,1,33.3,21,85,104,887,783,RB
5335,Anthony Johnson,5,5,10,1994,27,NYJ,15,0,5,12,2.4,0,0.8,0,0,10,5,31,6.2,0,2.1,50,3.1,0,0,10,12,43,46,3,RB
5336,Daryl Johnston,40,44,84,1994,28,DAL,16,16,40,138,3.5,2,8.6,11,60,60,44,325,7.4,2,20.3,73.3,5.4,13,55,84,138,463,463,0,FB
5337,Johnny Johnson,240,42,282,1994,26,NYJ,16,14,240,931,3.9,3,58.2,48,42.9,57,42,303,7.2,2,18.9,73.7,5.3,18,45.6,282,931,1234,1234,0,RB
5338,LeShon Johnson,26,13,39,1994,23,GNB,12,0,26,99,3.8,0,8.3,3,23.1,20,13,168,12.9,0,14,65,8.4,6,40,39,99,267,267,0,RB
5339,Tracy Johnson,12,10,22,1994,28,SEA,16,10,12,44,3.7,2,2.8,4,58.3,15,10,91,9.1,0,5.7,66.7,6.1,6,53.3,22,44,135,135,0,FB
5340,Calvin Jones,22,2,24,1994,24,RAI,7,0,22,93,4.2,0,13.3,6,59.1,3,2,6,3,0,0.9,66.7,2,0,0,24,93,99,99,0,RB
5341,Victor Jones,0,0,0,1994,27,"KAN,PIT",11,0,0,0,,0,0,0,,0,0,0,,0,0,,,0,,0,0,0,0,0,RB
5342,James Joseph,60,43,103,1994,27,PHI,14,5,60,203,3.4,1,14.5,12,40,59,43,344,8,2,24.6,72.9,5.8,14,39,103,203,547,558,11,FB
5343,Yonel Jourdain,17,10,27,1994,23,BUF,9,0,17,56,3.3,0,6.2,2,29.4,10,10,56,5.6,0,6.2,100,5.6,2,40,27,56,112,713,601,RB
5344,Terry Kirby,60,14,74,1994,24,MIA,4,4,60,233,3.9,2,58.3,17,41.7,19,14,154,11,0,38.5,73.7,8.1,6,47.4,74,233,387,387,0,RB
5345,David Lang,6,8,14,1994,26,RAM,13,0,6,34,5.7,0,2.6,2,50,14,8,60,7.5,0,4.6,57.1,4.3,3,35.7,14,34,94,720,626,RB
5346,Amp Lee,29,45,74,1994,23,MIN,13,0,29,104,3.6,0,8,9,51.7,55,45,368,8.2,2,28.3,81.8,6.7,20,56.4,74,104,472,514,42,RB
5347,Burnie Legette,0,0,0,1994,24,NWE,3,0,0,0,,0,0,0,,0,0,0,,0,0,,,0,,0,0,0,0,0,RB
5348,Tim Lester,7,1,8,1994,26,RAM,14,4,7,14,2,0,1,1,42.9,5,1,1,1,0,0.1,20,0.2,0,0,8,14,15,23,8,RB
5349,Dorsey Levens,5,1,6,1994,24,GNB,14,0,5,15,3,0,1.1,1,40,3,1,9,9,0,0.6,33.3,3,0,33.3,6,15,24,55,31,RB
5350,Chuck Levy,3,4,7,1994,22,ARI,11,0,3,15,5,0,1.4,1,33.3,6,4,35,8.8,0,3.2,66.7,5.8,3,50,7,15,50,563,513,RB
5351,Marc Logan,33,16,49,1994,29,SFO,10,5,33,143,4.3,1,14.3,8,42.4,25,16,97,6.1,1,9.7,64,3.9,7,44,49,143,240,240,0,FB
5352,Derek Loville,31,2,33,1994,26,SFO,14,0,31,99,3.2,0,7.1,6,41.9,4,2,26,13,0,1.9,50,6.5,2,50,33,99,125,159,34,RB
5353,Eric Lynch,1,2,3,1994,24,DET,12,3,1,0,0,0,0,0,0,3,2,18,9,0,1.5,66.7,6,1,66.7,3,0,18,123,105,RB
5354,Le'Shai Maston,0,2,2,1994,24,HOU,5,1,0,0,,0,0,0,,2,2,12,6,0,2.4,100,6,1,50,2,0,12,12,0,RB
5355,Fred McAfee,18,1,19,1994,26,"ARI,PIT",13,0,18,51,2.8,2,3.9,6,55.6,1,1,4,4,0,0.3,100,4,0,0,19,51,55,168,113,RB
5356,Napoleon McCallum,3,0,3,1994,31,RAI,1,0,3,5,1.7,1,5,2,66.7,0,0,0,,0,0,,,0,,3,5,5,5,0,RB
5357,Anthony McDowell,21,29,50,1994,26,TAM,14,11,21,58,2.8,0,4.1,6,57.1,41,29,193,6.7,1,13.8,70.7,4.7,8,34.1,50,58,251,251,0,FB
5358,Todd McNair,0,8,8,1994,29,HOU,16,1,0,0,,0,0,0,,19,8,78,9.8,0,4.9,42.1,4.1,4,26.3,8,0,78,559,481,RB
5359,Natrone Means,343,39,382,1994,22,SDG,16,16,343,1350,3.9,12,84.4,81,51.3,43,39,235,6,0,14.7,90.7,5.5,10,55.8,382,1350,1585,1585,0,RB
5360,Dave Meggett,91,32,123,1994,28,NYG,16,3,91,298,3.3,4,18.6,0,0,40,32,293,9.2,0,18.3,80,7.3,0,0,123,307,591,1462,871,RB
5361,Eric Metcalf,93,47,140,1994,26,CLE,16,8,93,329,3.5,2,20.6,14,36.6,85,47,436,9.3,3,27.3,55.3,5.1,20,40,140,329,765,1323,558,RB
5362,Glyn Milburn,58,77,135,1994,23,DEN,16,3,58,201,3.5,1,12.6,10,31,106,77,549,7.1,3,34.3,72.6,5.2,29,42.5,135,201,750,1922,1172,RB
5363,Brian Mitchell,78,26,104,1994,26,WAS,16,7,78,311,4,0,19.4,19,48.7,53,26,236,9.1,1,14.8,49.1,4.5,9,34,104,311,547,2477,1930,FB
5364,Tyrone Montgomery,36,8,44,1994,24,RAI,6,6,36,97,2.7,0,16.2,8,47.2,10,8,126,15.8,1,21,80,12.6,2,50,44,97,223,223,0,RB
5365,Derrick Moore,27,1,28,1994,27,DET,16,0,27,52,1.9,4,3.3,11,40.7,1,1,10,10,0,0.6,100,10,1,100,28,52,62,175,113,RB
5366,Ronald Moore,232,8,240,1994,24,ARI,16,16,232,780,3.4,4,48.8,43,39.2,11,8,52,6.5,1,3.3,72.7,4.7,3,45.5,240,780,832,832,0,RB
5367,Bam Morris,198,22,220,1994,22,PIT,15,6,198,836,4.2,7,55.7,50,50.5,25,22,204,9.3,0,13.6,88,8.2,6,56,220,836,1040,1154,114,RB
5368,Adrian Murrell,33,7,40,1994,24,NYJ,10,1,33,160,4.8,0,16,8,51.5,9,7,76,10.9,0,7.6,77.8,8.4,4,66.7,40,160,236,504,268,RB
5369,Brad Muster,1,10,11,1994,29,NOR,7,1,1,3,3,1,0.4,1,100,11,10,88,8.8,0,12.6,90.9,8,5,72.7,11,3,91,91,0,RB
5370,Lorenzo Neal,30,2,32,1994,24,NOR,16,7,30,90,3,1,5.6,7,50,4,2,9,4.5,0,0.6,50,2.3,0,50,32,90,99,116,17,FB
5371,Derrick Ned,11,13,24,1994,25,NOR,16,1,11,36,3.3,0,2.3,1,27.3,17,13,86,6.6,0,5.4,76.5,5.1,6,41.2,24,36,122,199,77,FB
5372,Brian O'Neal,0,0,0,1994,24,PHI,14,0,0,0,,0,0,0,,0,0,0,,0,0,,,0,,0,0,0,0,0,FB
5373,Bernie Parmalee,216,34,250,1994,27,MIA,15,10,216,868,4,6,57.9,56,52.8,50,34,249,7.3,1,16.6,68,5,12,46,250,868,1117,1137,0,RB
5374,Erric Pegram,103,16,119,1994,25,ATL,13,5,103,358,3.5,1,27.5,15,39.8,20,16,99,6.2,0,7.6,80,5,5,35,119,358,457,604,145,RB
5375,Roosevelt Potts,77,26,103,1994,23,IND,16,15,77,336,4.4,1,21,23,54.5,42,26,251,9.7,1,15.7,61.9,6,11,42.9,103,336,587,587,0,FB
5376,Kenyon Rasheed,17,10,27,1994,24,NYG,16,7,17,44,2.6,0,2.8,1,29.4,13,10,97,9.7,0,6.1,76.9,7.5,6,69.2,27,44,141,141,0,FB
5377,Tom Rathman,28,26,54,1994,32,RAI,16,16,28,118,4.2,0,7.4,6,46.4,41,26,194,7.5,0,12.1,63.4,4.7,6,43.9,54,118,312,312,0,FB
5378,Errict Rhett,284,22,306,1994,24,TAM,16,8,284,1011,3.6,7,63.2,72,48.9,30,22,119,5.4,0,7.4,73.3,4,5,36.7,306,1011,1130,1130,0,RB
5379,Reggie Rivers,43,20,63,1994,26,DEN,16,1,43,83,1.9,2,5.2,7,39.5,26,20,136,6.8,0,8.5,76.9,5.2,5,46.2,63,83,219,219,0,RB
5380,Mazio Royster,9,7,16,1994,24,TAM,14,1,9,7,0.8,0,0.5,1,11.1,11,7,36,5.1,0,2.6,63.6,3.3,2,27.3,16,7,43,43,0,RB
5381,Tyrone Rush,0,0,0,1994,23,WAS,5,0,0,0,,0,0,0,,0,0,0,,0,0,,,0,,0,0,0,45,45,RB
5382,Leonard Russell,190,38,228,1994,25,DEN,14,13,190,620,3.3,9,44.3,44,44.2,46,38,227,6,0,16.2,82.6,4.9,8,52.2,228,620,847,847,0,RB
5383,Barry Sanders,331,44,375,1994,26,DET,16,16,331,1883,5.7,7,117.7,76,44.7,65,44,283,6.4,1,17.7,67.7,4.4,16,32.3,375,1883,2166,2166,0,RB
5384,James Saxon,8,27,35,1994,28,MIA,16,7,8,16,2,0,1,2,50,35,27,151,5.6,0,9.4,77.1,4.3,3,45.7,35,16,167,179,12,FB
5385,Cedric Smith,10,15,25,1994,26,WAS,14,8,10,48,4.8,0,3.4,5,90,22,15,118,7.9,1,8.4,68.2,5.4,7,50,25,48,166,166,0,FB
5386,Emmitt Smith,368,50,418,1994,25,DAL,15,15,368,1484,4,21,98.9,100,50.5,61,50,341,6.8,1,22.7,82,5.6,15,45.9,418,1484,1825,1825,0,RB
5387,Lamar Smith,2,0,2,1994,24,SEA,2,0,2,-1,-0.5,0,-0.5,0,0,0,0,0,,0,0,,,0,,2,-1,-1,-1,0,RB
5388,Robert Smith,31,15,46,1994,22,MIN,14,0,31,106,3.4,1,7.6,6,45.2,19,15,105,7,0,7.5,78.9,5.5,7,52.6,46,106,211,630,419,RB
5389,Steve Smith,26,11,37,1994,30,SEA,16,0,26,80,3.1,2,5,10,57.7,17,11,142,12.9,1,8.9,64.7,8.4,7,52.9,37,80,222,222,0,RB
5390,Tony Smith,0,0,0,1994,24,ATL,4,0,0,0,,0,0,0,,0,0,0,,0,0,,,0,,0,0,0,408,408,RB
5391,Irving Spikes,70,4,74,1994,24,MIA,12,1,70,312,4.5,2,26,19,60,7,4,16,4,0,1.3,57.1,2.3,0,28.6,74,312,328,762,434,RB
5392,Deon Strother,0,0,0,1994,22,DEN,2,0,0,0,,0,0,0,,0,0,0,,0,0,,,0,,0,0,0,0,0,RB
5393,Mack Strong,27,3,30,1994,23,SEA,8,1,27,114,4.2,2,14.3,7,51.9,4,3,3,1,0,0.4,75,0.8,0,25,30,114,117,117,0,FB
5394,Blair Thomas,43,4,47,1994,27,"DAL,NWE",6,1,43,137,3.2,2,22.8,9,44.2,5,4,16,4,0,2.7,80,3.2,0,40,47,137,153,193,40,RB
5395,Darrell Thompson,2,0,2,1994,27,GNB,8,0,2,-2,-1,0,-0.3,0,0,0,0,0,,0,0,,,0,,2,-2,-2,65,67,RB
5396,Leroy Thompson,102,65,167,1994,25,NWE,16,1,102,312,3.1,2,19.5,13,35.3,86,65,465,7.2,5,29.1,75.6,5.4,24,50,167,312,777,1153,376,RB
5397,Thurman Thomas,287,50,337,1994,28,BUF,15,15,287,1093,3.8,7,72.9,64,47.4,71,50,349,7,2,23.3,70.4,4.9,16,43.7,337,1093,1442,1442,0,RB
5398,Lewis Tillman,275,27,302,1994,28,CHI,16,15,275,899,3.3,7,56.2,45,39.3,39,27,222,8.2,0,13.9,69.2,5.7,5,51.3,302,899,1121,1121,0,RB
5399,Spencer Tillman,2,0,2,1994,30,HOU,16,0,2,12,6,0,0.8,0,0,0,0,0,,0,0,,,0,,2,12,12,63,51,RB
5400,Ed Toner,1,0,1,1994,26,IND,9,0,1,11,11,0,1.2,0,0,0,0,0,,0,0,,,0,,1,11,11,19,8,RB
5401,Kevin Turner,36,52,88,1994,25,NWE,16,9,36,111,3.1,1,6.9,10,38.9,74,52,471,9.1,2,29.4,70.3,6.4,21,59.5,88,111,582,579,0,FB
5402,Tommy Vardell,15,16,31,1994,25,CLE,5,5,15,48,3.2,0,9.6,2,40,19,16,137,8.6,1,27.4,84.2,7.2,6,63.2,31,48,185,185,0,FB
5403,Jon Vaughn,27,1,28,1994,24,"KAN,SEA",13,0,27,96,3.6,1,7.4,8,44.4,2,1,5,5,1,0.4,50,2.5,1,50,28,96,101,930,829,RB
5404,Adam Walker,13,0,13,1994,26,SFO,8,0,13,54,4.2,1,6.8,2,30.8,1,0,0,,0,0,0,0,0,0,13,54,54,136,82,RB
5405,Herschel Walker,113,50,163,1994,32,PHI,16,14,113,528,4.7,5,33,22,48.7,81,50,500,10,2,31.3,61.7,6.2,19,37,163,528,1028,1609,581,RB
5406,Chris Warren,333,41,374,1994,26,SEA,16,15,333,1545,4.6,9,96.6,73,47.4,61,41,323,7.9,2,20.2,67.2,5.3,10,31.1,374,1545,1868,1868,0,RB
5407,Lamont Warren,18,3,21,1994,21,IND,11,0,18,80,4.4,0,7.3,4,27.8,5,3,47,15.7,0,4.3,60,9.4,1,40,21,80,127,183,56,RB
5408,Ricky Watters,239,66,305,1994,25,SFO,16,16,239,877,3.7,6,54.8,49,47.7,88,66,719,10.9,5,44.9,75,8.2,27,54.5,305,877,1596,1596,0,RB
5409,Lorenzo White,191,21,212,1994,28,HOU,15,8,191,757,4,3,50.5,37,45.5,42,21,188,9,1,12.5,50,4.5,9,26.2,212,757,945,1111,167,RB
5410,Harvey Williams,282,47,329,1994,27,RAI,16,10,282,983,3.5,4,61.4,45,41.8,64,47,391,8.3,3,24.4,73.4,6.1,16,45.3,329,983,1374,1527,153,RB
5411,John Williams,68,51,119,1994,30,PIT,15,12,68,317,4.7,1,21.1,0,0,68,51,378,7.4,2,25.2,75,5.6,0,0,119,317,695,695,0,FB
5412,Marcus Wilson,0,0,0,1994,26,GNB,12,0,0,0,,0,0,0,,0,0,0,,0,0,,,0,,0,0,0,14,14,RB
5413,Robert Wilson,1,0,1,1994,25,"DAL,MIA",4,0,1,-1,-1,0,-0.3,0,0,0,0,0,,0,0,,,0,,1,-1,-1,-1,0,RB
5414,Barry Word,0,0,0,1994,31,ARI,1,0,0,0,,0,0,0,,0,0,0,,0,0,,,0,,0,0,0,0,0,RB
5415,Vince Workman,79,11,90,1994,26,TAM,15,8,79,291,3.7,0,19.4,13,40.5,20,11,82,7.5,0,5.5,55,4.1,5,30,90,291,373,373,0,RB
5416,Tim Worley,9,1,10,1994,28,CHI,5,0,9,17,1.9,1,3.4,2,44.4,1,1,8,8,0,1.6,100,8,0,100,10,17,25,77,52,RB
5417,Tommie Agee,6,0,6,1993,29,DAL,12,0,6,13,2.2,0,1.1,1,33.3,0,0,0,,0,0,,,0,,6,13,13,13,0,RB
5418,Marcus Allen,206,34,240,1993,33,KAN,16,10,206,764,3.7,12,47.8,55,47.1,46,34,238,7,3,14.9,73.9,5.2,17,47.8,240,764,1002,1002,0,RB
5419,Gary Anderson,28,11,39,1993,32,"DET,TAM",10,1,28,56,2,0,5.6,4,32.1,15,11,89,8.1,1,8.9,73.3,5.9,3,46.7,39,56,145,490,345,RB
5420,Kimble Anders,75,40,115,1993,27,KAN,16,13,75,291,3.9,0,18.2,9,44,56,40,326,8.2,1,20.4,71.4,5.8,19,44.6,115,286,617,664,47,FB
5421,Neal Anderson,202,31,233,1993,29,CHI,15,11,202,646,3.2,4,43.1,33,33.7,48,31,160,5.2,0,10.7,64.6,3.3,8,25,233,646,806,806,0,RB
5422,Richie Anderson,0,0,0,1993,22,NYJ,7,0,0,0,,0,0,0,,1,0,0,,0,0,0,0,0,0,0,0,0,66,66,FB
5423,Steve Avery,0,0,0,1993,27,PIT,0,0,0,0,,0,,0,,0,0,0,,0,,,,0,,0,0,0,0,0,RB
5424,Johnny Bailey,49,32,81,1993,26,PHO,13,0,49,253,5.2,1,19.5,17,55.1,40,32,243,7.6,0,18.7,80,6.1,14,52.5,81,253,496,1477,981,RB
5425,Randy Baldwin,18,1,19,1993,26,CLE,14,0,18,61,3.4,0,4.4,4,33.3,1,1,5,5,1,0.4,100,5,1,100,19,61,66,510,444,RB
5426,Eric Ball,8,4,12,1993,27,CIN,15,1,8,37,4.6,1,2.5,4,50,5,4,39,9.8,0,2.6,80,7.8,0,60,12,37,76,577,501,RB
5427,Michael Bates,2,1,3,1993,24,SEA,16,1,2,12,6,0,0.8,0,0,3,1,6,6,0,0.4,33.3,2,0,0,3,12,18,624,603,RB
5428,Brad Baxter,174,20,194,1993,26,NYJ,16,13,174,559,3.2,7,34.9,34,48.3,36,20,158,7.9,0,9.9,55.6,4.4,5,36.1,194,559,717,717,0,FB
5429,Nick Bell,67,11,78,1993,25,RAI,10,3,67,180,2.7,1,18,10,34.3,15,11,111,10.1,0,11.1,73.3,7.4,6,53.3,78,180,291,291,0,RB
5430,Ryan Benjamin,3,1,4,1993,23,CIN,1,0,3,5,1.7,0,5,0,0,1,1,16,16,0,16,100,16,1,100,4,5,21,99,78,RB
5431,Edgar Bennett,159,59,218,1993,24,GNB,16,14,159,550,3.5,9,34.4,46,52.2,74,59,457,7.7,1,28.6,79.7,6.2,19,44.6,218,550,1007,1007,0,FB
5432,Rod Bernstine,223,44,267,1993,28,DEN,15,14,223,816,3.7,4,54.4,41,51.6,61,44,372,8.5,0,24.8,72.1,6.1,17,49.2,267,816,1188,1188,0,RB
5433,Jerome Bettis,294,26,320,1993,21,RAM,16,12,294,1429,4.9,7,89.3,79,57.5,34,26,244,9.4,0,15.3,76.5,7.2,9,52.9,320,1429,1673,1673,0,RB
5434,Eric Bieniemy,33,1,34,1993,24,SDG,16,0,33,135,4.1,1,8.4,9,60.6,1,1,0,0,0,0,100,0,0,0,34,135,135,245,110,RB
5435,Reggie Brooks,223,21,244,1993,22,WAS,16,11,223,1063,4.8,3,66.4,43,45.3,35,21,186,8.9,0,11.6,60,5.3,7,40,244,1063,1249,1261,12,RB
5436,Steve Broussard,39,1,40,1993,26,ATL,8,0,39,206,5.3,1,25.8,15,66.7,2,1,4,4,0,0.5,50,2,1,50,40,206,210,210,0,RB
5437,Derek Brown,180,21,201,1993,22,NOR,13,12,180,705,3.9,2,54.2,35,43.3,32,21,170,8.1,1,13.1,65.6,5.3,8,50,201,705,875,933,58,RB
5438,Gary Brown,195,21,216,1993,24,HOU,16,8,195,1002,5.1,6,62.6,55,62.1,30,21,240,11.4,2,15,70,8,11,43.3,216,1002,1242,1275,29,RB
5439,Jarrod Bunch,33,13,46,1993,25,NYG,13,8,33,128,3.9,2,9.8,7,72.7,18,13,98,7.5,1,7.5,72.2,5.4,4,55.6,46,128,226,226,0,FB
5440,Marion Butts,185,15,200,1993,27,SDG,16,16,185,746,4,4,46.6,35,47.6,24,15,105,7,0,6.6,62.5,4.4,2,29.2,200,746,851,851,0,RB
5441,Keith Byars,64,61,125,1993,30,MIA,16,16,64,269,4.2,3,16.8,15,46.9,84,61,613,10,3,38.3,72.6,7.3,34,65.5,125,280,882,882,0,FB
5442,Earnest Byner,23,27,50,1993,31,WAS,16,3,23,105,4.6,1,6.6,5,26.1,52,27,194,7.2,0,12.1,51.9,3.7,10,30.8,50,105,299,299,0,RB
5443,Dexter Carter,10,3,13,1993,26,SFO,16,0,10,72,7.2,1,4.5,3,30,9,3,40,13.3,0,2.5,33.3,4.4,2,22.2,13,72,112,1017,905,RB
5444,Larry Centers,25,66,91,1993,25,PHO,16,9,25,152,6.1,0,9.5,9,76,86,66,603,9.1,3,37.7,76.7,7,33,57,91,152,755,755,0,FB
5445,Pat Chaffey,5,4,9,1993,26,NYJ,3,0,5,17,3.4,0,5.7,2,60,4,4,55,13.8,1,18.3,100,13.8,3,100,9,17,72,72,0,RB
5446,Bob Christian,8,16,24,1993,25,CHI,14,1,8,19,2.4,0,1.4,1,12.5,24,16,160,10,0,11.4,66.7,6.7,6,41.7,24,19,179,179,0,RB
5447,Reggie Cobb,221,9,230,1993,25,TAM,12,10,221,658,3,3,54.8,37,39.4,14,9,61,6.8,1,5.1,64.3,4.4,4,35.7,230,658,719,719,0,RB
5448,Lincoln Coleman,34,4,38,1993,24,DAL,7,0,34,132,3.9,2,18.9,6,47.1,4,4,24,6,0,3.4,100,6,1,50,38,132,156,156,0,FB
5449,Roger Craig,38,19,57,1993,33,MIN,14,3,38,119,3.1,1,8.5,4,28.9,32,19,169,8.9,1,12.1,59.4,5.3,7,37.5,57,119,288,299,11,RB
5450,Corey Croom,60,8,68,1993,22,NWE,14,1,60,198,3.3,1,14.1,13,38.3,18,8,92,11.5,0,6.6,44.4,5.1,4,27.8,68,198,290,290,0,RB
5451,Rodney Culver,65,11,76,1993,24,IND,16,1,65,150,2.3,3,9.4,19,49.2,15,11,112,10.2,1,7,73.3,7.5,6,60,76,150,262,369,51,RB
5452,Randy Cuthbert,1,1,2,1993,23,PIT,10,0,1,7,7,0,0.7,1,100,1,1,3,3,0,0.3,100,3,0,0,2,7,10,10,0,RB
5453,Kenneth Davis,109,21,130,1993,31,BUF,16,0,109,391,3.6,6,24.4,27,43.1,24,21,95,4.5,0,5.9,87.5,4,4,29.2,130,391,486,586,100,RB
5454,Robert Delpino,131,26,157,1993,28,DEN,16,4,131,445,3.4,8,27.8,36,47.3,36,26,195,7.5,0,12.2,72.2,5.4,7,38.9,157,445,640,786,146,RB
5455,Eric Dickerson,26,6,32,1993,33,ATL,4,2,26,91,3.5,0,22.8,4,46.2,8,6,58,9.7,0,14.5,75,7.3,2,50,32,91,149,149,0,RB
5456,Ron Dickerson,0,0,0,1993,22,KAN,6,0,0,0,,0,0,0,,0,0,0,,0,0,,,0,,0,0,0,237,237,RB
5457,Ricky Ervins,50,16,66,1993,25,WAS,15,1,50,201,4,0,13.4,10,48,20,16,123,7.7,0,8.2,80,6.2,5,45,66,201,324,353,29,RB
5458,Charles Evans,14,4,18,1993,26,MIN,3,0,14,32,2.3,0,10.7,1,35.7,4,4,39,9.8,0,13,100,9.8,2,75,18,32,71,82,11,RB
5459,Derrick Fenner,121,48,169,1993,26,CIN,15,14,121,482,4,1,32.1,36,45.5,64,48,427,8.9,0,28.5,75,6.7,16,46.9,169,482,909,909,0,FB
5460,Barry Foster,177,27,204,1993,25,PIT,9,9,177,711,4,8,79,44,46.9,34,27,217,8,1,24.1,79.4,6.4,11,61.8,204,711,928,928,0,RB
5461,Eddie Fuller,0,0,0,1993,25,BUF,7,0,0,0,,0,0,0,,0,0,0,,0,0,,,0,,0,0,0,0,0,RB
5462,Derrick Gainer,9,6,15,1993,27,DAL,11,0,9,29,3.2,0,2.6,1,33.3,7,6,37,6.2,0,3.4,85.7,5.3,3,57.1,15,29,66,66,0,RB
5463,Carwell Gardner,20,4,24,1993,27,BUF,13,2,20,56,2.8,0,4.3,7,50,7,4,50,12.5,1,3.8,57.1,7.1,3,57.1,24,56,106,106,0,FB
5464,Cleveland Gary,79,36,115,1993,27,RAM,15,4,79,293,3.7,1,19.5,19,45.6,48,36,289,8,1,19.3,75,6,11,35.4,115,301,582,582,0,RB
5465,Sam Gash,48,14,62,1993,24,NWE,15,4,48,149,3.1,1,9.9,15,45.8,17,14,93,6.6,0,6.2,82.4,5.5,5,47.1,62,149,242,242,0,FB
5466,Scottie Graham,118,7,125,1993,24,MIN,7,3,118,488,4.1,3,69.7,30,54.2,12,7,46,6.6,0,6.6,58.3,3.8,2,50,125,488,534,550,16,RB
5467,Harold Green,215,22,237,1993,25,CIN,15,15,215,589,2.7,0,39.3,30,34.4,31,22,115,5.2,0,7.7,71,3.7,3,35.5,237,589,704,704,0,RB
5468,Robert Green,15,13,28,1993,23,CHI,16,0,15,29,1.9,0,1.8,3,26.7,17,13,63,4.8,0,3.9,76.5,3.7,2,23.5,28,29,92,233,141,RB
5469,Howard Griffith,0,0,0,1993,26,RAM,15,0,0,0,,0,0,0,,0,0,0,,0,0,,,0,,0,0,0,169,169,RB
5470,Rodney Hampton,292,18,310,1993,24,NYG,12,10,292,1077,3.7,5,89.8,63,46.6,23,18,210,11.7,0,17.5,78.3,9.1,7,47.8,310,1077,1287,1287,0,RB
5471,Ronnie Harmon,46,73,119,1993,29,SDG,16,1,46,216,4.7,0,13.5,15,56.5,103,73,671,9.2,2,41.9,70.9,6.5,31,48.5,119,216,887,905,18,RB
5472,Rudy Harris,7,4,11,1993,22,TAM,10,2,7,29,4.1,0,2.9,1,28.6,8,4,48,12,0,4.8,50,6,2,37.5,11,29,77,77,0,RB
5473,Garrison Hearst,76,6,82,1993,22,PHO,6,5,76,264,3.5,1,44,12,39.5,9,6,18,3,0,3,66.7,2,1,22.2,82,264,282,282,0,RB
5474,Vaughn Hebron,84,11,95,1993,23,PHI,16,4,84,297,3.5,3,18.6,19,46.4,17,11,82,7.5,0,5.1,64.7,4.8,1,52.9,95,297,379,414,35,RB
5475,Craig Heyward,68,16,84,1993,27,CHI,16,14,68,206,3,0,12.9,13,54.4,21,16,132,8.3,0,8.3,76.2,6.3,6,66.7,84,206,338,350,12,FB
5476,Mark Higgs,186,10,196,1993,27,MIA,16,8,186,693,3.7,3,43.3,35,41.9,12,10,72,7.2,0,4.5,83.3,6,1,58.3,196,693,765,765,0,RB
5477,Dalton Hilliard,50,40,90,1993,29,NOR,16,0,50,165,3.3,2,10.3,14,46,66,40,296,7.4,1,18.5,60.6,4.5,11,34.8,90,165,461,478,17,RB
5478,Leroy Hoard,56,35,91,1993,25,CLE,16,7,56,227,4.1,0,14.2,11,37.5,69,35,351,10,0,21.9,50.7,5.1,16,31.9,91,227,578,864,286,FB
5479,Merril Hoge,51,33,84,1993,28,PIT,16,13,51,249,4.9,1,15.6,14,47.1,56,33,247,7.5,4,15.4,58.9,4.4,13,41.1,84,249,496,533,33,FB
5480,John Ivlow,0,0,0,1993,23,CHI,2,0,0,0,,0,0,0,,0,0,0,,0,0,,,0,,0,0,0,0,0,RB
5481,Anthony Johnson,95,55,150,1993,26,IND,13,8,95,331,3.5,1,25.5,17,42.1,68,55,443,8.1,0,34.1,80.9,6.5,21,54.4,150,331,774,774,0,FB
5482,Daryl Johnston,24,50,74,1993,27,DAL,16,16,24,74,3.1,3,4.6,14,75,60,50,372,7.4,1,23.3,83.3,6.2,17,58.3,74,74,446,446,0,FB
5483,Johnny Johnson,198,67,265,1993,25,NYJ,15,9,198,821,4.1,3,54.7,40,48.5,83,67,641,9.6,1,42.7,80.7,7.7,32,57.8,265,821,1462,1462,0,RB
5484,Tracy Johnson,2,3,5,1993,27,SEA,16,1,2,8,4,0,0.5,0,50,3,3,15,5,1,0.9,100,5,2,100,5,8,23,23,0,RB
5485,Victor Jones,0,0,0,1993,26,PIT,16,0,0,0,,0,0,0,,0,0,0,,0,0,,,0,,0,0,0,0,0,RB
5486,Randy Jordan,12,4,16,1993,23,RAI,10,2,12,33,2.8,0,3.3,2,25,5,4,42,10.5,0,4.2,80,8.4,1,40,16,33,75,75,0,RB
5487,James Joseph,39,29,68,1993,26,PHI,16,5,39,140,3.6,0,8.8,10,48.7,41,29,291,10,1,18.2,70.7,7.1,18,53.7,68,140,431,431,0,FB
5488,Terry Kirby,119,75,194,1993,23,MIA,16,8,119,390,3.3,3,24.4,25,37.8,95,75,874,11.7,3,54.6,78.9,9.2,37,60,194,390,1264,1349,85,RB
5489,David Lang,9,4,13,1993,25,RAM,6,0,9,29,3.2,0,4.8,1,22.2,10,4,45,11.3,0,7.5,40,4.5,3,40,13,29,74,74,0,RB
5490,Derrick Lassic,75,9,84,1993,23,DAL,10,3,75,269,3.6,3,26.9,13,46.7,13,9,37,4.1,0,3.7,69.2,2.8,0,38.5,84,269,306,306,0,RB
5491,Amp Lee,72,16,88,1993,22,SFO,15,3,72,230,3.2,1,15.3,14,48.6,20,16,115,7.2,2,7.7,80,5.8,6,50,88,230,345,505,160,RB
5492,Burnie Legette,0,0,0,1993,23,NWE,7,0,0,0,,0,0,0,,0,0,0,,0,0,,,0,,0,0,0,0,0,RB
5493,Tim Lester,11,18,29,1993,25,RAM,16,14,11,74,6.7,0,4.6,8,81.8,28,18,154,8.6,0,9.6,64.3,5.5,6,46.4,29,74,228,228,0,FB
5494,Darren Lewis,7,4,11,1993,25,CHI,2,1,7,13,1.9,0,6.5,0,14.3,5,4,26,6.5,0,13,80,5.2,1,20,11,13,39,39,0,RB
5495,Scott Lockwood,0,0,0,1993,25,NWE,2,0,0,0,,0,0,0,,0,0,0,,0,0,,,0,,0,0,0,0,0,RB
5496,Marc Logan,58,37,95,1993,28,SFO,14,12,58,280,4.8,7,20,21,56.9,48,37,348,9.4,0,24.9,77.1,7.3,15,58.3,95,280,628,628,0,FB
5497,Eric Lynch,53,13,66,1993,23,DET,4,2,53,207,3.9,2,51.8,11,50.9,16,13,82,6.3,0,20.5,81.3,5.1,3,50,66,207,289,311,22,RB
5498,Anthony Lynn,0,0,0,1993,25,DEN,13,0,0,0,,0,0,0,,0,0,0,,0,0,,,0,,0,0,0,0,0,RB
5499,Kevin Mack,10,0,10,1993,31,CLE,4,0,10,33,3.3,1,8.3,2,40,0,0,0,,0,0,,,0,,10,33,33,33,0,RB
5500,Le'Shai Maston,1,1,2,1993,23,HOU,10,0,1,10,10,0,1,0,100,1,1,14,14,0,1.4,100,14,1,100,2,10,24,24,0,RB
5501,Rueben Mayes,1,0,1,1993,30,SEA,1,0,1,2,2,0,2,0,0,0,0,0,,0,0,,,0,,1,2,2,2,0,RB
5502,Fred McAfee,51,1,52,1993,25,NOR,15,4,51,160,3.1,1,10.7,7,35.3,2,1,3,3,0,0.2,50,1.5,0,0,52,160,163,743,580,RB
5503,Napoleon McCallum,37,2,39,1993,30,RAI,13,1,37,114,3.1,3,8.8,7,48.6,3,2,5,2.5,0,0.4,66.7,1.7,0,0,39,114,119,131,12,RB
5504,Anthony McDowell,2,8,10,1993,25,TAM,4,3,2,6,3,0,1.5,0,0,13,8,26,3.3,1,6.5,61.5,2,1,30.8,10,6,32,32,0,RB
5505,Dexter McNabb,0,0,0,1993,24,GNB,16,0,0,0,,0,0,0,,0,0,0,,0,0,,,0,,0,0,0,0,0,FB
5506,Todd McNair,51,10,61,1993,28,KAN,15,1,51,278,5.5,2,18.5,15,52.9,15,10,74,7.4,0,4.9,66.7,4.9,5,40,61,278,352,380,28,RB
5507,Natrone Means,160,10,170,1993,21,SDG,16,0,160,645,4,8,40.3,48,51.3,18,10,59,5.9,0,3.7,55.6,3.3,3,38.9,170,645,704,726,22,RB
5508,Dave Meggett,69,38,107,1993,27,NYG,16,1,69,329,4.8,0,20.6,17,44.9,50,38,319,8.4,0,19.9,76,6.4,11,48,107,392,648,1382,734,RB
5509,Eric Metcalf,129,63,192,1993,25,CLE,16,9,129,611,4.7,1,38.2,25,42.6,84,63,539,8.6,2,33.7,75,6.4,21,40.5,192,611,1150,1932,782,RB
5510,Glyn Milburn,52,38,90,1993,22,DEN,16,2,52,231,4.4,0,14.4,14,38.5,54,38,300,7.9,3,18.8,70.4,5.6,13,38.9,90,231,531,1144,613,RB
5511,Ostell Miles,22,6,28,1993,23,CIN,15,2,22,56,2.5,1,3.7,3,22.7,7,6,89,14.8,0,5.9,85.7,12.7,4,71.4,28,56,145,210,65,RB
5512,Brian Mitchell,63,20,83,1993,25,WAS,16,4,63,246,3.9,3,15.4,24,60.3,21,20,157,7.9,0,9.8,95.2,7.5,7,66.7,83,296,403,1274,871,RB
5513,Tyrone Montgomery,37,10,47,1993,23,RAI,12,0,37,106,2.9,0,8.8,10,37.8,23,10,43,4.3,0,3.6,43.5,1.9,1,21.7,47,106,149,149,0,RB
5514,Derrick Moore,88,21,109,1993,26,DET,13,3,88,405,4.6,3,31.2,32,53.4,24,21,169,8,1,13,87.5,7,6,50,109,405,574,642,68,RB
5515,Ronald Moore,263,3,266,1993,23,PHO,16,11,263,1018,3.9,9,63.6,61,46,7,3,16,5.3,0,1,42.9,2.3,0,28.6,266,1018,1034,1043,9,RB
5516,Adrian Murrell,34,5,39,1993,23,NYJ,16,0,34,157,4.6,1,9.8,6,38.2,7,5,12,2.4,0,0.8,71.4,1.7,0,14.3,39,157,169,511,342,RB
5517,Brad Muster,64,23,87,1993,28,NOR,13,11,64,214,3.3,3,16.5,14,45.3,33,23,195,8.5,0,15,69.7,5.9,11,51.5,87,214,409,409,0,FB
5518,Lorenzo Neal,21,0,21,1993,23,NOR,2,2,21,175,8.3,1,87.5,6,42.9,0,0,0,,0,0,,,0,,21,175,175,175,0,FB
5519,Derrick Ned,9,9,18,1993,24,NOR,14,1,9,71,7.9,1,5.1,4,55.6,13,9,54,6,0,3.9,69.2,4.2,2,46.2,18,71,125,125,0,FB
5520,Bernie Parmalee,4,1,5,1993,26,MIA,16,0,4,16,4,0,1,2,75,1,1,1,1,0,0.1,100,1,0,0,5,16,17,17,0,RB
5521,Erric Pegram,292,33,325,1993,24,ATL,16,14,292,1185,4.1,3,74.1,65,46.6,42,33,302,9.2,0,18.9,78.6,7.2,12,57.1,325,1185,1487,1550,63,RB
5522,Roosevelt Potts,179,26,205,1993,22,IND,16,15,179,711,4,0,44.4,32,46.4,34,26,189,7.3,0,11.8,76.5,5.6,8,41.2,205,711,900,900,0,RB
5523,Kenyon Rasheed,9,1,10,1993,23,NYG,5,3,9,42,4.7,1,8.4,2,44.4,1,1,3,3,0,0.6,100,3,0,100,10,42,45,45,0,FB
5524,Tom Rathman,19,10,29,1993,31,SFO,8,4,19,80,4.2,3,10,7,57.9,14,10,86,8.6,0,10.8,71.4,6.1,5,57.1,29,80,166,166,0,RB
5525,Curvin Richards,4,0,4,1993,25,DET,1,0,4,1,0.3,0,1,0,0,0,0,0,,0,0,,,0,,4,1,1,1,0,RB
5526,Reggie Rivers,15,6,21,1993,25,DEN,16,2,15,50,3.3,1,3.1,3,26.7,7,6,59,9.8,1,3.7,85.7,8.4,3,71.4,21,50,109,109,0,RB
5527,Greg Robinson,156,15,171,1993,24,RAI,12,12,156,591,3.8,1,49.3,29,44.9,21,15,142,9.5,0,11.8,71.4,6.8,1,57.1,171,591,733,790,57,RB
5528,Mazio Royster,33,5,38,1993,23,TAM,14,0,33,115,3.5,1,8.2,7,48.5,5,5,18,3.6,0,1.3,100,3.6,1,60,38,115,133,235,102,RB
5529,Leonard Russell,300,26,326,1993,24,NWE,16,15,300,1088,3.6,7,68,66,43,37,26,245,9.4,0,15.3,70.3,6.6,9,43.2,326,1088,1333,1355,0,RB
5530,Barry Sanders,243,36,279,1993,25,DET,11,11,243,1115,4.6,3,101.4,46,42.4,48,36,205,5.7,0,18.6,75,4.3,6,33.3,279,1115,1320,1320,0,RB
5531,James Saxon,5,0,5,1993,27,MIA,16,0,5,13,2.6,0,0.8,1,40,0,0,0,,0,0,,,0,,5,13,13,20,7,FB
5532,Heath Sherman,115,12,127,1993,26,PHI,15,7,115,406,3.5,2,27.1,29,45.2,15,12,78,6.5,0,5.2,80,5.2,5,40,127,406,484,484,0,FB
5533,Vai Sikahema,0,0,0,1993,31,PHI,16,0,0,0,,0,0,0,,0,0,0,,0,0,,,0,,0,0,0,854,854,RB
5534,Emmitt Smith,283,57,340,1993,24,DAL,14,13,283,1486,5.3,9,106.1,74,57.6,65,57,414,7.3,1,29.6,87.7,6.4,13,43.1,340,1486,1900,1900,0,RB
5535,Robert Smith,82,24,106,1993,21,MIN,10,2,82,399,4.9,2,39.9,19,58.5,32,24,111,4.6,0,11.1,75,3.5,4,25,106,399,510,555,45,RB
5536,Steve Smith,47,18,65,1993,29,RAI,16,13,47,156,3.3,0,9.8,10,48.9,23,18,187,10.4,0,11.7,78.3,8.1,6,52.2,65,156,343,343,0,FB
5537,Tony Smith,0,0,0,1993,23,ATL,15,0,0,0,,0,0,0,,0,0,0,,0,0,,,0,,0,0,0,1203,1203,RB
5538,John Stephens,54,5,59,1993,27,"GNB,KAN",12,5,54,191,3.5,1,15.9,8,42.6,8,5,31,6.2,0,2.6,62.5,3.9,1,25,59,191,222,310,88,RB
5539,Blair Thomas,59,7,66,1993,26,NYJ,11,5,59,221,3.7,1,20.1,8,45.8,11,7,25,3.6,0,2.3,63.6,2.3,1,27.3,66,221,246,285,39,RB
5540,Darrell Thompson,169,18,187,1993,26,GNB,16,11,169,654,3.9,3,40.9,30,41.4,29,18,129,7.2,0,8.1,62.1,4.4,6,31,187,654,783,954,171,RB
5541,Ernie Thompson,11,4,15,1993,24,KAN,16,2,11,28,2.5,0,1.8,1,36.4,5,4,33,8.3,0,2.1,80,6.6,2,80,15,28,61,61,0,RB
5542,Leroy Thompson,205,38,243,1993,24,PIT,15,6,205,763,3.7,3,50.9,45,42.9,46,38,259,6.8,0,17.3,82.6,5.6,14,50,243,763,1022,1099,77,RB
5543,Thurman Thomas,355,48,403,1993,27,BUF,16,16,355,1315,3.7,6,82.2,70,46.8,71,48,387,8.1,0,24.2,67.6,5.5,19,46.5,403,1315,1702,1702,0,RB
5544,Lewis Tillman,121,1,122,1993,27,NYG,16,7,121,585,4.8,3,36.6,30,54.5,2,1,21,21,0,1.3,50,10.5,1,50,122,585,606,587,0,RB
5545,Spencer Tillman,9,1,10,1993,29,HOU,15,0,9,94,10.4,0,6.3,5,88.9,2,1,4,4,1,0.3,50,2,1,50,10,94,98,98,0,RB
5546,Ed Toner,2,1,3,1993,25,IND,16,1,2,6,3,0,0.4,0,0,1,1,5,5,0,0.3,100,5,0,0,3,6,11,11,0,RB
5547,Kevin Turner,50,39,89,1993,24,NWE,16,9,50,231,4.6,0,14.4,15,56,57,39,333,8.5,2,20.8,68.4,5.8,20,52.6,89,231,564,570,0,FB
5548,Tommy Vardell,171,19,190,1993,24,CLE,16,12,171,644,3.8,3,40.3,37,46.2,23,19,151,7.9,1,9.4,82.6,6.6,8,52.2,190,644,795,853,58,FB
5549,Jon Vaughn,36,0,36,1993,23,SEA,16,2,36,153,4.3,0,9.6,8,50,1,0,0,,0,0,0,0,0,0,36,153,153,433,280,RB
5550,Adam Walker,5,1,6,1993,25,SFO,10,0,5,17,3.4,0,1.7,1,20,1,1,4,4,0,0.4,100,4,0,0,6,17,21,72,51,RB
5551,Herschel Walker,174,75,249,1993,31,PHI,16,16,174,746,4.3,1,46.6,33,50,91,75,610,8.1,3,38.1,82.4,6.7,34,50.5,249,741,1356,1540,184,RB
5552,Chris Warren,273,15,288,1993,25,SEA,14,14,273,1072,3.9,7,76.6,60,44.7,21,15,99,6.6,0,7.1,71.4,4.7,3,23.8,288,1072,1171,1171,0,RB
5553,Ricky Watters,208,31,239,1993,24,SFO,13,13,208,950,4.6,10,73.1,53,53.4,45,31,326,10.5,1,25.1,68.9,7.2,12,57.8,239,950,1276,1276,0,RB
5554,Lorenzo White,131,34,165,1993,27,HOU,8,8,131,465,3.5,2,58.1,23,48.9,44,34,229,6.7,0,28.6,77.3,5.2,6,45.5,165,465,694,694,0,RB
5555,Russell White,2,0,2,1993,23,RAM,5,0,2,10,5,0,2,1,100,1,0,0,,0,0,0,0,0,0,2,10,10,132,122,RB
5556,Harvey Williams,42,7,49,1993,26,KAN,7,6,42,149,3.5,0,21.3,5,40.5,9,7,42,6,0,6,77.8,4.7,2,44.4,49,149,191,244,53,RB
5557,John Williams,82,58,140,1993,29,SEA,16,9,82,371,4.5,3,23.2,24,53.7,90,58,450,7.8,1,28.1,64.4,5,16,40,140,371,821,821,0,FB
5558,Kevin Williams,0,0,0,1993,23,GNB,3,0,0,0,,0,0,0,,0,0,0,,0,0,,,0,,0,0,0,0,0,RB
5559,Warren Williams,0,0,0,1993,28,IND,5,0,0,0,,0,0,0,,0,0,0,,0,0,,,0,,0,0,0,0,0,RB
5560,Marcus Wilson,6,2,8,1993,25,GNB,16,0,6,3,0.5,0,0.2,1,16.7,2,2,18,9,0,1.1,100,9,1,50,8,3,21,218,197,RB
5561,Ron Wolfley,0,5,5,1993,31,CLE,16,5,0,0,,0,0,0,,8,5,25,5,1,1.6,62.5,3.1,1,50,5,0,25,25,0,RB
5562,Barry Word,142,9,151,1993,30,MIN,13,8,142,458,3.2,2,35.2,25,42.3,17,9,105,11.7,0,8.1,52.9,6.2,4,41.2,151,458,563,563,0,RB
5563,Vince Workman,78,54,132,1993,25,TAM,16,11,78,284,3.6,2,17.8,23,44.9,77,54,411,7.6,2,25.7,70.1,5.3,16,39,132,284,695,762,67,FB
5564,Tim Worley,120,11,131,1993,27,"CHI,PIT",15,3,120,470,3.9,2,31.3,27,47.5,15,11,62,5.6,0,4.1,73.3,4.1,3,40,131,470,532,653,121,RB
5565,Tommie Agee,16,3,19,1992,28,DAL,16,0,16,54,3.4,0,3.4,5,56.3,4,3,18,6,0,1.1,75,4.5,0,25,19,54,72,72,0,RB
5566,Jeff Alexander,0,0,0,1992,27,DEN,7,0,0,0,,0,0,0,,0,0,0,,0,0,,,0,,0,0,0,0,0,RB
5567,Marcus Allen,67,28,95,1992,32,RAI,16,0,67,301,4.5,2,18.8,24,55.2,44,28,277,9.9,1,17.3,63.6,6.3,13,50,95,301,578,578,0,RB
5568,Terry Allen,266,49,315,1992,24,MIN,16,16,266,1201,4.5,13,75.1,65,54.5,70,49,478,9.8,2,29.9,70,6.8,20,44.3,315,1201,1679,1679,0,RB
5569,Gary Anderson,55,34,89,1992,31,TAM,15,4,55,194,3.5,1,12.9,11,40,54,34,284,8.4,0,18.9,63,5.3,10,38.9,89,194,478,1087,609,RB
5570,Kimble Anders,1,5,6,1992,26,KAN,11,2,1,1,1,0,0.1,0,0,13,5,65,13,0,5.9,38.5,5,3,30.8,6,1,66,86,20,RB
5571,Neal Anderson,156,42,198,1992,28,CHI,16,11,156,582,3.7,5,36.4,35,42.3,65,42,399,9.5,6,24.9,64.6,6.1,22,49.2,198,582,981,981,0,RB
5572,Ottis Anderson,10,0,10,1992,35,NYG,13,0,10,31,3.1,0,2.4,0,0,0,0,0,,0,0,,,0,,10,31,31,31,0,RB
5573,Johnny Bailey,52,33,85,1992,25,PHO,12,2,52,233,4.5,1,19.4,13,50,44,33,331,10,1,27.6,75,7.5,17,56.8,85,233,564,1517,953,RB
5574,Randy Baldwin,10,2,12,1992,25,CLE,15,0,10,31,3.1,0,2.1,3,30,2,2,30,15,0,2,100,15,1,100,12,31,61,736,675,RB
5575,Eric Ball,16,6,22,1992,26,CIN,16,14,16,55,3.4,2,3.4,3,37.5,17,6,66,11,2,4.1,35.3,3.9,2,17.6,22,55,121,526,411,FB
5576,Brad Baxter,152,4,156,1992,25,NYJ,15,15,152,698,4.6,6,46.5,43,52,10,4,32,8,0,2.1,40,3.2,2,40,156,698,730,730,0,FB
5577,Nick Bell,81,4,85,1992,24,RAI,16,1,81,366,4.5,3,22.9,16,42,6,4,40,10,0,2.5,66.7,6.7,3,66.7,85,366,406,422,16,RB
5578,Edgar Bennett,61,13,74,1992,23,GNB,16,2,61,214,3.5,0,13.4,11,50.8,14,13,93,7.2,0,5.8,92.9,6.6,4,50,74,214,307,411,104,RB
5579,Albert Bentley,0,0,0,1992,32,PIT,2,0,0,0,,0,0,0,,0,0,0,,0,0,,,0,,0,0,0,17,17,RB
5580,Rod Bernstine,106,12,118,1992,27,SDG,9,1,106,499,4.7,4,55.4,30,51.9,25,12,86,7.2,0,9.6,48,3.4,5,36,118,499,585,585,0,RB
5581,Eric Bieniemy,74,5,79,1992,23,SDG,15,0,74,264,3.6,3,17.6,15,45.9,7,5,49,9.8,0,3.3,71.4,7,1,42.9,79,264,313,799,486,RB
5582,James Brooks,18,2,20,1992,34,"CLE,TAM",6,2,18,44,2.4,0,7.3,4,44.4,6,2,-1,-0.5,0,-0.2,33.3,-0.2,0,16.7,20,44,43,92,49,RB
5583,Tony Brooks,0,0,0,1992,23,PHI,5,0,0,0,,0,0,0,,0,0,0,,0,0,,,0,,0,0,0,11,11,RB
5584,Steve Broussard,84,11,95,1992,25,ATL,15,1,84,363,4.3,1,24.2,19,42.9,16,11,96,8.7,1,6.4,68.8,6,4,31.3,95,363,459,457,0,RB
5585,A.B. Brown,24,4,28,1992,27,NYJ,7,1,24,42,1.8,0,6,1,25,6,4,30,7.5,0,4.3,66.7,5,1,33.3,28,42,72,72,0,RB
5586,Gary Brown,19,1,20,1992,23,HOU,16,0,19,87,4.6,1,5.4,5,63.2,2,1,5,5,0,0.3,50,2.5,0,50,20,87,92,107,15,RB
5587,Ivory Lee Brown,68,7,75,1992,23,PHO,7,5,68,194,2.9,2,27.7,10,44.1,7,7,54,7.7,0,7.7,100,7.7,1,100,75,194,248,248,0,RB
5588,Jarrod Bunch,104,11,115,1992,24,NYG,16,13,104,501,4.8,3,31.3,32,53.8,16,11,50,4.5,1,3.1,68.8,3.1,2,37.5,115,501,551,578,27,FB
5589,Marion Butts,218,9,227,1992,26,SDG,15,15,218,809,3.7,4,53.9,38,47.2,11,9,73,8.1,0,4.9,81.8,6.6,2,63.6,227,809,882,882,0,RB
5590,Keith Byars,41,56,97,1992,29,PHI,15,15,41,176,4.3,1,11.7,9,41.5,81,56,502,9,2,33.5,69.1,6.2,23,46.9,97,176,678,678,0,TE/FB
5591,Earnest Byner,262,39,301,1992,30,WAS,16,16,262,998,3.8,6,62.4,46,50,49,39,338,8.7,1,21.1,79.6,6.9,17,55.1,301,1039,1336,1336,0,RB
5592,Sheldon Canley,4,0,4,1992,24,NYJ,1,0,4,9,2.3,0,9,0,0,1,0,0,,0,0,0,0,0,0,4,9,9,9,0,RB
5593,Dexter Carter,4,1,5,1992,25,SFO,3,0,4,9,2.3,0,3,0,50,2,1,43,43,1,14.3,50,21.5,1,50,5,9,52,107,55,RB
5594,Maurice Carthon,4,3,7,1992,31,IND,16,5,4,9,2.3,0,0.6,1,50,7,3,10,3.3,0,0.6,42.9,1.4,0,14.3,7,9,19,19,0,FB
5595,Larry Centers,37,50,87,1992,24,PHO,16,1,37,139,3.8,0,8.7,6,35.1,59,50,417,8.3,2,26.1,84.7,7.1,19,50.8,87,139,556,556,0,FB
5596,Pat Chaffey,27,7,34,1992,25,NYJ,14,0,27,186,6.9,1,13.3,7,40.7,12,7,56,8,0,4,58.3,4.7,2,41.7,34,186,242,242,0,RB
5597,Bob Christian,0,0,0,1992,24,CHI,2,0,0,0,,0,0,0,,0,0,0,,0,0,,,0,,0,0,0,0,0,RB
5598,Ken Clark,40,5,45,1992,26,IND,13,2,40,134,3.4,0,10.3,7,47.5,8,5,46,9.2,0,3.5,62.5,5.8,1,37.5,45,134,180,234,54,RB
5599,Reggie Cobb,310,21,331,1992,24,TAM,16,13,310,1171,3.8,9,73.2,69,48.7,25,21,156,7.4,0,9.8,84,6.2,6,52,331,1171,1327,1327,0,RB
5600,Roger Craig,105,22,127,1992,32,MIN,15,1,105,416,4,4,27.7,26,52.4,30,22,164,7.5,0,10.9,73.3,5.5,9,50,127,416,580,580,0,RB
5601,Aaron Craver,3,0,3,1992,24,MIA,6,0,3,9,3,0,1.5,0,0,4,0,0,,0,0,0,0,0,0,3,9,9,183,174,RB
5602,Rodney Culver,121,26,147,1992,23,IND,16,2,121,321,2.7,7,20.1,27,34.7,35,26,210,8.1,2,13.1,74.3,6,8,45.7,147,321,531,531,0,RB
5603,Kenneth Davis,139,15,154,1992,30,BUF,16,0,139,613,4.4,6,38.3,34,54,18,15,80,5.3,0,5,83.3,4.4,1,33.3,154,613,693,944,251,RB
5604,Robert Delpino,32,18,50,1992,27,RAM,10,4,32,115,3.6,0,11.5,7,31.3,30,18,139,7.7,1,13.9,60,4.6,5,43.3,50,115,254,337,83,RB
5605,Eric Dickerson,187,14,201,1992,32,RAI,16,15,187,729,3.9,2,45.6,26,41.7,22,14,85,6.1,1,5.3,63.6,3.9,5,45.5,201,729,814,814,0,RB
5606,Vaughn Dunbar,154,9,163,1992,24,NOR,16,8,154,565,3.7,3,35.3,24,40.3,14,9,62,6.9,0,3.9,64.3,4.4,4,42.9,163,565,627,814,187,RB
5607,Ricky Ervins,151,32,183,1992,24,WAS,16,0,151,495,3.3,2,30.9,38,45,42,32,252,7.9,0,15.8,76.2,6,11,42.9,183,495,747,747,0,RB
5608,Derrick Fenner,112,7,119,1992,25,CIN,16,1,112,500,4.5,7,31.3,42,57.1,12,7,41,5.9,1,2.6,58.3,3.4,2,41.7,119,500,541,579,38,RB
5609,Barry Foster,390,36,426,1992,24,PIT,16,15,390,1690,4.3,11,105.6,86,49,50,36,344,9.6,0,21.5,72,6.9,12,46,426,1690,2034,2014,0,RB
5610,Eddie Fuller,6,2,8,1992,24,BUF,8,0,6,39,6.5,0,4.9,1,83.3,5,2,17,8.5,0,2.1,40,3.4,0,20,8,39,56,190,134,RB
5611,Derrick Gainer,2,0,2,1992,26,"DAL,RAI",7,0,2,10,5,0,1.4,1,100,0,0,0,,0,0,,,0,,2,10,10,10,0,RB
5612,Carwell Gardner,40,7,47,1992,26,BUF,16,7,40,166,4.2,2,10.4,11,52.5,9,7,67,9.6,0,4.2,77.8,7.4,4,66.7,47,166,233,233,0,FB
5613,Cleveland Gary,279,52,331,1992,26,RAM,16,16,279,1125,4,7,70.3,59,43,55,52,293,5.6,3,18.3,94.5,5.3,18,54.5,331,1125,1418,1418,0,RB
5614,Sam Gash,5,0,5,1992,23,NWE,15,0,5,7,1.4,1,0.5,2,40,2,0,0,,0,0,0,0,0,0,5,7,7,7,0,FB
5615,Scottie Graham,14,0,14,1992,23,NYJ,2,0,14,29,2.1,0,14.5,1,28.6,0,0,0,,0,0,,,0,,14,29,29,29,0,RB
5616,Gaston Green,161,10,171,1992,26,DEN,14,13,161,648,4,2,46.3,20,44.1,13,10,79,7.9,0,5.6,76.9,6.1,3,46.2,171,648,727,803,76,RB
5617,Harold Green,265,41,306,1992,24,CIN,16,15,265,1170,4.4,2,73.1,52,49.4,48,41,214,5.2,0,13.4,85.4,4.5,11,52.1,306,1170,1384,1384,0,RB
5618,Mark Green,23,7,30,1992,25,CHI,15,0,23,107,4.7,2,7.1,5,60.9,9,7,85,12.1,0,5.7,77.8,9.4,3,77.8,30,107,192,416,224,RB
5619,Robert Green,8,1,9,1992,22,WAS,15,0,8,46,5.8,0,3.1,3,62.5,1,1,5,5,0,0.3,100,5,0,0,9,46,51,60,9,RB
5620,Rodney Hampton,257,28,285,1992,23,NYG,16,16,257,1141,4.4,14,71.3,61,49,38,28,215,7.7,0,13.4,73.7,5.7,9,50,285,1141,1356,1356,0,RB
5621,Ronnie Harmon,55,79,134,1992,28,SDG,16,2,55,235,4.3,3,14.7,17,50.9,102,79,914,11.6,1,57.1,77.5,9,35,57.8,134,235,1149,1245,96,RB
5622,Johnny Hector,24,2,26,1992,32,NYJ,5,1,24,67,2.8,0,13.4,3,41.7,3,2,13,6.5,0,2.6,66.7,4.3,1,33.3,26,67,80,95,15,RB
5623,Keith Henderson,44,5,49,1992,26,"MIN,SFO",15,0,44,150,3.4,1,10,9,54.5,10,5,64,12.8,0,4.3,50,6.4,2,30,49,186,214,325,111,RB
5624,Steve Hendrickson,0,0,0,1992,26,SDG,16,2,0,0,,0,0,0,,0,0,0,,0,0,,,0,,0,0,0,14,14,RB
5625,Craig Heyward,104,19,123,1992,26,NOR,16,13,104,416,4,3,26,27,49,25,19,159,8.4,0,9.9,76,6.4,7,56,123,416,575,589,14,FB
5626,Mark Higgs,256,16,272,1992,26,MIA,16,15,256,915,3.6,7,57.2,65,50.4,20,16,142,8.9,0,8.9,80,7.1,6,65,272,915,1057,1057,0,RB
5627,Alonzo Highsmith,8,5,13,1992,27,TAM,5,2,8,23,2.9,0,4.6,2,62.5,5,5,28,5.6,0,5.6,100,5.6,1,60,13,23,51,51,0,RB
5628,Dalton Hilliard,115,48,163,1992,28,NOR,16,4,115,445,3.9,3,27.8,26,42.6,59,48,465,9.7,4,29.1,81.4,7.9,21,57.6,163,445,910,1040,130,RB
5629,Leroy Hoard,54,26,80,1992,24,CLE,16,9,54,236,4.4,0,14.8,10,38.9,48,26,310,11.9,1,19.4,54.2,6.5,13,39.6,80,236,546,580,34,RB
5630,Merril Hoge,41,28,69,1992,27,PIT,16,11,41,150,3.7,0,9.4,13,41.5,42,28,231,8.3,1,14.4,66.7,5.5,9,42.9,69,150,381,409,28,FB
5631,Bobby Humphrey,102,54,156,1992,26,MIA,16,1,102,471,4.6,1,29.4,28,49,75,54,507,9.4,1,31.7,72,6.8,26,54.7,156,471,978,996,18,RB
5632,Stanford Jennings,5,9,14,1992,30,TAM,11,0,5,25,5,0,2.3,2,60,16,9,69,7.7,1,6.3,56.3,4.3,3,25,14,25,94,94,0,RB
5633,Anthony Johnson,178,49,227,1992,25,IND,15,13,178,592,3.3,0,39.5,31,41.6,60,49,517,10.6,3,34.5,81.7,8.6,22,53.3,227,592,1109,1109,0,RB
5634,Daryl Johnston,17,32,49,1992,26,DAL,16,16,17,61,3.6,0,3.8,5,41.2,38,32,249,7.8,2,15.6,84.2,6.6,14,71.1,49,61,310,310,0,FB
5635,Johnny Johnson,178,14,192,1992,24,PHO,12,8,178,734,4.1,6,61.2,45,57.3,19,14,103,7.4,0,8.6,73.7,5.4,3,47.4,192,734,837,837,0,RB
5636,Tracy Johnson,3,0,3,1992,26,SEA,16,0,3,26,8.7,0,1.6,1,66.7,1,0,0,,0,0,0,0,0,0,3,26,26,51,15,RB
5637,Bill Jones,0,2,2,1992,26,KAN,7,6,0,0,,0,0,0,,5,2,6,3,0,0.9,40,1.2,0,0,2,0,6,6,0,FB
5638,James Jones,0,21,21,1992,31,SEA,16,1,0,0,,0,0,0,,38,21,190,9,0,11.9,55.3,5,7,36.8,21,0,190,206,16,FB
5639,Keith Jones,79,12,91,1992,26,ATL,16,8,79,278,3.5,0,17.4,16,40.5,14,12,94,7.8,0,5.9,85.7,6.7,4,64.3,91,278,372,486,114,RB
5640,Victor Jones,0,3,3,1992,25,DEN,16,1,0,0,,0,0,0,,3,3,17,5.7,0,1.1,100,5.7,1,33.3,3,0,17,17,0,RB
5641,Buford Jordan,0,0,0,1992,30,NOR,2,0,0,0,,0,0,0,,0,0,0,,0,0,,,0,,0,0,0,18,18,RB
5642,James Joseph,0,0,0,1992,25,PHI,16,0,0,0,,0,0,0,,0,0,0,,0,0,,,0,,0,0,0,0,0,RB
5643,David Lang,33,18,51,1992,24,RAM,16,11,33,203,6.2,5,12.7,10,51.5,26,18,283,15.7,1,17.7,69.2,10.9,11,65.4,51,203,486,714,228,FB
5644,Amp Lee,91,20,111,1992,21,SFO,16,3,91,362,4,2,22.6,17,51.6,25,20,102,5.1,2,6.4,80,4.1,6,48,111,362,464,740,276,RB
5645,Tim Lester,0,0,0,1992,24,RAM,11,0,0,0,,0,0,0,,0,0,0,,0,0,,,0,,0,0,0,0,0,RB
5646,Darren Lewis,90,18,108,1992,24,CHI,16,5,90,382,4.2,4,23.9,18,45.6,27,18,175,9.7,0,10.9,66.7,6.5,9,40.7,108,382,557,1068,511,RB
5647,Greg Lewis,73,4,77,1992,23,DEN,16,2,73,268,3.7,4,16.8,20,45.2,4,4,30,7.5,0,1.9,100,7.5,1,25,77,268,298,298,0,RB
5648,Scott Lockwood,35,0,35,1992,24,NWE,4,0,35,162,4.6,0,40.5,5,40,1,0,0,,0,0,0,0,0,0,35,162,162,395,233,RB
5649,Marc Logan,8,2,10,1992,27,SFO,16,1,8,44,5.5,1,2.8,2,37.5,2,2,17,8.5,0,1.1,100,8.5,1,100,10,44,61,539,478,RB
5650,Eric Lynch,0,0,0,1992,22,DET,1,0,0,0,,0,0,0,,0,0,0,,0,0,,,0,,0,0,0,0,0,RB
5651,Kevin Mack,169,13,182,1992,30,CLE,12,6,169,543,3.2,6,45.3,38,46.7,15,13,81,6.2,0,6.8,86.7,5.4,3,40,182,543,624,624,0,FB
5652,Rueben Mayes,28,2,30,1992,29,SEA,16,0,28,74,2.6,0,4.6,3,25,5,2,13,6.5,0,0.8,40,2.6,1,20,30,74,87,398,311,RB
5653,Fred McAfee,39,1,40,1992,24,NOR,14,1,39,114,2.9,1,8.1,8,41,1,1,16,16,0,1.1,100,16,1,100,40,114,130,523,393,RB
5654,Napoleon McCallum,0,2,2,1992,29,RAI,13,0,0,0,,0,0,0,,2,2,13,6.5,0,1,100,6.5,0,0,2,0,13,306,293,RB
5655,Anthony McDowell,14,27,41,1992,24,TAM,12,8,14,81,5.8,0,6.8,3,42.9,37,27,258,9.6,2,21.5,73,7,10,45.9,41,81,339,339,0,FB
5656,Buford McGee,8,6,14,1992,32,GNB,4,3,8,19,2.4,0,4.8,1,37.5,8,6,60,10,0,15,75,7.5,4,50,14,19,79,79,0,RB
5657,Dexter McNabb,2,0,2,1992,23,GNB,16,0,2,11,5.5,0,0.7,1,100,0,0,0,,0,0,,,0,,2,11,11,26,15,FB
5658,Todd McNair,21,44,65,1992,27,KAN,16,0,21,124,5.9,1,7.8,6,61.9,62,44,380,8.6,1,23.8,71,6.1,15,38.7,65,124,504,524,20,RB
5659,Freeman McNeil,43,16,59,1992,33,NYJ,12,1,43,170,4,0,14.2,7,44.2,25,16,154,9.6,0,12.8,64,6.2,6,36,59,170,324,324,0,RB
5660,Dave Meggett,32,38,70,1992,26,NYG,16,0,32,167,5.2,0,10.4,10,46.9,65,38,229,6,2,14.3,58.5,3.5,11,27.7,70,167,396,1091,695,RB
5661,Eric Metcalf,73,47,120,1992,24,CLE,16,5,73,301,4.1,1,18.8,12,41.1,69,47,614,13.1,5,38.4,68.1,8.9,25,47.8,120,301,915,1501,586,RB
5662,Ostell Miles,8,0,8,1992,22,CIN,11,0,8,22,2.8,0,2,1,25,0,0,0,,0,0,,,0,,8,22,22,150,128,RB
5663,Brian Mitchell,6,3,9,1992,24,WAS,16,0,6,70,11.7,0,4.4,3,83.3,4,3,30,10,0,1.9,75,7.5,1,50,9,70,100,863,763,RB
5664,Brad Muster,98,34,132,1992,27,CHI,16,16,98,414,4.2,3,25.9,22,48,45,34,389,11.4,2,24.3,75.6,8.6,16,60,132,414,803,803,0,FB
5665,Darrin Nelson,10,0,10,1992,33,MIN,16,0,10,5,0.5,0,0.3,1,30,2,0,0,,0,0,0,0,0,0,10,5,5,631,626,RB
5666,Christian Okoye,144,1,145,1992,31,KAN,15,5,144,448,3.1,6,29.9,31,42.4,4,1,5,5,0,0.3,25,1.3,0,25,145,448,453,453,0,FB
5667,Don Overton,0,0,0,1992,25,DET,1,0,0,0,,0,0,0,,0,0,0,,0,0,,,0,,0,0,0,0,0,RB
5668,Tony Paige,7,48,55,1992,30,MIA,16,16,7,11,1.6,1,0.7,1,28.6,60,48,399,8.3,1,24.9,80,6.7,18,71.7,55,11,410,439,29,FB
5669,Bernie Parmalee,6,0,6,1992,25,MIA,10,0,6,38,6.3,0,3.8,2,66.7,0,0,0,,0,0,,,0,,6,38,38,327,289,RB
5670,Erric Pegram,21,2,23,1992,23,ATL,16,1,21,89,4.2,0,5.6,6,38.1,3,2,25,12.5,0,1.6,66.7,8.3,1,66.7,23,89,114,276,161,RB
5671,Bob Perryman,3,2,5,1992,28,DEN,4,1,3,-1,-0.3,0,-0.3,0,0,0,2,15,7.5,0,3.8,,,0,,5,-1,14,14,0,RB
5672,Tom Rathman,57,44,101,1992,30,SFO,15,15,57,194,3.4,5,12.9,19,54.4,55,44,343,7.8,4,22.9,80,6.2,20,56.4,101,194,537,537,0,FB
5673,Curvin Richards,49,3,52,1992,24,DAL,9,0,49,176,3.6,1,19.6,11,53.1,3,3,8,2.7,0,0.9,100,2.7,0,66.7,52,176,184,184,0,RB
5674,Reggie Rivers,74,45,119,1992,24,DEN,16,3,74,282,3.8,3,17.6,21,37.8,63,45,449,10,1,28.1,71.4,7.1,16,46,119,282,731,731,0,RB
5675,Mazio Royster,0,1,1,1992,22,TAM,5,0,0,0,,0,0,0,,1,1,8,8,0,1.6,100,8,0,0,1,0,8,8,0,RB
5676,Leonard Russell,123,11,134,1992,23,NWE,11,10,123,390,3.2,2,35.5,18,36.6,14,11,24,2.2,0,2.2,78.6,1.7,1,28.6,134,390,414,414,0,RB
5677,Barry Sanders,312,29,341,1992,24,DET,16,16,312,1352,4.3,9,84.5,68,43.6,40,29,225,7.8,1,14.1,72.5,5.6,7,40,341,1352,1577,1577,0,RB
5678,James Saxon,4,5,9,1992,26,MIA,16,0,4,7,1.8,0,0.4,0,25,6,5,41,8.2,0,2.6,83.3,6.8,2,66.7,9,7,48,48,0,FB
5679,Heath Sherman,112,18,130,1992,25,PHI,16,7,112,583,5.2,5,36.4,32,52.7,23,18,219,12.2,1,13.7,78.3,9.5,6,65.2,130,583,802,802,0,FB
5680,Vai Sikahema,2,13,15,1992,30,PHI,16,0,2,2,1,0,0.1,0,0,20,13,142,10.9,0,8.9,65,7.1,7,60,15,2,144,1175,1031,RB
5681,Emmitt Smith,373,59,432,1992,23,DAL,16,16,373,1713,4.6,18,107.1,91,50.4,74,59,335,5.7,1,20.9,79.7,4.5,12,37.8,432,1713,2048,2048,0,RB
5682,Sammie Smith,23,0,23,1992,25,DEN,3,1,23,94,4.1,0,31.3,4,43.5,0,0,0,,0,0,,,0,,23,94,94,125,31,RB
5683,Steve Smith,44,28,72,1992,28,RAI,16,15,44,129,2.9,0,8.1,12,31.8,41,28,217,7.8,1,13.6,68.3,5.3,10,51.2,72,129,346,346,0,FB
5684,Tony Smith,87,2,89,1992,22,ATL,14,6,87,329,3.8,2,23.5,16,40.2,3,2,14,7,0,1,66.7,4.7,0,33.3,89,329,343,670,327,RB
5685,Siran Stacy,0,0,0,1992,24,PHI,16,0,0,0,,0,0,0,,0,0,0,,0,0,,,0,,0,0,0,0,0,RB
5686,John Stephens,75,21,96,1992,26,NWE,16,16,75,277,3.7,2,17.3,16,37.3,33,21,161,7.7,0,10.1,63.6,4.9,6,36.4,96,277,438,438,0,FB
5687,Troy Stradford,12,2,14,1992,28,"DET,RAM",8,0,12,41,3.4,0,5.1,2,25,2,2,15,7.5,0,1.9,100,7.5,1,50,14,41,56,151,95,RB
5688,Harry Sydney,51,49,100,1992,33,GNB,16,10,51,163,3.2,2,10.2,19,54.9,65,49,384,7.8,1,24,75.4,5.9,19,56.9,100,163,547,547,0,FB
5689,Anthony Thompson,19,5,24,1992,25,"PHO,RAM",8,0,19,65,3.4,1,8.1,5,52.6,6,5,11,2.2,0,1.4,83.3,1.8,1,16.7,24,65,76,110,34,RB
5690,Blair Thomas,97,7,104,1992,25,NYJ,9,7,97,440,4.5,0,48.9,25,46.4,10,7,49,7,0,5.4,70,4.9,1,40,104,440,489,489,0,RB
5691,Darrell Thompson,76,13,89,1992,25,GNB,7,4,76,254,3.3,2,36.3,17,50,16,13,129,9.9,1,18.4,81.3,8.1,7,68.8,89,254,383,383,0,RB
5692,Leroy Thompson,35,22,57,1992,23,PIT,15,2,35,157,4.5,1,10.5,9,42.9,29,22,278,12.6,0,18.5,75.9,9.6,10,44.8,57,157,435,486,51,RB
5693,Thurman Thomas,312,58,370,1992,26,BUF,16,16,312,1487,4.8,9,92.9,78,51.3,87,58,626,10.8,3,39.1,66.7,7.2,35,55.2,370,1487,2113,2113,0,RB
5694,Ed Tillison,4,0,4,1992,23,DET,6,0,4,22,5.5,0,3.7,1,50,0,0,0,,0,0,,,0,,4,22,22,49,27,FB
5695,Lewis Tillman,6,1,7,1992,26,NYG,16,0,6,13,2.2,0,0.8,0,16.7,1,1,15,15,0,0.9,100,15,1,100,7,13,28,28,0,RB
5696,Spencer Tillman,1,0,1,1992,28,HOU,16,0,1,1,1,0,0.1,0,0,0,0,0,,0,0,,,0,,1,1,1,158,157,RB
5697,Ed Toner,0,0,0,1992,24,IND,8,0,0,0,,0,0,0,,0,0,0,,0,0,,,0,,0,0,0,0,0,RB
5698,Peter Tuipulotu,0,0,0,1992,23,SDG,6,0,0,0,,0,0,0,,0,0,0,,0,0,,,0,,0,0,0,0,0,RB
5699,Kevin Turner,10,7,17,1992,23,NWE,16,1,10,40,4,0,2.5,0,0,11,7,52,7.4,2,3.3,63.6,4.7,3,36.4,17,40,92,103,11,FB
5700,Tommy Vardell,99,13,112,1992,23,CLE,14,10,99,369,3.7,0,26.4,14,38.4,13,13,128,9.8,0,9.1,100,9.8,8,69.2,112,369,497,511,14,FB
5701,Jon Vaughn,113,13,126,1992,22,NWE,16,5,113,451,4,1,28.2,20,36.3,21,13,84,6.5,0,5.3,61.9,4,2,33.3,126,451,535,1096,564,RB
5702,Adam Walker,0,0,0,1992,24,SFO,1,0,0,0,,0,0,0,,0,0,0,,0,0,,,0,,0,0,0,0,0,RB
5703,Herschel Walker,267,38,305,1992,30,PHI,16,16,267,1070,4,8,66.9,60,47.9,47,38,278,7.3,2,17.4,80.9,5.9,11,48.9,305,1070,1348,1417,69,RB
5704,Chris Warren,223,16,239,1992,24,SEA,16,16,223,1017,4.6,3,63.6,51,50.2,28,16,134,8.4,0,8.4,57.1,4.8,5,39.3,239,1017,1151,1927,776,RB
5705,Ricky Watters,206,43,249,1992,23,SFO,14,13,206,1013,4.9,9,72.4,54,57.8,52,43,405,9.4,2,28.9,82.7,7.8,21,59.6,249,1013,1418,1418,0,RB
5706,Lorenzo White,265,57,322,1992,26,HOU,16,16,265,1226,4.6,7,76.6,75,60,77,57,641,11.2,1,40.1,74,8.3,26,51.9,322,1226,1867,1867,0,RB
5707,Harvey Williams,78,5,83,1992,25,KAN,14,0,78,262,3.4,1,18.7,8,42.3,7,5,24,4.8,0,1.7,71.4,3.4,1,14.3,83,262,286,691,405,RB
5708,John Williams,114,74,188,1992,28,SEA,16,16,114,339,3,1,21.2,12,32.5,122,74,556,7.5,2,34.8,60.7,4.6,27,36.9,188,339,895,895,0,FB
5709,Warren Williams,2,1,3,1992,27,PIT,16,0,2,0,0,0,0,0,0,1,1,44,44,0,2.8,100,44,1,100,3,0,44,44,0,RB
5710,Marcus Wilson,0,0,0,1992,24,GNB,6,0,0,0,,0,0,0,,0,0,0,,0,0,,,0,,0,0,0,0,0,RB
5711,Ron Wolfley,1,2,3,1992,30,CLE,15,0,1,2,2,0,0.1,0,0,4,2,8,4,1,0.5,50,2,1,50,3,2,10,10,0,RB
5712,Barry Word,163,9,172,1992,29,KAN,12,11,163,607,3.7,4,50.6,33,42.9,14,9,80,8.9,0,6.7,64.3,5.7,3,57.1,172,607,687,687,0,RB
5713,Vince Workman,159,47,206,1992,24,GNB,10,10,159,631,4,2,63.1,38,47.8,59,47,290,6.2,0,29,79.7,4.9,17,40.7,206,631,921,938,17,RB
5714,George Adams,2,0,2,1991,29,NWE,2,1,2,3,1.5,0,1.5,1,50,0,0,0,,0,0,,,0,,2,3,3,3,0,RB
5715,Tommie Agee,9,7,16,1991,27,DAL,16,0,9,20,2.2,1,1.3,1,33.3,9,7,43,6.1,0,2.7,77.8,4.8,2,22.2,16,20,63,63,0,RB
5716,Marcus Allen,63,15,78,1991,31,RAI,8,2,63,287,4.6,2,35.9,16,54,17,15,131,8.7,0,16.4,88.2,7.7,5,29.4,78,298,418,418,0,RB
5717,Marvin Allen,13,1,14,1991,26,NWE,15,0,13,50,3.8,0,3.3,4,53.8,3,1,9,9,0,0.6,33.3,3,1,33.3,14,50,59,220,161,RB
5718,Terry Allen,120,6,126,1991,23,MIN,15,6,120,563,4.7,2,37.5,29,55,13,6,49,8.2,1,3.3,46.2,3.8,4,30.8,126,563,612,626,14,FB
5719,Alfred Anderson,26,1,27,1991,30,MIN,16,5,26,118,4.5,1,7.4,10,61.5,6,1,2,2,0,0.1,16.7,0.3,0,0,27,118,120,127,7,FB
5720,Gary Anderson,72,25,97,1991,30,TAM,16,5,72,263,3.7,1,16.4,16,38.9,37,25,184,7.4,0,11.5,67.6,5,5,29.7,97,263,447,1090,643,RB
5721,Kimble Anders,0,2,2,1991,25,KAN,2,0,0,0,,0,0,0,,4,2,30,15,0,15,50,7.5,2,50,2,0,30,30,0,RB
5722,Neal Anderson,210,47,257,1991,27,CHI,13,12,210,747,3.6,6,57.5,41,41.4,66,47,368,7.8,3,28.3,71.2,5.6,23,51.5,257,747,1115,1115,0,RB
5723,Ottis Anderson,53,11,64,1991,34,NYG,10,1,53,141,2.7,1,14.1,12,41.5,14,11,41,3.7,0,4.1,78.6,2.9,3,35.7,64,141,182,182,0,RB
5724,Steve Avery,0,0,0,1991,25,GNB,1,0,0,0,,0,0,0,,0,0,0,,0,0,,,0,,0,0,0,0,0,RB
5725,Johnny Bailey,15,0,15,1991,24,CHI,14,0,15,43,2.9,1,3.1,2,40,0,0,0,,0,0,,,0,,15,43,43,635,592,RB
5726,Randy Baldwin,0,0,0,1991,24,MIN,4,0,0,0,,0,0,0,,0,0,0,,0,0,,,0,,0,0,0,14,14,RB
5727,Eric Ball,10,3,13,1991,25,CIN,6,4,10,21,2.1,1,3.5,2,40,4,3,17,5.7,0,2.8,75,4.3,0,50,13,21,38,300,262,RB
5728,Brad Baxter,184,12,196,1991,24,NYJ,16,14,184,666,3.6,11,41.6,48,57.6,19,12,124,10.3,0,7.8,63.2,6.5,4,52.6,196,666,790,790,0,FB
5729,Nick Bell,78,6,84,1991,23,RAI,9,1,78,307,3.9,3,34.1,20,50,7,6,62,10.3,0,6.9,85.7,8.9,3,57.1,84,307,369,369,0,RB
5730,Albert Bentley,0,7,7,1991,31,IND,1,0,0,0,,0,0,0,,9,7,42,6,0,42,77.8,4.7,3,55.6,7,0,42,42,0,RB
5731,Rod Bernstine,159,11,170,1991,26,SDG,13,8,159,766,4.8,8,58.9,48,59.7,14,11,124,11.3,0,9.5,78.6,8.9,6,57.1,170,777,890,897,7,RB
5732,Eric Bieniemy,3,0,3,1991,22,SDG,15,0,3,17,5.7,0,1.1,1,33.3,0,0,0,,0,0,,,0,,3,17,17,17,0,RB
5733,Ricky Blake,15,1,16,1991,24,DAL,2,0,15,80,5.3,1,40,4,40,1,1,5,5,0,2.5,100,5,0,0,16,80,85,85,0,RB
5734,James Brooks,152,40,192,1991,33,CIN,15,12,152,571,3.8,2,38.1,29,40.1,53,40,348,8.7,2,23.2,75.5,6.6,16,52.8,192,571,919,1109,190,RB
5735,Steve Broussard,99,12,111,1991,24,ATL,14,5,99,449,4.5,4,32.1,24,55.6,24,12,120,10,1,8.6,50,5,7,37.5,111,449,569,569,0,RB
5736,A.B. Brown,3,0,3,1991,26,NYJ,9,0,3,4,1.3,1,0.4,1,33.3,0,0,0,,0,0,,,0,,3,4,4,104,100,RB
5737,Gary Brown,8,2,10,1991,22,HOU,11,0,8,85,10.6,1,7.7,3,75,3,2,1,0.5,0,0.1,66.7,0.3,1,33.3,10,85,86,116,30,RB
5738,Jarrod Bunch,1,2,3,1991,23,NYG,16,1,1,0,0,0,0,0,0,2,2,8,4,0,0.5,100,4,0,0,3,0,8,8,0,FB
5739,Marion Butts,193,10,203,1991,25,SDG,16,8,193,834,4.3,6,52.1,39,38.9,15,10,91,9.1,1,5.7,66.7,6.1,4,40,203,834,925,925,0,RB
5740,Keith Byars,94,62,156,1991,28,PHI,16,16,94,383,4.1,1,23.9,23,42.6,93,62,564,9.1,3,35.3,66.7,6.1,21,43,156,383,947,947,0,FB
5741,Earnest Byner,274,34,308,1991,29,WAS,16,16,274,1048,3.8,5,65.5,45,46,45,34,308,9.1,0,19.3,75.6,6.8,18,55.6,308,1066,1356,1356,0,RB
5742,Dexter Carter,85,23,108,1991,24,SFO,16,15,85,379,4.5,2,23.7,17,44.7,33,23,253,11,1,15.8,69.7,7.7,15,57.6,108,379,632,1471,839,RB
5743,Maurice Carthon,32,7,39,1991,30,NYG,16,8,32,109,3.4,0,6.8,9,50,8,7,39,5.6,0,2.4,87.5,4.9,3,50,39,109,148,148,0,FB
5744,Larry Centers,14,19,33,1991,23,PHO,9,2,14,44,3.1,0,4.9,1,14.3,23,19,176,9.3,0,19.6,82.6,7.7,8,56.5,33,44,220,580,360,FB
5745,Pat Chaffey,29,0,29,1991,24,ATL,14,2,29,127,4.4,1,9.1,6,51.7,2,0,0,,0,0,0,0,0,0,29,127,127,141,14,RB
5746,Ken Clark,114,33,147,1991,25,IND,16,7,114,366,3.2,0,22.9,19,36.8,47,33,245,7.4,0,15.3,70.2,5.2,10,34,147,366,611,611,0,RB
5747,Reggie Cobb,196,15,211,1991,23,TAM,16,11,196,752,3.8,7,47,44,45.4,26,15,111,7.4,0,6.9,57.7,4.3,6,34.6,211,752,863,878,15,RB
5748,Roger Craig,162,17,179,1991,31,RAI,15,13,162,590,3.6,1,39.3,21,43.2,26,17,136,8,0,9.1,65.4,5.2,6,42.3,179,590,726,726,0,RB
5749,Aaron Craver,20,8,28,1991,23,MIA,14,0,20,58,2.9,1,4.1,4,30,9,8,67,8.4,0,4.8,88.9,7.4,2,44.4,28,58,125,740,615,RB
5750,Kenneth Davis,129,20,149,1991,29,BUF,16,1,129,624,4.8,4,39,41,55,23,20,118,5.9,1,7.4,87,5.1,4,43.5,149,624,742,815,73,RB
5751,Walter Dean,0,0,0,1991,23,GNB,9,0,0,0,,0,0,0,,0,0,0,,0,0,,,0,,0,0,0,0,0,RB
5752,Robert Delpino,214,55,269,1991,26,RAM,16,15,214,688,3.2,9,43,40,37.4,73,55,617,11.2,1,38.6,75.3,8.5,29,60.3,269,688,1305,1359,54,RB
5753,Eric Dickerson,167,41,208,1991,31,IND,10,9,167,536,3.2,2,53.6,21,34.1,54,41,269,6.6,1,26.9,75.9,5,13,44.4,208,536,805,805,0,RB
5754,Mike Dingle,21,5,26,1991,22,CIN,8,0,21,91,4.3,0,11.4,4,42.9,10,5,23,4.6,1,2.9,50,2.3,2,30,26,91,114,290,176,RB
5755,Derrick Douglas,0,0,0,1991,23,CLE,2,0,0,0,,0,0,0,,0,0,0,,0,0,,,0,,0,0,0,0,0,RB
5756,D.J. Dozier,9,1,10,1991,26,DET,6,0,9,48,5.3,0,8,3,33.3,3,1,3,3,0,0.5,33.3,1,0,0,10,48,51,111,60,RB
5757,Robert Drummond,12,0,12,1991,24,PHI,16,0,12,27,2.3,2,1.7,3,41.7,1,0,0,,0,0,0,0,0,0,12,27,27,27,0,RB
5758,Marcus Dupree,49,6,55,1991,27,RAM,8,1,49,179,3.7,1,22.4,7,51,6,6,46,7.7,0,5.8,100,7.7,1,66.7,55,179,225,225,0,RB
5759,Ricky Ervins,145,16,161,1991,23,WAS,15,0,145,680,4.7,3,45.3,30,44.8,19,16,181,11.3,1,12.1,84.2,9.5,8,68.4,161,680,861,1093,232,RB
5760,Gill Fenerty,139,26,165,1991,28,NOR,16,12,139,477,3.4,3,29.8,22,34.5,39,26,235,9,2,14.7,66.7,6,8,33.3,165,477,712,795,83,RB
5761,Derrick Fenner,91,11,102,1991,24,SEA,11,7,91,267,2.9,4,24.3,20,45.1,14,11,72,6.5,0,6.5,78.6,5.1,3,50,102,267,339,339,0,RB
5762,Rick Fenney,23,2,25,1991,27,MIN,11,0,23,99,4.3,0,9,6,60.9,4,2,11,5.5,0,1,50,2.8,0,25,25,99,110,110,0,RB
5763,Terrence Flagler,1,8,9,1991,27,PHO,7,0,1,7,7,0,1,0,100,13,8,85,10.6,0,12.1,61.5,6.5,4,46.2,9,7,92,300,208,RB
5764,Barry Foster,96,9,105,1991,23,PIT,10,9,96,488,5.1,1,48.8,20,51,13,9,117,13,1,11.7,69.2,9,4,69.2,105,488,605,606,0,RB
5765,Eddie Fuller,0,0,0,1991,23,BUF,5,0,0,0,,0,0,0,,0,0,0,,0,0,,,0,,0,0,0,125,125,RB
5766,Carwell Gardner,42,3,45,1991,25,BUF,16,5,42,146,3.5,4,9.1,14,54.8,6,3,20,6.7,0,1.3,50,3.3,1,16.7,45,146,166,176,10,FB
5767,Cleveland Gary,68,13,81,1991,25,RAM,10,2,68,245,3.6,1,24.5,14,45.6,17,13,110,8.5,0,11,76.5,6.5,4,58.8,81,245,355,355,0,RB
5768,Gaston Green,261,13,274,1991,25,DEN,13,12,261,1037,4,4,79.8,45,40.6,27,13,78,6,0,6,48.1,2.9,2,25.9,274,1037,1115,1115,0,RB
5769,Harold Green,158,16,174,1991,23,CIN,14,10,158,731,4.6,2,52.2,27,43,24,16,136,8.5,0,9.7,66.7,5.7,8,41.7,174,731,867,933,66,FB
5770,Mark Green,61,6,67,1991,24,CHI,16,4,61,217,3.6,3,13.6,13,47.5,13,6,54,9,0,3.4,46.2,4.2,2,38.5,67,217,271,349,78,RB
5771,Rodney Hampton,256,43,299,1991,22,NYG,14,14,256,1059,4.1,10,75.6,58,52.3,53,43,283,6.6,0,20.2,81.1,5.3,16,50.9,299,1059,1342,1546,204,RB
5772,Robert Hardy,0,0,0,1991,24,TAM,16,0,0,0,,0,0,0,,0,0,0,,0,0,,,0,,0,0,0,119,119,RB
5773,Ronnie Harmon,89,59,148,1991,27,SDG,16,0,89,544,6.1,1,34,19,51.7,80,59,555,9.4,1,34.7,73.8,6.9,28,47.5,148,544,1099,1124,25,RB
5774,Johnny Hector,62,7,69,1991,31,NYJ,14,1,62,345,5.6,0,24.6,19,62.9,16,7,51,7.3,0,3.6,43.8,3.2,4,25,69,345,396,568,172,RB
5775,Keith Henderson,137,30,167,1991,25,SFO,14,1,137,561,4.1,2,40.1,21,51.1,37,30,303,10.1,0,21.6,81.1,8.2,15,59.5,167,561,864,864,0,RB
5776,Craig Heyward,76,4,80,1991,25,NOR,7,4,76,260,3.4,4,37.1,20,55.3,5,4,34,8.5,1,4.9,80,6.8,1,60,80,304,294,294,0,RB
5777,Mark Higgs,231,11,242,1991,25,MIA,14,10,231,905,3.9,4,64.6,57,51.5,18,11,80,7.3,0,5.7,61.1,4.4,2,55.6,242,905,985,985,0,RB
5778,Alonzo Highsmith,5,0,5,1991,26,"DAL,TAM",13,0,5,21,4.2,0,1.6,0,0,1,0,0,,0,0,0,0,0,0,5,21,21,21,0,RB
5779,Dalton Hilliard,79,21,100,1991,27,NOR,10,3,79,252,3.2,4,25.2,12,32.9,27,21,127,6,1,12.7,77.8,4.7,5,37,100,252,379,379,0,RB
5780,Leroy Hoard,37,48,85,1991,23,CLE,16,9,37,154,4.2,2,9.6,9,35.1,63,48,567,11.8,9,35.4,76.2,9,29,63.5,85,154,721,725,0,RB
5781,Merril Hoge,165,49,214,1991,26,PIT,16,16,165,610,3.7,2,38.1,31,45.5,71,49,379,7.7,1,23.7,69,5.3,18,50.7,214,610,989,989,0,FB
5782,Bobby Humphrey,11,0,11,1991,25,DEN,4,0,11,33,3,0,8.3,2,45.5,1,0,0,,0,0,0,0,0,0,11,33,33,33,0,RB
5783,Ivy Joe Hunter,18,11,29,1991,25,NWE,13,11,18,53,2.9,0,4.1,5,38.9,15,11,97,8.8,0,7.5,73.3,6.5,4,60,29,53,150,150,0,FB
5784,Cedric Jackson,17,1,18,1991,23,DET,8,1,17,55,3.2,0,6.9,3,29.4,3,1,-2,-2,0,-0.3,33.3,-0.7,0,0,18,55,53,62,9,RB
5785,Stanford Jennings,0,0,0,1991,29,NOR,5,0,0,0,,0,0,0,,0,0,0,,0,0,,,0,,0,0,0,213,213,RB
5786,Anthony Johnson,22,42,64,1991,24,IND,9,6,22,94,4.3,0,10.4,4,54.5,62,42,344,8.2,0,38.2,67.7,5.5,20,48.4,64,94,438,438,0,FB
5787,Daryl Johnston,17,28,45,1991,25,DAL,16,14,17,54,3.2,0,3.4,6,52.9,42,28,244,8.7,1,15.3,66.7,5.8,15,54.8,45,54,298,298,0,FB
5788,Johnny Johnson,196,29,225,1991,23,PHO,15,13,196,666,3.4,4,44.4,42,45.4,42,29,225,7.8,2,15,69,5.4,9,38.1,225,666,891,891,0,RB
5789,Tracy Johnson,8,3,11,1991,25,ATL,16,5,8,26,3.3,0,1.6,3,50,5,3,27,9,0,1.7,60,5.4,1,20,11,26,53,53,0,RB
5790,Bill Jones,0,14,14,1991,25,KAN,15,14,0,0,,0,0,0,,18,14,97,6.9,1,6.5,77.8,5.4,7,66.7,14,0,97,97,0,RB
5791,James Jones,45,10,55,1991,30,SEA,16,6,45,154,3.4,3,9.6,13,53.3,13,10,103,10.3,0,6.4,76.9,7.9,5,53.8,55,154,257,257,0,RB
5792,Keith Jones,35,6,41,1991,25,ATL,5,3,35,126,3.6,0,25.2,9,51.4,7,6,58,9.7,0,11.6,85.7,8.3,4,71.4,41,126,184,184,0,RB
5793,Victor Jones,0,0,0,1991,24,HOU,14,0,0,0,,0,0,0,,0,0,0,,0,0,,,0,,0,0,0,7,7,RB
5794,Buford Jordan,47,15,62,1991,29,NOR,14,6,47,150,3.2,2,10.7,12,48.9,20,15,92,6.1,1,6.6,75,4.6,6,50,62,150,242,260,18,FB
5795,James Joseph,135,10,145,1991,24,PHI,16,3,135,440,3.3,3,27.5,24,37,11,10,64,6.4,0,4,90.9,5.8,3,54.5,145,440,504,504,0,RB
5796,David Lang,0,0,0,1991,23,RAM,16,0,0,0,,0,0,0,,0,0,0,,0,0,,,0,,0,0,0,194,194,RB
5797,Brian Lattimore,0,0,0,1991,25,IND,3,0,0,0,,0,0,0,,0,0,0,,0,0,,,0,,0,0,0,0,0,RB
5798,Darren Lewis,15,0,15,1991,23,CHI,15,0,15,36,2.4,0,2.4,2,33.3,0,0,0,,0,0,,,0,,15,36,36,49,13,RB
5799,Greg Lewis,99,2,101,1991,22,DEN,16,4,99,376,3.8,4,23.5,21,47.5,4,2,9,4.5,0,0.6,50,2.3,0,25,101,376,385,405,20,RB
5800,Doug Lloyd,0,0,0,1991,26,RAI,1,0,0,0,,0,0,0,,0,0,0,,0,0,,,0,,0,0,0,0,0,RB
5801,Marc Logan,4,0,4,1991,26,MIA,16,0,4,5,1.3,0,0.3,0,0,0,0,0,,0,0,,,0,,4,5,5,196,191,RB
5802,Derek Loville,22,0,22,1991,23,SEA,16,0,22,69,3.1,0,4.3,2,36.4,3,0,0,,0,0,0,0,0,0,22,69,69,497,428,RB
5803,Kevin Mack,197,40,237,1991,29,CLE,14,11,197,726,3.7,8,51.9,46,44.2,53,40,255,6.4,2,18.2,75.5,4.8,11,47.2,237,726,981,981,0,FB
5804,Tim Manoa,27,2,29,1991,27,IND,9,5,27,144,5.3,1,16,7,55.6,7,2,5,2.5,0,0.6,28.6,0.7,0,14.3,29,144,149,149,0,RB
5805,Fred McAfee,109,1,110,1991,23,NOR,9,0,109,494,4.5,2,54.9,23,47.7,5,1,8,8,0,0.9,20,1.6,0,20,110,494,502,516,14,RB
5806,Napoleon McCallum,31,0,31,1991,28,RAI,16,0,31,110,3.5,1,6.9,6,48.4,0,0,0,,0,0,,,0,,31,110,110,215,105,RB
5807,Buford McGee,19,20,39,1991,31,RAM,16,4,19,65,3.4,0,4.1,7,52.6,29,20,160,8,0,10,69,5.5,8,58.6,39,65,225,225,0,RB
5808,Todd McNair,10,37,47,1991,26,KAN,14,0,10,51,5.1,0,3.6,2,30,52,37,342,9.2,1,24.4,71.2,6.6,16,51.9,47,51,393,459,66,RB
5809,Freeman McNeil,51,7,58,1991,32,NYJ,13,1,51,300,5.9,2,23.1,17,58.8,11,7,56,8,0,4.3,63.6,5.1,3,54.5,58,300,356,356,0,RB
5810,Dave Meggett,29,50,79,1991,25,NYG,16,2,29,153,5.3,1,9.6,7,41.4,63,50,412,8.2,3,25.8,79.4,6.5,25,41.3,79,153,565,1366,801,RB
5811,Eric Metcalf,30,29,59,1991,23,CLE,8,3,30,107,3.6,0,13.4,3,36.7,36,29,294,10.1,0,36.8,80.6,8.2,13,58.3,59,96,401,852,451,RB
5812,Brian Mitchell,3,0,3,1991,23,WAS,16,0,3,14,4.7,0,0.9,1,33.3,0,0,0,,0,0,,,0,,3,14,14,1197,1183,RB
5813,Joe Morris,93,13,106,1991,31,CLE,16,4,93,289,3.1,2,18.1,20,36.6,17,13,76,5.8,0,4.8,76.5,4.5,3,52.9,106,289,365,675,310,RB
5814,Bobby Morse,3,0,3,1991,26,NOR,6,0,3,7,2.3,0,1.2,1,33.3,0,0,0,,0,0,,,0,,3,7,7,69,62,RB
5815,Brad Muster,90,35,125,1991,26,CHI,11,11,90,412,4.6,6,37.5,25,53.3,45,35,287,8.2,1,26.1,77.8,6.4,15,64.4,125,412,699,699,0,FB
5816,Darrin Nelson,28,19,47,1991,32,MIN,16,0,28,210,7.5,2,13.1,11,60.7,25,19,142,7.5,0,8.9,76,5.7,6,36,47,235,352,1034,682,RB
5817,Christian Okoye,225,3,228,1991,30,KAN,14,12,225,1031,4.6,9,73.6,67,58.2,3,3,34,11.3,0,2.4,100,11.3,3,100,228,1031,1065,1065,0,FB
5818,Mike Oliphant,0,0,0,1991,28,CLE,4,0,0,0,,0,0,0,,0,0,0,,0,0,,,0,,0,0,0,0,0,RB
5819,Don Overton,14,4,18,1991,24,DET,14,0,14,59,4.2,0,4.2,3,57.1,4,4,38,9.5,0,2.7,100,9.5,2,100,18,59,97,168,71,RB
5820,Tony Paige,10,57,67,1991,29,MIA,16,16,10,25,2.5,0,1.6,4,40,73,57,469,8.2,1,29.3,78.1,6.4,19,65.8,67,25,494,525,31,FB
5821,Erric Pegram,101,1,102,1991,22,ATL,16,7,101,349,3.5,1,21.8,13,34.7,2,1,-1,-1,0,-0.1,50,-0.5,0,0,102,349,348,608,260,RB
5822,Bruce Perkins,4,3,7,1991,24,IND,14,1,4,11,2.8,0,0.8,0,0,3,3,-2,-0.7,0,-0.1,100,-0.7,0,0,7,11,9,9,0,RB
5823,Bob Perryman,21,17,38,1991,27,DEN,15,7,21,45,2.1,0,3,6,57.1,25,17,171,10.1,0,11.4,68,6.8,9,60,38,45,216,217,0,RB
5824,Allen Pinkett,171,29,200,1991,27,HOU,16,16,171,720,4.2,9,45,45,53.8,36,29,228,7.9,1,14.3,80.6,6.3,10,52.8,200,720,948,1456,508,RB
5825,Tom Rathman,63,34,97,1991,29,SFO,16,16,63,183,2.9,6,11.4,23,54,44,34,286,8.4,0,17.9,77.3,6.5,13,52.3,97,183,469,469,0,FB
5826,Allen Rice,30,2,32,1991,29,GNB,6,3,30,100,3.3,0,16.7,5,36.7,6,2,10,5,0,1.7,33.3,1.7,0,0,32,100,110,146,36,RB
5827,Curvin Richards,2,0,2,1991,23,DAL,2,0,2,4,2,0,2,0,0,0,0,0,,0,0,,,0,,2,4,4,4,0,RB
5828,Gerald Riggs,78,1,79,1991,31,WAS,16,0,78,248,3.2,11,15.5,26,43.6,1,1,5,5,0,0.3,100,5,0,0,79,248,253,253,0,RB
5829,Reggie Rivers,2,0,2,1991,23,DEN,16,0,2,5,2.5,0,0.3,0,0,1,0,0,,0,0,0,0,0,0,2,5,5,5,0,RB
5830,James Rouse,27,15,42,1991,25,CHI,14,4,27,74,2.7,0,5.3,5,40.7,21,15,93,6.2,0,6.6,71.4,4.4,3,52.4,42,74,167,177,10,RB
5831,Lee Rouson,3,2,5,1991,29,CLE,16,3,3,14,4.7,0,0.9,0,0,2,2,9,4.5,0,0.6,100,4.5,0,0,5,14,23,39,16,RB
5832,Mike Rozier,96,2,98,1991,30,ATL,11,0,96,361,3.8,0,32.8,15,43.8,3,2,15,7.5,0,1.4,66.7,5,0,66.7,98,361,376,376,0,RB
5833,Leonard Russell,266,18,284,1991,22,NWE,16,15,266,959,3.6,4,59.9,54,41.4,26,18,81,4.5,0,5.1,69.2,3.1,2,38.5,284,959,1040,1040,0,RB
5834,Chris Samuels,2,2,4,1991,22,SDG,3,0,2,10,5,0,3.3,0,50,3,2,33,16.5,0,11,66.7,11,1,33.3,4,10,43,43,0,RB
5835,Barry Sanders,342,41,383,1991,23,DET,15,15,342,1548,4.5,16,103.2,91,52.6,52,41,307,7.5,1,20.5,78.8,5.9,18,50,383,1548,1855,1855,0,RB
5836,Thomas Sanders,54,8,62,1991,29,PHI,5,3,54,122,2.3,1,24.4,8,35.2,12,8,62,7.8,0,12.4,66.7,5.2,3,41.7,62,122,184,344,160,RB
5837,James Saxon,6,6,12,1991,25,KAN,16,0,6,13,2.2,0,0.8,1,16.7,7,6,55,9.2,0,3.4,85.7,7.9,3,42.9,12,13,68,124,56,FB
5838,Steve Sewell,50,38,88,1991,28,DEN,16,1,50,211,4.2,2,13.2,13,42,48,38,436,11.5,2,27.3,79.2,9.1,20,50,88,235,647,661,14,RB
5839,Heath Sherman,106,14,120,1991,24,PHI,16,5,106,279,2.6,0,17.4,14,34.9,18,14,59,4.2,0,3.7,77.8,3.3,2,33.3,120,279,338,399,61,RB
5840,Vai Sikahema,0,0,0,1991,29,GNB,11,0,0,0,,0,0,0,,0,0,0,,0,0,,,0,,0,0,0,564,564,RB
5841,Cedric Smith,0,0,0,1991,23,NOR,6,0,0,0,,0,0,0,,0,0,0,,0,0,,,0,,0,0,0,0,0,FB
5842,Emmitt Smith,365,49,414,1991,22,DAL,16,16,365,1563,4.3,12,97.7,77,46,60,49,258,5.3,1,16.1,81.7,4.3,10,38.3,414,1563,1821,1821,0,RB
5843,Sammie Smith,83,14,97,1991,24,MIA,12,6,83,297,3.6,1,24.8,19,50.6,22,14,95,6.8,0,7.9,63.6,4.3,3,54.5,97,297,392,392,0,RB
5844,Steve Smith,62,15,77,1991,27,RAI,16,16,62,265,4.3,1,16.6,19,56.5,28,15,130,8.7,1,8.1,53.6,4.6,5,39.3,77,265,395,395,0,FB
5845,John Stephens,63,16,79,1991,25,NWE,14,3,63,163,2.6,2,11.6,12,36.5,24,16,119,7.4,0,8.5,66.7,5,4,33.3,79,163,282,282,0,RB
5846,Troy Stradford,1,9,10,1991,27,KAN,10,0,1,7,7,0,0.7,0,0,12,9,91,10.1,0,9.1,75,7.6,6,66.7,10,7,98,540,442,RB
5847,Harry Sydney,57,13,70,1991,32,SFO,16,0,57,245,4.3,5,15.3,17,47.4,16,13,90,6.9,2,5.6,81.3,5.6,8,56.3,70,245,335,348,13,RB
5848,Mosi Tatupu,0,0,0,1991,36,RAM,5,0,0,0,,0,0,0,,0,0,0,,0,0,,,0,,0,0,0,0,0,RB
5849,Craig Taylor,33,21,54,1991,25,CIN,12,3,33,153,4.6,2,12.8,8,42.4,26,21,122,5.8,0,10.2,80.8,4.7,5,46.2,54,153,275,275,0,RB
5850,Anthony Thompson,126,7,133,1991,24,PHO,16,4,126,376,3,1,23.5,19,35.7,12,7,52,7.4,0,3.3,58.3,4.3,2,41.7,133,376,428,428,0,RB
5851,Blair Thomas,189,30,219,1991,24,NYJ,16,12,189,728,3.9,3,45.5,41,47.1,48,30,195,6.5,1,12.2,62.5,4.1,10,41.7,219,744,923,923,0,RB
5852,Darrell Thompson,141,7,148,1991,24,GNB,13,13,141,471,3.3,1,36.2,24,44,15,7,71,10.1,0,5.5,46.7,4.7,2,46.7,148,471,542,669,127,FB
5853,Ernie Thompson,2,2,4,1991,22,RAM,4,0,2,9,4.5,0,2.3,0,50,4,2,35,17.5,1,8.8,50,8.8,2,50,4,9,44,44,0,RB
5854,Leroy Thompson,20,14,34,1991,22,PIT,13,0,20,60,3,0,4.6,2,50,24,14,118,8.4,0,9.1,58.3,4.9,7,54.2,34,60,178,186,8,RB
5855,Thurman Thomas,288,62,350,1991,25,BUF,15,15,288,1407,4.9,7,93.8,62,52.1,73,62,631,10.2,5,42.1,84.9,8.6,30,69.9,350,1407,2038,2038,0,RB
5856,Lewis Tillman,65,5,70,1991,25,NYG,16,1,65,287,4.4,1,17.9,14,46.2,6,5,30,6,0,1.9,83.3,5,2,50,70,287,317,346,29,RB
5857,Spencer Tillman,13,2,15,1991,27,SFO,16,0,13,40,3.1,0,2.5,2,15.4,3,2,3,1.5,0,0.2,66.7,1,0,0,15,40,43,175,132,RB
5858,Jon Vaughn,31,9,40,1991,21,NWE,16,2,31,146,4.7,2,9.1,8,38.7,18,9,89,9.9,0,5.6,50,4.9,3,33.3,40,159,235,950,717,RB
5859,Herschel Walker,198,33,231,1991,29,MIN,15,15,198,825,4.2,10,55,49,47.5,42,33,204,6.2,0,13.6,78.6,4.9,10,47.6,231,825,1029,1112,83,RB
5860,Chris Warren,11,2,13,1991,23,SEA,16,1,11,13,1.2,0,0.8,0,18.2,3,2,9,4.5,0,0.6,66.7,3,1,33.3,13,13,22,1112,1090,RB
5861,Chuck Weatherspoon,0,0,0,1991,23,TAM,4,0,0,0,,0,0,0,,0,0,0,,0,0,,,0,,0,0,0,0,0,RB
5862,Chuck Webb,0,0,0,1991,22,GNB,2,0,0,0,,0,0,0,,0,0,0,,0,0,,,0,,0,0,0,40,40,FB
5863,Lorenzo White,110,27,137,1991,25,HOU,13,0,110,465,4.2,4,35.8,39,59.1,34,27,211,7.8,0,16.2,79.4,6.2,8,52.9,137,465,676,676,0,RB
5864,Harvey Williams,97,16,113,1991,24,KAN,14,1,97,447,4.6,1,31.9,21,54.6,18,16,147,9.2,2,10.5,88.9,8.2,7,77.8,113,447,594,1118,524,RB
5865,John Williams,188,61,249,1991,27,SEA,16,16,188,741,3.9,4,46.3,34,41.5,80,61,499,8.2,1,31.2,76.3,6.2,21,51.3,249,741,1240,1240,0,FB
5866,Warren Williams,57,15,72,1991,26,PIT,16,3,57,262,4.6,4,16.4,17,70.2,19,15,139,9.3,0,8.7,78.9,7.3,7,57.9,72,262,401,401,0,RB
5867,Marcus Wilson,6,0,6,1991,23,RAI,1,0,6,21,3.5,0,21,1,50,0,0,0,,0,0,,,0,,6,21,21,21,0,RB
5868,Robert Wilson,42,20,62,1991,22,TAM,16,15,42,179,4.3,0,11.2,9,47.6,31,20,121,6.1,2,7.6,64.5,3.9,5,45.2,62,179,300,319,19,FB
5869,Ron Wolfley,0,0,0,1991,29,PHO,16,0,0,0,,0,0,0,,1,0,0,,0,0,0,0,0,0,0,0,0,0,0,RB
5870,Ickey Woods,36,6,42,1991,25,CIN,9,2,36,97,2.7,4,10.8,12,38.9,9,6,36,6,0,4,66.7,4,1,33.3,42,97,133,133,0,RB
5871,Keith Woodside,84,22,106,1991,27,GNB,16,12,84,326,3.9,1,20.4,16,46.4,40,22,185,8.4,0,11.6,55,4.6,5,32.5,106,326,511,511,0,RB
5872,Barry Word,160,2,162,1991,28,KAN,16,3,160,684,4.3,4,42.8,36,55,2,2,13,6.5,0,0.8,100,6.5,0,100,162,684,697,697,0,RB
5873,Vince Workman,71,46,117,1991,23,GNB,16,0,71,237,3.3,7,14.8,29,49.3,55,46,371,8.1,4,23.2,83.6,6.7,19,56.4,117,237,608,756,139,RB
5874,Tim Worley,22,0,22,1991,25,PIT,2,0,22,117,5.3,0,58.5,4,68.2,1,0,0,,0,0,0,0,0,0,22,117,117,117,0,RB
5875,George Adams,28,16,44,1990,28,NWE,16,7,28,111,4,0,6.9,6,46.4,23,16,146,9.1,1,9.1,69.6,6.3,7,47.8,44,111,257,264,7,FB
5876,Tommie Agee,53,30,83,1990,26,DAL,16,11,53,213,4,0,13.3,10,41.5,43,30,272,9.1,1,17,69.8,6.3,13,55.8,83,213,485,485,0,FB
5877,Marcus Allen,179,15,194,1990,30,RAI,16,15,179,682,3.8,12,42.6,50,49.7,22,15,189,12.6,1,11.8,68.2,8.6,7,54.5,194,682,871,871,0,RB
5878,Marvin Allen,63,6,69,1990,25,NWE,8,3,63,237,3.8,1,29.6,15,41.3,8,6,48,8,0,6,75,6,1,37.5,69,237,285,453,168,RB
5879,Alfred Anderson,59,13,72,1990,29,MIN,11,6,59,207,3.5,2,18.8,16,59.3,19,13,80,6.2,0,7.3,68.4,4.2,2,36.8,72,207,287,331,44,FB
5880,Gary Anderson,166,38,204,1990,29,TAM,16,13,166,646,3.9,3,40.4,25,47.6,57,38,464,12.2,2,29,66.7,8.1,16,47.4,204,646,1110,1233,123,RB
5881,Neal Anderson,260,42,302,1990,26,CHI,15,14,260,1078,4.1,10,71.9,50,43.8,59,42,484,11.5,3,32.3,71.2,8.2,20,47.5,302,1078,1562,1562,0,RB
5882,Ottis Anderson,225,18,243,1990,33,NYG,16,11,225,784,3.5,11,49,55,45.8,21,18,139,7.7,0,8.7,85.7,6.6,7,52.4,243,784,923,945,0,RB
5883,Johnny Bailey,26,0,26,1990,23,CHI,16,1,26,86,3.3,0,5.4,5,46.2,2,0,0,,0,0,0,0,0,0,26,108,86,848,762,RB
5884,Eric Ball,22,2,24,1990,24,CIN,13,1,22,72,3.3,1,5.5,3,40.9,3,2,46,23,1,3.5,66.7,15.3,1,33.3,24,72,118,484,366,RB
5885,Brad Baxter,124,8,132,1990,23,NYJ,16,10,124,539,4.3,6,33.7,28,56.5,11,8,73,9.1,0,4.6,72.7,6.6,3,54.5,132,539,612,612,0,FB
5886,Greg Bell,47,1,48,1990,28,RAI,6,0,47,164,3.5,1,27.3,12,53.2,4,1,7,7,0,1.2,25,1.8,0,25,48,164,171,171,0,RB
5887,Richard Bell,5,12,17,1990,23,PIT,16,1,5,18,3.6,0,1.1,2,40,27,12,137,11.4,1,8.6,44.4,5.1,6,29.6,17,18,155,155,0,RB
5888,Albert Bentley,137,71,208,1990,30,IND,16,15,137,556,4.1,4,34.8,35,44.5,123,71,664,9.4,2,41.5,57.7,5.4,23,36.6,208,556,1220,1442,211,FB
5889,Rod Bernstine,124,8,132,1990,25,SDG,12,1,124,589,4.8,4,49.1,28,54.8,12,8,40,5,0,3.3,66.7,3.3,1,25,132,589,629,629,0,RB
5890,Mel Bratton,27,29,56,1990,25,DEN,16,3,27,82,3,3,5.1,8,51.9,37,29,276,9.5,1,17.3,78.4,7.5,10,56.8,56,82,358,395,37,RB
5891,James Brooks,195,26,221,1990,32,CIN,16,15,195,1004,5.1,5,62.8,44,44.6,43,26,269,10.3,4,16.8,60.5,6.3,13,37.2,221,1004,1273,1273,0,RB
5892,Steve Broussard,126,24,150,1990,23,ATL,13,10,126,454,3.6,4,34.9,19,44.4,30,24,160,6.7,0,12.3,80,5.3,7,40,150,454,614,659,45,RB
5893,A.B. Brown,1,0,1,1990,25,NYJ,1,0,1,8,8,0,8,1,100,0,0,0,,0,0,,,0,,1,8,8,71,63,RB
5894,Kelvin Bryant,6,26,32,1990,30,WAS,15,0,6,24,4,0,1.6,2,33.3,37,26,248,9.5,1,16.5,70.3,6.7,19,62.2,32,24,272,272,0,RB
5895,Marion Butts,265,16,281,1990,24,SDG,14,13,265,1225,4.6,8,87.5,62,49.8,19,16,117,7.3,0,8.4,84.2,6.2,4,52.6,281,1225,1342,1342,0,RB
5896,Keith Byars,37,81,118,1990,27,PHI,16,15,37,141,3.8,0,8.8,12,48.6,120,81,819,10.1,3,51.2,67.5,6.8,39,52.5,118,194,960,960,0,RB
5897,Earnest Byner,297,31,328,1990,28,WAS,16,16,297,1219,4.1,6,76.2,60,50.5,45,31,279,9,1,17.4,68.9,6.2,13,57.8,328,1250,1498,1498,0,RB
5898,Dexter Carter,114,25,139,1990,23,SFO,16,5,114,460,4,1,28.8,16,43,31,25,217,8.7,0,13.6,80.6,7,11,64.5,139,460,677,1460,783,RB
5899,Maurice Carthon,36,14,50,1990,29,NYG,16,13,36,143,4,0,8.9,15,75,16,14,151,10.8,0,9.4,87.5,9.4,3,50,50,143,294,294,0,FB
5900,Larry Centers,0,0,0,1990,22,PHO,6,0,0,0,,0,0,0,,0,0,0,,0,0,,,0,,0,0,0,272,272,FB
5901,Jessie Clark,16,1,17,1990,30,MIN,5,3,16,49,3.1,0,9.8,2,50,1,1,4,4,0,0.8,100,4,0,100,17,49,53,53,0,RB
5902,Ken Clark,7,5,12,1990,24,IND,5,3,7,10,1.4,0,2,1,14.3,7,5,23,4.6,0,4.6,71.4,3.3,2,42.9,12,10,33,33,0,RB
5903,Reggie Cobb,151,39,190,1990,22,TAM,16,13,151,480,3.2,2,30,38,44.4,49,39,299,7.7,0,18.7,79.6,6.1,12,59.2,190,480,779,1002,223,FB
5904,Tony Collins,0,0,0,1990,31,MIA,1,0,0,0,,0,0,0,,0,0,0,,0,0,,,0,,0,0,0,30,30,RB
5905,Roger Craig,141,25,166,1990,30,SFO,11,11,141,439,3.1,1,39.9,21,42.6,39,25,201,8,0,18.3,64.1,5.2,7,43.6,166,439,640,640,0,RB
5906,Kenneth Davis,64,9,73,1990,28,BUF,16,0,64,302,4.7,4,18.9,22,56.3,10,9,78,8.7,1,4.9,90,7.8,5,70,73,302,380,380,0,RB
5907,Robert Delpino,13,15,28,1990,25,RAM,15,2,13,52,4,0,3.5,2,30.8,28,15,172,11.5,4,11.5,53.6,6.1,8,42.9,28,52,224,613,389,RB
5908,Eric Dickerson,166,18,184,1990,30,IND,11,8,166,677,4.1,4,61.5,40,47,26,18,92,5.1,0,8.4,69.2,3.5,2,34.6,184,677,769,769,0,RB
5909,James Dixon,11,2,13,1990,23,DAL,15,1,11,43,3.9,0,2.9,2,54.5,10,2,26,13,0,1.7,20,2.6,1,10,13,43,69,805,736,RB
5910,D.J. Dozier,6,1,7,1990,25,MIN,6,1,6,12,2,0,2,0,33.3,1,1,12,12,0,2,100,12,1,100,7,12,24,24,0,RB
5911,Robert Drummond,8,5,13,1990,23,PHI,4,0,8,33,4.1,1,8.3,2,50,9,5,39,7.8,0,9.8,55.6,4.3,1,33.3,13,33,72,72,0,RB
5912,Reggie Dupard,19,0,19,1990,27,WAS,7,0,19,85,4.5,0,12.1,5,52.6,0,0,0,,0,0,,,0,,19,85,85,85,0,RB
5913,Marcus Dupree,19,0,19,1990,26,RAM,7,1,19,72,3.8,0,10.3,2,47.4,0,0,0,,0,0,,,0,,19,72,72,72,0,RB
5914,Blake Ezor,23,0,23,1990,24,DEN,9,0,23,81,3.5,0,9,5,56.5,1,0,0,,0,0,0,0,0,0,23,81,81,295,214,RB
5915,Gill Fenerty,73,18,91,1990,27,NOR,15,0,73,355,4.9,2,23.7,14,45.2,29,18,209,11.6,0,13.9,62.1,7.2,9,37.9,91,355,564,1136,572,RB
5916,Derrick Fenner,215,17,232,1990,23,SEA,16,15,215,859,4,14,53.7,54,49.8,22,17,143,8.4,1,8.9,77.3,6.5,6,50,232,859,1002,1002,0,RB
5917,Rick Fenney,87,17,104,1990,26,MIN,12,5,87,376,4.3,2,31.3,21,55.2,24,17,112,6.6,0,9.3,70.8,4.7,5,50,104,376,488,488,0,FB
5918,Terrence Flagler,13,13,26,1990,26,PHO,13,0,13,85,6.5,1,6.5,4,38.5,21,13,130,10,1,10,61.9,6.2,8,57.1,26,85,215,382,167,RB
5919,Herman Fontenot,17,31,48,1990,27,GNB,14,0,17,76,4.5,0,5.4,5,41.2,45,31,293,9.5,1,20.9,68.9,6.5,18,51.1,48,76,369,457,88,RB
5920,Barry Foster,36,1,37,1990,22,PIT,16,1,36,203,5.6,1,12.7,13,63.9,2,1,2,2,0,0.1,50,1,0,0,37,203,205,234,29,RB
5921,Brent Fullwood,44,3,47,1990,27,"CLE,GNB",6,4,44,124,2.8,1,20.7,7,43.2,6,3,17,5.7,0,2.8,50,2.8,1,33.3,47,124,141,260,119,RB
5922,Derrick Gainer,30,7,37,1990,24,CLE,16,1,30,81,2.7,1,5.1,4,40,7,7,85,12.1,0,5.3,100,12.1,4,85.7,37,81,166,166,0,RB
5923,Kenny Gamble,0,0,0,1990,25,KAN,1,0,0,0,,0,0,0,,0,0,0,,0,0,,,0,,0,0,0,0,0,RB
5924,Carwell Gardner,15,0,15,1990,24,BUF,7,0,15,41,2.7,0,5.9,2,33.3,0,0,0,,0,0,,,0,,15,41,41,41,0,FB
5925,Cleveland Gary,204,30,234,1990,24,RAM,15,7,204,808,4,14,53.9,50,46.1,37,30,150,5,1,10,81.1,4.1,5,43.2,234,808,958,958,0,RB
5926,Gaston Green,68,2,70,1990,24,RAM,15,3,68,261,3.8,0,17.4,8,48.5,3,2,23,11.5,1,1.5,66.7,7.7,1,66.7,70,261,284,844,560,RB
5927,Harold Green,83,12,95,1990,22,CIN,12,9,83,353,4.3,1,29.4,14,48.2,18,12,90,7.5,1,7.5,66.7,5,4,33.3,95,353,443,443,0,FB
5928,Mark Green,27,4,31,1990,23,CHI,12,1,27,126,4.7,0,10.5,6,44.4,7,4,26,6.5,1,2.2,57.1,3.7,3,42.9,31,126,152,264,112,RB
5929,Michael Haddix,98,13,111,1990,29,GNB,16,12,98,311,3.2,0,19.4,16,40.8,22,13,94,7.2,2,5.9,59.1,4.3,5,40.9,111,311,405,405,0,FB
5930,Rodney Hampton,109,32,141,1990,21,NYG,15,2,109,455,4.2,2,30.3,15,37.6,43,32,274,8.6,2,18.3,74.4,6.4,11,44.2,141,455,729,1069,340,RB
5931,Ronnie Harmon,66,46,112,1990,26,SDG,16,2,66,363,5.5,0,22.7,16,43.9,63,46,511,11.1,2,31.9,73,8.1,25,52.4,112,363,874,874,0,RB
5932,John Harvey,27,11,38,1990,24,TAM,16,1,27,113,4.2,0,7.1,4,37,17,11,86,7.8,1,5.4,64.7,5.1,7,52.9,38,113,199,406,207,RB
5933,Johnny Hector,91,8,99,1990,30,NYJ,15,3,91,377,4.1,2,25.1,26,52.7,13,8,72,9,0,4.8,61.5,5.5,3,23.1,99,377,449,449,0,RB
5934,Keith Henderson,6,4,10,1990,24,SFO,2,0,6,14,2.3,0,7,0,0,5,4,35,8.8,0,17.5,80,7,0,0,10,14,49,49,0,RB
5935,Craig Heyward,129,18,147,1990,24,NOR,16,15,129,599,4.6,4,37.4,41,58.9,22,18,121,6.7,0,7.6,81.8,5.5,4,59.1,147,599,720,732,12,FB
5936,Mark Higgs,10,0,10,1990,24,MIA,12,0,10,67,6.7,0,5.6,4,80,0,0,0,,0,0,,,0,,10,67,67,277,210,RB
5937,Alonzo Highsmith,19,3,22,1990,25,DAL,7,5,19,48,2.5,0,6.9,3,31.6,7,3,13,4.3,0,1.9,42.9,1.9,0,28.6,22,48,61,61,0,FB
5938,Dalton Hilliard,90,14,104,1990,26,NOR,6,6,90,284,3.2,0,47.3,17,34.4,18,14,125,8.9,1,20.8,77.8,6.9,6,55.6,104,284,409,409,0,RB
5939,Leroy Hoard,58,10,68,1990,22,CLE,14,5,58,149,2.6,3,10.6,9,44.8,13,10,73,7.3,0,5.2,76.9,5.6,3,53.8,68,149,222,240,18,RB
5940,Merril Hoge,203,40,243,1990,25,PIT,16,15,203,772,3.8,7,48.3,42,47.3,62,40,342,8.6,3,21.4,64.5,5.5,22,53.2,243,772,1114,1114,0,FB
5941,Bobby Humphrey,288,24,312,1990,24,DEN,15,14,288,1202,4.2,7,80.1,70,50.3,32,24,152,6.3,0,10.1,75,4.8,4,53.1,312,1202,1354,1354,0,RB
5942,Ivy Joe Hunter,0,0,0,1990,24,IND,16,1,0,0,,0,0,0,,0,0,0,,0,0,,,0,,0,0,0,0,0,RB
5943,Bo Jackson,125,6,131,1990,28,RAI,10,0,125,698,5.6,5,69.8,27,49.6,12,6,68,11.3,0,6.8,50,5.7,4,50,131,698,766,766,0,RB
5944,Stanford Jennings,12,4,16,1990,28,CIN,16,0,12,46,3.8,1,2.9,3,41.7,5,4,23,5.8,0,1.4,80,4.6,0,60,16,46,69,653,584,RB
5945,Anthony Johnson,0,5,5,1990,23,IND,16,0,0,0,,0,0,0,,6,5,32,6.4,2,2,83.3,5.3,3,66.7,5,0,32,32,0,RB
5946,Daryl Johnston,10,14,24,1990,24,DAL,16,0,10,35,3.5,1,2.2,2,50,20,14,148,10.6,1,9.3,70,7.4,9,70,24,35,183,183,0,RB
5947,Johnny Johnson,234,25,259,1990,22,PHO,14,14,234,926,4,5,66.1,51,46.2,38,25,241,9.6,0,17.2,65.8,6.3,8,50,259,926,1167,1167,0,RB
5948,Tracy Johnson,30,10,40,1990,24,ATL,16,5,30,106,3.5,3,6.6,8,46.7,13,10,79,7.9,1,4.9,76.9,6.1,3,61.5,40,106,185,187,2,RB
5949,Bill Jones,10,19,29,1990,24,KAN,16,5,10,47,4.7,0,2.9,1,60,27,19,137,7.2,5,8.6,70.4,5.1,10,51.9,29,47,184,184,0,RB
5950,James Jones,5,1,6,1990,29,SEA,16,0,5,20,4,0,1.3,2,60,1,1,22,22,0,1.4,100,22,1,100,6,20,42,63,21,FB
5951,Keith Jones,49,13,62,1990,24,ATL,15,10,49,185,3.8,0,12.3,8,46.9,15,13,103,7.9,0,6.9,86.7,6.9,4,73.3,62,222,288,524,236,FB
5952,Victor Jones,14,0,14,1990,23,HOU,10,0,14,75,5.4,0,7.5,6,64.3,0,0,0,,0,0,,,0,,14,75,75,75,0,RB
5953,Buford Jordan,0,0,0,1990,28,NOR,6,0,0,0,,0,0,0,,0,0,0,,0,0,,,0,,0,0,0,0,0,RB
5954,Larry Kinnebrew,9,0,9,1990,31,BUF,2,0,9,18,2,1,9,3,55.6,0,0,0,,0,0,,,0,,9,18,18,18,0,RB
5955,Gene Lang,9,1,10,1990,28,ATL,3,0,9,24,2.7,0,8,2,33.3,2,1,7,7,0,2.3,50,3.5,0,50,10,24,31,49,18,RB
5956,Jamie Lawson,0,0,0,1990,25,"NWE,TAM",7,0,0,0,,0,0,0,,0,0,0,,0,0,,,0,,0,0,0,0,0,RB
5957,Garrett Limbrick,5,4,9,1990,25,MIA,7,2,5,14,2.8,0,2,0,0,6,4,23,5.8,0,3.3,66.7,3.8,0,0,9,14,37,37,0,RB
5958,Marc Logan,79,7,86,1990,25,MIA,16,0,79,317,4,2,19.8,20,50.6,15,7,54,7.7,0,3.4,46.7,3.6,2,33.3,86,317,371,738,367,RB
5959,Derek Loville,7,0,7,1990,22,SEA,11,1,7,12,1.7,0,1.1,0,0,0,0,0,,0,0,,,0,,7,12,12,371,359,RB
5960,Kevin Mack,158,42,200,1990,28,CLE,14,14,158,702,4.4,5,50.1,51,51.9,59,42,360,8.6,2,25.7,71.2,6.1,18,42.4,200,702,1062,1063,0,FB
5961,Rueben Mayes,138,12,150,1990,27,NOR,15,8,138,510,3.7,7,34,26,47.1,14,12,121,10.1,0,8.1,85.7,8.6,3,50,150,510,631,670,39,RB
5962,Jerry Mays,0,0,0,1990,23,SDG,2,0,0,0,,0,0,0,,0,0,0,,0,0,,,0,,0,0,0,30,30,RB
5963,Napoleon McCallum,10,0,10,1990,27,RAI,16,0,10,25,2.5,0,1.6,1,30,0,0,0,,0,0,,,0,,10,25,25,25,0,RB
5964,Craig McEwen,0,29,29,1990,25,SDG,16,4,0,0,,0,0,0,,46,29,325,11.2,3,20.3,63,7.1,19,60.9,29,0,325,325,0,RB
5965,Buford McGee,44,47,91,1990,30,RAM,16,15,44,234,5.3,1,14.6,19,59.1,65,47,388,8.3,4,24.3,72.3,6,22,46.2,91,257,622,622,0,FB
5966,Todd McNair,14,40,54,1990,25,KAN,15,1,14,61,4.4,0,4.1,4,50,51,40,507,12.7,2,33.8,78.4,9.9,20,52.9,54,61,568,795,227,RB
5967,Freeman McNeil,99,16,115,1990,31,NYJ,16,4,99,458,4.6,6,28.6,26,50.5,39,16,230,14.4,0,14.4,41,5.9,9,35.9,115,458,688,688,0,RB
5968,Dave Meggett,22,39,61,1990,24,NYG,16,1,22,164,7.5,0,10.3,8,50,59,39,410,10.5,1,25.6,66.1,6.9,16,40.7,61,164,574,1533,959,RB
5969,Eric Metcalf,80,57,137,1990,22,CLE,16,10,80,248,3.1,1,15.5,6,33.8,104,57,452,7.9,1,28.3,54.8,4.3,22,34.6,137,248,700,1752,1052,RB
5970,Joe Mickles,0,0,0,1990,25,SDG,1,0,0,0,,0,0,0,,0,0,0,,0,0,,,0,,0,0,0,0,0,RB
5971,Brian Mitchell,15,2,17,1990,22,WAS,15,0,15,81,5.4,1,5.4,4,46.7,2,2,5,2.5,0,0.3,100,2.5,0,0,17,118,86,558,472,RB
5972,Jamie Morris,2,0,2,1990,25,NWE,5,0,2,4,2,0,0.8,0,0,0,0,0,,0,0,,,0,,2,4,4,206,202,RB
5973,Bobby Morse,0,0,0,1990,25,NOR,10,0,0,0,,0,0,0,,0,0,0,,0,0,,,0,,0,0,0,151,151,RB
5974,Jamie Mueller,59,16,75,1990,26,BUF,16,8,59,207,3.5,2,12.9,16,54.2,20,16,106,6.6,1,6.6,80,5.3,4,45,75,207,313,313,0,FB
5975,Vance Mueller,13,0,13,1990,26,RAI,16,1,13,43,3.3,0,2.7,1,23.1,1,0,0,,0,0,0,0,0,0,13,43,43,43,0,RB
5976,Brad Muster,141,47,188,1990,25,CHI,16,15,141,664,4.7,6,41.5,47,56,68,47,452,9.6,0,28.3,69.1,6.6,22,58.8,188,664,1116,1116,0,FB
5977,Darrin Nelson,3,4,7,1990,31,SDG,14,0,3,14,4.7,0,1,1,33.3,12,4,29,7.3,0,2.1,33.3,2.4,1,8.3,7,14,43,123,80,RB
5978,Christian Okoye,245,4,249,1990,29,KAN,14,13,245,805,3.3,7,57.5,48,42,8,4,23,5.8,0,1.6,50,2.9,0,37.5,249,805,828,828,0,FB
5979,Don Overton,5,2,7,1990,23,NWE,7,0,5,8,1.6,0,1.1,0,20,4,2,19,9.5,0,2.7,50,4.8,1,25,7,8,27,215,188,RB
5980,Tony Paige,32,35,67,1990,28,MIA,13,13,32,95,3,2,7.3,8,46.9,41,35,247,7.1,4,19,85.4,6,12,65.9,67,95,342,360,18,FB
5981,Bruce Perkins,13,8,21,1990,23,TAM,16,3,13,36,2.8,0,2.3,1,23.1,8,8,85,10.6,2,5.3,100,10.6,5,87.5,21,36,121,121,0,RB
5982,Bob Perryman,32,15,47,1990,26,NWE,8,7,32,97,3,1,12.1,2,37.5,20,15,88,5.9,0,11,75,4.4,5,45,47,97,185,185,0,FB
5983,Allen Pinkett,66,11,77,1990,26,HOU,15,0,66,268,4.1,0,17.9,14,47,19,11,85,7.7,0,5.7,57.9,4.5,2,21.1,77,268,353,444,91,RB
5984,Kerry Porter,1,4,5,1990,26,DEN,13,3,1,3,3,0,0.2,0,0,8,4,44,11,0,3.4,50,5.5,3,50,5,3,47,47,0,RB
5985,Mike Pringle,2,0,2,1990,23,ATL,3,0,2,9,4.5,0,3,0,0,0,0,0,,0,0,,,0,,2,9,9,23,14,RB
5986,Tom Rathman,101,48,149,1990,28,SFO,16,16,101,318,3.1,7,19.9,34,52.5,68,48,327,6.8,0,20.4,70.6,4.8,14,44.1,149,318,645,645,0,FB
5987,Barry Redden,1,0,1,1990,30,CLE,5,0,1,-1,-1,0,-0.2,0,0,0,0,0,,0,0,,,0,,1,-1,-1,-1,0,RB
5988,Allen Rice,22,4,26,1990,28,MIN,15,0,22,74,3.4,0,4.9,8,45.5,9,4,46,11.5,0,3.1,44.4,5.1,1,11.1,26,74,120,296,176,RB
5989,Gerald Riggs,123,7,130,1990,30,WAS,10,0,123,475,3.9,6,47.5,30,53.7,10,7,60,8.6,0,6,70,6,2,60,130,475,535,535,0,RB
5990,James Rouse,16,0,16,1990,24,CHI,16,0,16,56,3.5,0,3.5,2,56.3,2,0,0,,0,0,0,0,0,0,16,56,56,73,17,RB
5991,Lee Rouson,3,1,4,1990,28,NYG,16,0,3,14,4.7,0,0.9,1,66.7,1,1,12,12,0,0.8,100,12,1,100,4,14,26,26,0,RB
5992,Mike Rozier,163,13,176,1990,29,"ATL,HOU",16,5,163,717,4.4,3,44.8,43,47.9,20,13,105,8.1,0,6.6,65,5.3,5,35,176,717,822,822,0,RB
5993,Barry Sanders,255,36,291,1990,22,DET,16,16,255,1304,5.1,13,81.5,71,53.3,49,36,480,13.3,3,30,73.5,9.8,20,49,291,1304,1784,1784,0,RB
5994,Thomas Sanders,56,2,58,1990,28,PHI,10,0,56,208,3.7,1,20.8,7,35.7,3,2,20,10,0,2,66.7,6.7,1,66.7,58,208,228,527,299,RB
5995,James Saxon,3,1,4,1990,24,KAN,6,0,3,15,5,0,2.5,1,100,1,1,5,5,0,0.8,100,5,0,100,4,15,20,101,81,FB
5996,John Settle,9,0,9,1990,25,ATL,6,0,9,16,1.8,0,2.7,0,0,0,0,0,,0,0,,,0,,9,16,16,16,0,RB
5997,Steve Sewell,17,26,43,1990,27,DEN,12,1,17,46,2.7,3,3.8,5,52.9,42,26,268,10.3,0,22.3,61.9,6.4,14,45.2,43,46,314,314,0,FB
5998,Heath Sherman,164,23,187,1990,23,PHI,14,6,164,685,4.2,1,48.9,30,47,27,23,167,7.3,3,11.9,85.2,6.2,7,55.6,187,685,852,852,0,FB
5999,Vai Sikahema,3,7,10,1990,28,PHO,16,0,3,8,2.7,0,0.5,1,33.3,8,7,51,7.3,0,3.2,87.5,6.4,2,50,10,8,59,909,850,RB
6000,Cedric Smith,9,0,9,1990,22,MIN,15,1,9,19,2.1,0,1.3,0,0,0,0,0,,0,0,,,0,,9,19,19,35,16,FB
6001,Dennis Smith,0,0,0,1990,23,PHO,4,0,0,0,,0,0,0,,0,0,0,,0,0,,,0,,0,0,0,0,0,RB
6002,Don Smith,20,21,41,1990,27,BUF,16,2,20,82,4.1,2,5.1,14,70,29,21,225,10.7,0,14.1,72.4,7.8,10,55.2,41,82,307,950,643,RB
6003,Emmitt Smith,241,24,265,1990,21,DAL,16,15,241,937,3.9,11,58.6,59,44,39,24,228,9.5,0,14.3,61.5,5.8,6,33.3,265,937,1165,1165,0,RB
6004,Sammie Smith,226,11,237,1990,23,MIA,16,16,226,831,3.7,8,51.9,47,46.5,18,11,134,12.2,1,8.4,61.1,7.4,5,50,237,831,965,965,0,RB
6005,Steve Smith,81,4,85,1990,26,RAI,16,15,81,327,4,2,20.4,14,60.5,7,4,30,7.5,3,1.9,57.1,4.3,3,57.1,85,327,357,357,0,FB
6006,Timmy Smith,6,0,6,1990,26,DAL,1,1,6,6,1,0,6,0,0,1,0,0,,0,0,0,0,0,0,6,6,6,6,0,RB
6007,Tim Spencer,0,0,0,1990,30,SDG,4,0,0,0,,0,0,0,,0,0,0,,0,0,,,0,,0,0,0,0,0,RB
6008,John Stephens,212,28,240,1990,24,NWE,16,14,212,808,3.8,2,50.5,36,43.9,50,28,196,7,1,12.3,56,3.9,7,26,240,808,1004,1004,0,RB
6009,Troy Stradford,37,30,67,1990,26,MIA,14,0,37,138,3.7,1,9.9,5,32.4,47,30,257,8.6,0,18.4,63.8,5.5,12,42.6,67,138,395,455,60,RB
6010,Harry Sydney,35,10,45,1990,31,SFO,16,0,35,166,4.7,2,10.4,13,54.3,15,10,116,11.6,1,7.3,66.7,7.7,4,46.7,45,166,282,315,33,RB
6011,Lars Tate,3,0,3,1990,24,CHI,3,0,3,5,1.7,0,1.7,0,0,0,0,0,,0,0,,,0,,3,5,5,5,0,RB
6012,Mosi Tatupu,16,2,18,1990,35,NWE,15,0,16,56,3.5,0,3.7,2,31.3,3,2,10,5,0,0.7,66.7,3.3,1,66.7,18,56,66,66,0,RB
6013,Craig Taylor,51,3,54,1990,24,CIN,12,1,51,216,4.2,2,18,9,49,7,3,22,7.3,1,1.8,42.9,3.1,2,28.6,54,216,238,254,16,RB
6014,Anthony Thompson,106,2,108,1990,23,PHO,13,3,106,390,3.7,4,30,24,43.4,3,2,11,5.5,0,0.8,66.7,3.7,0,0,108,390,401,401,0,RB
6015,Blair Thomas,123,20,143,1990,23,NYJ,15,11,123,620,5,1,41.3,30,49.6,30,20,204,10.2,1,13.6,66.7,6.8,9,50,143,620,824,824,0,RB
6016,Darrell Thompson,76,3,79,1990,23,GNB,16,0,76,264,3.5,1,16.5,12,34.2,5,3,1,0.3,0,0.1,60,0.2,0,0,79,264,265,368,103,RB
6017,Thurman Thomas,271,49,320,1990,24,BUF,16,16,271,1297,4.8,11,81.1,58,51.7,74,49,532,10.9,2,33.3,66.2,7.2,26,52.7,320,1297,1829,1829,0,RB
6018,Lewis Tillman,84,8,92,1990,24,NYG,16,3,84,231,2.8,1,14.4,10,39.3,9,8,18,2.3,0,1.1,88.9,2,1,22.2,92,231,249,249,0,RB
6019,Spencer Tillman,0,0,0,1990,26,SFO,16,0,0,0,,0,0,0,,0,0,0,,0,0,,,0,,0,0,0,111,111,RB
6020,Anthony Toney,132,17,149,1990,28,PHI,15,11,132,452,3.4,1,30.1,22,44.7,20,17,133,7.8,3,8.9,85,6.7,8,50,149,452,585,585,0,FB
6021,Roger Vick,16,0,16,1990,26,PHI,14,0,16,58,3.6,1,4.1,3,50,0,0,0,,0,0,,,0,,16,58,58,80,22,RB
6022,Herschel Walker,184,35,219,1990,28,MIN,16,16,184,770,4.2,5,48.1,37,42.9,59,35,315,9,4,19.7,59.3,5.3,20,50.8,219,782,1085,2051,966,RB
6023,Curt Warner,49,0,49,1990,29,RAM,7,2,49,139,2.8,1,19.9,6,42.9,0,0,0,,0,0,,,0,,49,139,139,139,0,RB
6024,Chris Warren,6,0,6,1990,22,SEA,16,0,6,11,1.8,1,0.7,1,33.3,0,0,0,,0,0,,,0,,6,11,11,758,747,RB
6025,Lorenzo White,168,39,207,1990,24,HOU,16,16,168,702,4.2,8,43.9,48,54.8,49,39,368,9.4,4,23,79.6,7.5,16,63.3,207,702,1070,1070,0,RB
6026,James Wilder,11,1,12,1990,32,"DET,WAS",16,0,11,51,4.6,0,3.2,2,45.5,3,1,8,8,1,0.5,33.3,2.7,1,33.3,12,51,59,59,0,RB
6027,John Williams,187,73,260,1990,26,SEA,16,16,187,714,3.8,3,44.6,48,48.7,97,73,699,9.6,0,43.7,75.3,7.2,27,46.4,260,714,1413,1413,0,FB
6028,Warren Williams,68,5,73,1990,25,PIT,14,4,68,389,5.7,3,27.8,13,55.9,9,5,42,8.4,1,3,55.6,4.7,4,44.4,73,389,431,431,0,RB
6029,Sammy Winder,42,17,59,1990,31,DEN,15,2,42,120,2.9,2,8,7,35.7,23,17,145,8.5,0,9.7,73.9,6.3,5,39.1,59,120,265,311,55,RB
6030,Ron Wolfley,2,0,2,1990,28,PHO,13,2,2,3,1.5,0,0.2,0,0,1,0,0,,0,0,0,0,0,0,2,3,3,3,0,RB
6031,Ickey Woods,64,20,84,1990,24,CIN,10,6,64,268,4.2,6,26.8,20,42.2,25,20,162,8.1,0,16.2,80,6.5,11,60,84,268,430,430,0,FB
6032,Keith Woodside,46,24,70,1990,26,GNB,16,13,46,182,4,1,11.4,7,47.8,44,24,184,7.7,0,11.5,54.5,4.2,7,40.9,70,182,366,366,0,RB
6033,Barry Word,204,4,208,1990,27,KAN,16,3,204,1015,5,4,63.4,48,47.5,5,4,28,7,0,1.8,80,5.6,0,60,208,1015,1043,1053,10,RB
6034,Vince Workman,8,4,12,1990,22,GNB,15,0,8,51,6.4,0,3.4,3,75,6,4,30,7.5,1,2,66.7,5,2,50,12,51,81,291,210,RB
6035,Tim Worley,109,8,117,1990,24,PIT,11,8,109,418,3.8,0,38,18,35.8,13,8,70,8.8,0,6.4,61.5,5.4,2,38.5,117,418,488,488,0,RB
6036,George Adams,9,2,11,1989,27,NYG,14,0,9,29,3.2,0,2.1,0,33.3,2,2,7,3.5,0,0.5,100,3.5,1,50,11,29,36,36,0,RB
6037,Tommie Agee,1,0,1,1989,25,KAN,9,0,1,3,3,0,0.3,1,100,0,0,0,,0,0,,,0,,1,3,3,3,0,RB
6038,Jeff Alexander,45,8,53,1989,24,DEN,14,6,45,146,3.2,2,10.4,6,55.6,13,8,84,10.5,0,6,61.5,6.5,3,46.2,53,146,230,230,0,FB
6039,Marcus Allen,69,20,89,1989,29,RAI,8,5,69,293,4.2,2,36.6,18,59.4,24,20,191,9.6,0,23.9,83.3,8,9,62.5,89,293,484,484,0,RB
6040,Marvin Allen,11,0,11,1989,24,NWE,3,0,11,51,4.6,1,17,5,72.7,2,0,0,,0,0,0,0,0,0,11,51,51,175,124,RB
6041,Alfred Anderson,52,20,72,1989,28,MIN,11,8,52,189,3.6,2,17.2,13,50,28,20,193,9.7,0,17.5,71.4,6.9,9,42.9,72,189,382,457,75,FB
6042,Neal Anderson,274,50,324,1989,25,CHI,16,16,274,1275,4.7,11,79.7,65,47.4,68,50,434,8.7,4,27.1,73.5,6.4,23,54.4,324,1275,1709,1709,0,RB
6043,Ottis Anderson,325,28,353,1989,32,NYG,16,16,325,1023,3.1,14,63.9,62,39.7,34,28,268,9.6,0,16.8,82.4,7.9,10,67.6,353,1023,1291,1291,0,RB
6044,Steve Avery,0,0,0,1989,23,HOU,1,0,0,0,,0,0,0,,0,0,0,,0,0,,,0,,0,0,0,0,0,RB
6045,Tony Baker,20,2,22,1989,25,PHO,10,2,20,31,1.6,0,3.1,0,0,4,2,18,9,0,1.8,50,4.5,0,0,22,31,49,294,245,RB
6046,Eric Ball,98,6,104,1989,23,CIN,15,9,98,391,4,3,26.1,23,44.9,12,6,44,7.3,0,2.9,50,3.7,2,33.3,104,391,435,454,19,FB
6047,Brad Baxter,0,0,0,1989,22,NYJ,1,0,0,0,,0,0,0,,0,0,0,,0,0,,,0,,0,0,0,0,0,RB
6048,Rick Bayless,0,0,0,1989,25,MIN,1,0,0,0,,0,0,0,,0,0,0,,0,0,,,0,,0,0,0,0,0,RB
6049,Greg Bell,272,19,291,1989,27,RAM,16,15,272,1137,4.2,15,71.1,65,47.8,27,19,85,4.5,0,5.3,70.4,3.1,6,37,291,1137,1222,1222,0,RB
6050,Albert Bentley,75,52,127,1989,29,IND,16,8,75,299,4,1,18.7,18,54.7,87,52,525,10.1,3,32.8,59.8,6,23,46,127,299,824,1159,328,FB
6051,Rod Bernstine,15,21,36,1989,24,SDG,5,0,15,137,9.1,1,27.4,5,53.3,27,21,222,10.6,1,44.4,77.8,8.2,12,63,36,137,359,359,0,RB
6052,Reggie Branch,0,0,0,1989,27,WAS,10,0,0,0,,0,0,0,,0,0,0,,0,0,,,0,,0,0,0,6,6,RB
6053,Mel Bratton,30,10,40,1989,24,DEN,16,3,30,108,3.6,1,6.8,4,46.7,14,10,69,6.9,3,4.3,71.4,4.9,5,64.3,40,108,177,196,19,RB
6054,James Brooks,221,37,258,1989,31,CIN,16,14,221,1239,5.6,7,77.4,59,57,52,37,306,8.3,2,19.1,71.2,5.9,18,55.8,258,1239,1545,1545,0,RB
6055,A.B. Brown,12,4,16,1989,24,NYJ,16,0,12,63,5.3,0,3.9,4,50,7,4,10,2.5,0,0.6,57.1,1.4,0,14.3,16,63,73,73,0,RB
6056,Tom Brown,13,13,26,1989,25,MIA,9,7,13,26,2,0,2.9,5,53.8,16,13,117,9,0,13,81.3,7.3,3,62.5,26,26,143,143,0,FB
6057,Marion Butts,170,7,177,1989,23,SDG,15,5,170,683,4,9,45.5,38,41.8,12,7,21,3,0,1.4,58.3,1.8,0,16.7,177,683,704,704,0,RB
6058,Keith Byars,133,68,201,1989,26,PHI,16,15,133,452,3.4,5,28.3,27,43.6,112,68,721,10.6,0,45.1,60.7,6.4,30,43.8,201,452,1173,1206,27,RB
6059,Earnest Byner,134,54,188,1989,27,WAS,16,13,134,580,4.3,7,36.3,35,60.4,85,54,458,8.5,2,28.6,63.5,5.4,23,47.1,188,580,1038,1038,0,RB/FB
6060,Lydell Carr,0,0,0,1989,24,PHO,5,0,0,0,,0,0,0,,0,0,0,,0,0,,,0,,0,0,0,15,15,RB
6061,Paul Ott Carruth,0,1,1,1989,28,KAN,2,1,0,0,,0,0,0,,2,1,3,3,0,1.5,50,1.5,0,0,1,0,3,3,0,RB
6062,Maurice Carthon,57,15,72,1989,28,NYG,16,10,57,153,2.7,0,9.6,16,45.6,23,15,132,8.8,0,8.3,65.2,5.7,5,56.5,72,153,285,285,0,FB
6063,Rodney Carter,11,38,49,1989,25,PIT,15,0,11,16,1.5,1,1.1,2,18.2,62,38,267,7,3,17.8,61.3,4.3,18,41.9,49,24,283,283,0,RB
6064,Darryl Clack,14,4,18,1989,26,DAL,8,1,14,40,2.9,2,5,4,35.7,9,4,69,17.3,0,8.6,44.4,7.7,2,33.3,18,40,109,165,56,RB
6065,Jessie Clark,20,2,22,1989,29,"PHO,MIN",14,0,20,99,5,0,7.1,8,60,4,2,14,7,0,1,50,3.5,1,25,22,99,113,119,6,RB
6066,Roger Craig,271,49,320,1989,29,SFO,16,16,271,1054,3.9,6,65.9,54,46.1,67,49,473,9.7,1,29.6,73.1,7.1,23,61.2,320,1054,1527,1527,0,RB
6067,Ron Davenport,14,3,17,1989,27,MIA,9,3,14,56,4,1,6.2,4,42.9,6,3,19,6.3,0,2.1,50,3.2,1,33.3,17,56,75,94,19,RB
6068,John Davis,0,0,0,1989,24,BUF,16,0,0,0,,0,0,0,,0,0,0,,0,0,,,0,,0,0,0,0,0,RB
6069,Kenneth Davis,29,6,35,1989,27,BUF,16,0,29,149,5.1,1,9.3,6,44.8,8,6,92,15.3,2,5.8,75,11.5,4,62.5,35,149,241,293,52,RB
6070,Robert Delpino,78,34,112,1989,24,RAM,16,1,78,368,4.7,1,23,18,39.7,41,34,334,9.8,1,20.9,82.9,8.1,17,70.7,112,368,702,1036,334,RB
6071,Eric Dickerson,314,30,344,1989,29,IND,15,14,314,1311,4.2,7,87.4,78,51,45,30,211,7,1,14.1,66.7,4.7,10,48.9,344,1305,1522,1522,0,RB
6072,D.J. Dozier,46,14,60,1989,24,MIN,14,6,46,207,4.5,0,14.8,9,43.5,23,14,148,10.6,0,10.6,60.9,6.4,5,26.1,60,226,355,613,258,RB
6073,Robert Drummond,32,17,49,1989,22,PHI,16,1,32,127,4,0,7.9,7,43.8,28,17,180,10.6,1,11.3,60.7,6.4,9,50,49,127,307,307,0,RB
6074,Reggie Dupard,37,6,43,1989,26,"NWE,WAS",14,2,37,111,3,1,7.9,7,40.5,8,6,70,11.7,0,5,75,8.8,1,37.5,43,111,181,181,0,RB
6075,Bobby Joe Edmonds,0,0,0,1989,25,RAI,7,0,0,0,,0,0,0,,0,0,0,,0,0,,,0,,0,0,0,439,439,RB
6076,Patrick Egu,3,0,3,1989,22,NWE,7,0,3,20,6.7,1,2.9,1,33.3,0,0,0,,0,0,,,0,,3,20,20,46,26,RB
6077,Nuu Faaola,2,1,3,1989,25,"MIA,NYJ",12,1,2,10,5,0,0.8,0,0,1,1,8,8,0,0.7,100,8,0,0,3,10,18,48,30,RB
6078,Mel Farr,0,0,0,1989,23,RAM,1,0,0,0,,0,0,0,,0,0,0,,0,0,,,0,,0,0,0,0,0,RB
6079,Derrick Fenner,11,3,14,1989,22,SEA,5,1,11,41,3.7,1,8.2,2,45.5,7,3,23,7.7,0,4.6,42.9,3.3,1,42.9,14,41,64,64,0,RB
6080,Rick Fenney,151,30,181,1989,25,MIN,16,8,151,588,3.9,4,36.8,39,57,40,30,254,8.5,2,15.9,75,6.4,13,52.5,181,588,842,854,12,FB
6081,Earl Ferrell,149,18,167,1989,31,PHO,15,15,149,502,3.4,6,33.5,33,47.7,23,18,122,6.8,0,8.1,78.3,5.3,6,52.2,167,502,624,624,0,FB
6082,Terrence Flagler,33,6,39,1989,25,SFO,15,0,33,129,3.9,1,8.6,5,51.5,7,6,51,8.5,0,3.4,85.7,7.3,2,42.9,39,129,180,823,643,RB
6083,Kenny Flowers,13,0,13,1989,25,ATL,8,1,13,24,1.8,1,3,1,30.8,3,0,0,,0,0,0,0,0,0,13,24,24,24,0,RB
6084,Victor Floyd,8,1,9,1989,23,SDG,6,0,8,15,1.9,0,2.5,0,0,2,1,6,6,0,1,50,3,0,0,9,15,21,33,12,RB
6085,Herman Fontenot,17,40,57,1989,26,GNB,16,0,17,69,4.1,1,4.3,3,41.2,57,40,372,9.3,3,23.3,70.2,6.5,18,50.9,57,60,441,471,30,RB
6086,Paul Frazier,25,3,28,1989,22,NOR,15,0,25,112,4.5,1,7.5,7,44,5,3,25,8.3,0,1.7,60,5,1,20,28,112,137,294,157,RB
6087,Brent Fullwood,204,19,223,1989,26,GNB,15,15,204,821,4,5,54.7,60,54.4,26,19,214,11.3,0,14.3,73.1,8.2,8,53.8,223,821,1035,1278,243,FB
6088,Kenny Gamble,6,2,8,1989,24,KAN,2,0,6,24,4,1,12,2,50,4,2,2,1,0,1,50,0.5,0,0,8,24,26,81,55,RB
6089,Cleveland Gary,37,2,39,1989,23,RAM,10,0,37,163,4.4,1,16.3,6,54.1,4,2,13,6.5,0,1.3,50,3.3,0,25,39,163,176,180,4,RB
6090,Kerry Goode,0,0,0,1989,24,MIA,1,0,0,0,,0,0,0,,0,0,0,,0,0,,,0,,0,0,0,8,8,RB
6091,Gaston Green,26,1,27,1989,23,RAM,6,1,26,73,2.8,0,12.2,4,46.2,2,1,-5,-5,0,-0.8,50,-2.5,0,0,27,73,68,68,0,RB
6092,Mark Green,5,5,10,1989,22,CHI,10,0,5,46,9.2,1,4.6,1,40,6,5,48,9.6,0,4.8,83.3,8,2,50,10,46,94,474,380,RB
6093,Michael Haddix,44,15,59,1989,28,GNB,16,1,44,135,3.1,0,8.4,9,50,17,15,111,7.4,1,6.9,88.2,6.5,6,58.8,59,135,246,246,0,RB
6094,Lorenzo Hampton,17,8,25,1989,27,MIA,10,0,17,47,2.8,0,4.7,2,23.5,10,8,25,3.1,0,2.5,80,2.5,1,30,25,47,72,375,303,RB
6095,Kevin Harmon,1,0,1,1989,23,SEA,4,0,1,24,24,0,6,1,100,0,0,0,,0,0,,,0,,1,24,24,108,84,RB
6096,Ronnie Harmon,17,29,46,1989,25,BUF,15,2,17,99,5.8,0,6.6,7,58.8,48,29,363,12.5,4,24.2,60.4,7.6,17,54.2,46,99,462,871,409,RB
6097,Elroy Harris,8,3,11,1989,23,SEA,14,0,8,23,2.9,0,1.6,3,50,3,3,26,8.7,0,1.9,100,8.7,1,100,11,23,49,383,334,RB
6098,Herman Heard,63,25,88,1989,28,KAN,16,10,63,216,3.4,0,13.5,9,44.4,34,25,246,9.8,1,15.4,73.5,7.2,9,50,88,216,462,462,0,RB
6099,Johnny Hector,177,38,215,1989,29,NYJ,15,9,177,702,4,3,46.8,43,49.7,62,38,330,8.7,2,22,61.3,5.3,17,38.7,215,702,1032,1032,0,RB
6100,Keith Henderson,7,3,10,1989,23,SFO,6,0,7,30,4.3,1,5,1,42.9,5,3,130,43.3,0,21.7,60,26,3,60,10,30,160,181,21,RB
6101,Craig Heyward,49,13,62,1989,23,NOR,16,6,49,183,3.7,1,11.4,9,40.8,18,13,69,5.3,0,4.3,72.2,3.8,2,44.4,62,183,252,252,0,FB
6102,Mark Higgs,49,3,52,1989,23,PHI,15,1,49,184,3.8,0,12.3,6,40.8,3,3,9,3,0,0.6,100,3,1,33.3,52,184,193,486,293,RB
6103,Alonzo Highsmith,128,18,146,1989,24,HOU,16,16,128,531,4.1,4,33.2,34,50.8,21,18,201,11.2,2,12.6,85.7,9.6,11,61.9,146,531,732,732,0,FB
6104,Dalton Hilliard,344,52,396,1989,25,NOR,16,16,344,1262,3.7,13,78.9,67,46.8,63,52,514,9.9,5,32.1,82.5,8.2,20,60.3,396,1297,1776,1796,20,RB
6105,Merril Hoge,186,34,220,1989,24,PIT,16,16,186,621,3.3,8,38.8,43,48.4,52,34,271,8,0,16.9,65.4,5.2,10,30.8,220,621,892,892,0,FB
6106,John Holifield,11,2,13,1989,25,CIN,3,0,11,20,1.8,0,6.7,1,18.2,2,2,18,9,0,6,100,9,1,50,13,20,38,38,0,RB
6107,William Howard,108,30,138,1989,25,TAM,16,12,108,357,3.3,1,22.3,18,52.8,39,30,188,6.3,1,11.8,76.9,4.8,8,46.2,138,357,545,631,82,FB
6108,Bobby Humphrey,294,22,316,1989,23,DEN,16,12,294,1151,3.9,7,71.9,63,48.3,32,22,156,7.1,1,9.8,68.8,4.9,9,50,316,1168,1307,1393,86,RB
6109,Ivy Joe Hunter,13,0,13,1989,23,IND,16,1,13,47,3.6,0,2.9,4,46.2,0,0,0,,0,0,,,0,,13,47,47,105,58,RB
6110,Bo Jackson,173,9,182,1989,27,RAI,11,9,173,950,5.5,4,86.4,37,42.8,20,9,69,7.7,0,6.3,45,3.5,4,20,182,950,1019,1019,0,RB
6111,Stanford Jennings,83,10,93,1989,27,CIN,16,6,83,293,3.5,2,18.3,17,44.6,13,10,119,11.9,1,7.4,76.9,9.2,4,69.2,93,293,412,937,525,FB
6112,Daryl Johnston,67,16,83,1989,23,DAL,16,10,67,212,3.2,0,13.3,12,46.3,24,16,133,8.3,3,8.3,66.7,5.5,7,50,83,212,345,345,0,FB
6113,Tracy Johnson,4,1,5,1989,23,HOU,16,0,4,16,4,0,1,1,75,1,1,8,8,0,0.5,100,8,0,100,5,16,24,248,224,RB
6114,Undra Johnson,0,0,0,1989,23,"ATL,NOR",6,0,0,0,,0,0,0,,0,0,0,,0,0,,,0,,0,0,0,34,34,RB
6115,James Jones,0,1,1,1989,28,SEA,2,0,0,0,,0,0,0,,1,1,8,8,0,4,100,8,1,100,1,0,8,8,0,FB
6116,Keith Jones,43,15,58,1989,23,CLE,16,2,43,160,3.7,1,10,6,44.2,17,15,126,8.4,0,7.9,88.2,7.4,4,70.6,58,160,286,328,42,RB
6117,Keith Jones,52,41,93,1989,23,ATL,14,9,52,202,3.9,6,14.4,17,50,69,41,396,9.7,0,28.3,59.4,5.7,17,46.4,93,202,598,1038,440,RB
6118,Buford Jordan,38,4,42,1989,27,NOR,11,7,38,179,4.7,3,16.3,12,71.1,8,4,53,13.3,0,4.8,50,6.6,3,37.5,42,179,232,232,0,FB
6119,Tony Jordan,83,6,89,1989,24,PHO,13,8,83,211,2.5,2,16.2,11,36.1,7,6,20,3.3,0,1.5,85.7,2.9,0,42.9,89,211,231,231,0,RB
6120,Larry Kinnebrew,131,5,136,1989,30,BUF,15,10,131,533,4.1,6,35.5,36,58.8,9,5,60,12,0,4,55.6,6.7,3,44.4,136,533,593,593,0,FB
6121,Gene Lang,47,39,86,1989,27,ATL,15,7,47,176,3.7,1,11.7,11,46.8,62,39,436,11.2,1,29.1,62.9,7,15,45.2,86,176,612,612,0,RB
6122,Jamie Lawson,0,0,0,1989,24,TAM,5,0,0,0,,0,0,0,,0,0,0,,0,0,,,0,,0,0,0,0,0,RB
6123,Marc Logan,57,5,62,1989,24,MIA,10,4,57,201,3.5,0,20.1,13,49.1,9,5,34,6.8,0,3.4,55.6,3.8,2,44.4,62,201,235,847,613,RB
6124,Kevin Mack,37,2,39,1989,27,CLE,4,1,37,130,3.5,1,32.5,10,51.4,5,2,7,3.5,0,1.8,40,1.4,0,20,39,130,137,137,0,RB
6125,Tim Manoa,87,27,114,1989,25,CLE,16,15,87,289,3.3,3,18.1,24,47.1,35,27,241,8.9,2,15.1,77.1,6.9,13,51.4,114,289,530,530,0,FB
6126,Craig McEwen,0,7,7,1989,24,SDG,4,3,0,0,,0,0,0,,13,7,99,14.1,0,24.8,53.8,7.6,4,53.8,7,0,99,99,0,RB
6127,Buford McGee,21,37,58,1989,29,RAM,16,13,21,99,4.7,1,6.2,8,57.1,43,37,303,8.2,4,18.9,86,7,16,67.4,58,99,402,402,0,FB
6128,Todd McNair,23,34,57,1989,24,KAN,14,0,23,121,5.3,0,8.6,4,39.1,51,34,372,10.9,1,26.6,66.7,7.3,20,54.9,57,121,493,750,257,RB
6129,Freeman McNeil,80,31,111,1989,30,NYJ,11,7,80,352,4.4,2,32,15,58.8,47,31,310,10,1,28.2,66,6.6,15,51.1,111,352,662,662,0,RB
6130,Dave Meggett,28,34,62,1989,23,NYG,16,2,28,117,4.2,0,7.3,7,46.4,51,34,531,15.6,4,33.2,66.7,10.4,23,56.9,62,117,648,1807,1159,RB
6131,Eric Metcalf,187,54,241,1989,21,CLE,16,11,187,633,3.4,6,39.6,36,38.5,75,54,397,7.4,4,24.8,72,5.3,20,48,241,665,1030,1748,718,RB
6132,Joe Mickles,0,0,0,1989,24,WAS,9,0,0,0,,0,0,0,,0,0,0,,0,0,,,0,,0,0,0,0,0,RB
6133,Alvin Mitchell,0,1,1,1989,25,TAM,5,0,0,0,,0,0,0,,1,1,11,11,0,2.2,100,11,0,0,1,0,11,11,0,RB
6134,Stump Mitchell,43,1,44,1989,30,PHO,3,3,43,165,3.8,0,55,7,53.5,2,1,10,10,0,3.3,50,5,1,50,44,165,175,175,0,RB
6135,Jamie Morris,124,8,132,1989,24,WAS,12,3,124,336,2.7,2,28,15,37.1,14,8,65,8.1,0,5.4,57.1,4.6,4,50,132,336,401,401,0,RB
6136,Bobby Morse,2,0,2,1989,24,NOR,11,0,2,43,21.5,0,3.9,1,100,0,0,0,,0,0,,,0,,2,43,43,350,307,RB
6137,Jamie Mueller,16,1,17,1989,25,BUF,14,3,16,44,2.8,0,3.1,5,43.8,1,1,8,8,0,0.6,100,8,0,0,17,44,52,71,19,RB
6138,Vance Mueller,48,18,66,1989,25,RAI,16,2,48,161,3.4,2,10.1,7,43.8,35,18,240,13.3,2,15,51.4,6.9,11,48.6,66,161,401,521,120,RB
6139,Brad Muster,82,32,114,1989,24,CHI,16,16,82,327,4,5,20.4,24,57.3,48,32,259,8.1,3,16.2,66.7,5.4,13,52.1,114,327,586,586,0,FB
6140,Darrin Nelson,67,38,105,1989,30,"MIN,SDG",14,0,67,321,4.8,0,22.9,15,47.8,60,38,380,10,0,27.1,63.3,6.3,11,30,105,321,701,1018,317,RB
6141,Christian Okoye,370,2,372,1989,28,KAN,15,14,370,1480,4,12,98.7,77,52.4,5,2,12,6,0,0.8,40,2.4,0,40,372,1480,1492,1492,0,FB
6142,Mike Oliphant,15,3,18,1989,26,CLE,14,0,15,97,6.5,1,6.9,5,60,3,3,22,7.3,0,1.6,100,7.3,1,33.3,18,97,119,188,69,RB
6143,Tony Paige,30,2,32,1989,27,DET,16,4,30,105,3.5,0,6.6,6,43.3,5,2,27,13.5,0,1.7,40,5.4,2,40,32,105,132,132,0,RB
6144,Carl Painter,15,3,18,1989,25,DET,15,0,15,64,4.3,0,4.3,2,46.7,3,3,41,13.7,0,2.7,100,13.7,1,100,18,64,105,119,14,RB
6145,Paul Palmer,112,17,129,1989,25,"DAL,DET",14,8,112,446,4,2,31.9,19,38.4,27,17,93,5.5,0,6.6,63,3.4,3,40.7,129,446,539,794,255,RB
6146,Greg Paterra,9,5,14,1989,22,ATL,10,0,9,32,3.6,0,3.2,2,66.7,8,5,42,8.4,0,4.2,62.5,5.3,2,37.5,14,32,74,203,129,RB
6147,Bob Perryman,150,29,179,1989,25,NWE,16,14,150,562,3.7,2,35.1,37,48.7,43,29,195,6.7,0,12.2,67.4,4.5,7,46.5,179,562,757,757,0,FB
6148,Allen Pinkett,94,31,125,1989,25,HOU,16,6,94,449,4.8,1,28.1,14,41.5,37,31,239,7.7,1,14.9,83.8,6.5,11,56.8,125,449,688,688,0,RB
6149,Kerry Porter,13,0,13,1989,25,RAI,16,0,13,54,4.2,0,3.4,3,30.8,1,0,0,,0,0,0,0,0,0,13,54,54,54,0,RB
6150,James Primus,0,0,0,1989,25,ATL,5,0,0,0,,0,0,0,,0,0,0,,0,0,,,0,,0,0,0,16,16,RB
6151,Tom Rathman,79,73,152,1989,27,SFO,16,16,79,305,3.9,1,19.1,26,57,86,73,616,8.4,1,38.5,84.9,7.2,31,61.6,152,305,921,933,0,FB
6152,Willard Reaves,1,0,1,1989,30,"MIA,WAS",3,0,1,-1,-1,0,-0.3,0,0,0,0,0,,0,0,,,0,,1,-1,-1,83,84,RB
6153,Barry Redden,40,6,46,1989,29,CLE,16,1,40,180,4.5,1,11.3,8,50,12,6,34,5.7,0,2.1,50,2.8,0,16.7,46,180,214,216,2,RB
6154,Allen Rice,6,4,10,1989,27,MIN,4,0,6,25,4.2,0,6.3,2,50,5,4,29,7.3,0,7.3,80,5.8,2,60,10,15,54,67,13,RB
6155,Gerald Riggs,201,7,208,1989,29,WAS,12,7,201,834,4.1,4,69.5,40,47.8,9,7,67,9.6,0,5.6,77.8,7.4,1,77.8,208,834,901,901,0,RB
6156,Lee Rouson,11,7,18,1989,27,NYG,16,0,11,51,4.6,0,3.2,1,63.6,10,7,121,17.3,0,7.6,70,12.1,4,60,18,51,172,189,17,RB
6157,Mike Rozier,88,4,92,1989,28,HOU,12,10,88,301,3.4,2,25.1,17,46.6,7,4,28,7,0,2.3,57.1,4,1,42.9,92,301,329,329,0,RB
6158,Barry Sanders,280,24,304,1989,21,DET,15,13,280,1470,5.3,14,98,80,49.3,36,24,282,11.8,0,18.8,66.7,7.8,10,33.3,304,1470,1752,1870,118,RB
6159,Thomas Sanders,41,3,44,1989,27,CHI,16,0,41,127,3.1,0,7.9,8,41.5,6,3,28,9.3,1,1.8,50,4.7,1,50,44,127,155,646,491,RB
6160,Broderick Sargent,20,6,26,1989,27,DAL,14,5,20,87,4.4,1,6.2,4,40,13,6,50,8.3,0,3.6,46.2,3.8,1,23.1,26,87,137,137,0,FB
6161,James Saxon,58,11,69,1989,23,KAN,16,2,58,233,4,3,14.6,18,58.6,17,11,86,7.8,0,5.4,64.7,5.1,4,41.2,69,233,319,335,16,FB
6162,Kevin Scott,2,9,11,1989,26,DAL,3,1,2,-4,-2,0,-1.3,0,0,15,9,63,7,0,21,60,4.2,2,40,11,-4,59,59,0,RB
6163,John Settle,179,39,218,1989,24,ATL,15,15,179,689,3.8,3,45.9,41,43,66,39,316,8.1,2,21.1,59.1,4.8,16,36.4,218,689,1005,1005,0,FB
6164,Steve Sewell,7,25,32,1989,26,DEN,16,3,7,44,6.3,0,2.8,3,71.4,45,25,416,16.6,3,26,55.6,9.2,19,48.9,32,44,460,460,0,RB
6165,Heath Sherman,40,8,48,1989,22,PHI,15,1,40,177,4.4,2,11.8,11,50,12,8,85,10.6,0,5.7,66.7,7.1,4,41.7,48,177,262,484,222,RB
6166,Vai Sikahema,38,23,61,1989,27,PHO,16,2,38,145,3.8,0,9.1,7,36.8,42,23,245,10.7,0,15.3,54.8,5.8,11,40.5,61,145,390,1697,1307,RB
6167,Don Smith,7,7,14,1989,26,TAM,11,0,7,37,5.3,0,3.4,1,57.1,9,7,110,15.7,0,10,77.8,12.2,3,55.6,14,37,147,147,0,RB
6168,Sammie Smith,200,7,207,1989,22,MIA,13,12,200,659,3.3,6,50.7,40,45,13,7,81,11.6,0,6.2,53.8,6.2,2,38.5,207,659,740,740,0,RB
6169,Steve Smith,117,19,136,1989,25,RAI,16,16,117,471,4,1,29.4,23,55.6,26,19,140,7.4,0,8.8,73.1,5.4,9,50,136,471,611,630,19,FB
6170,Tim Spencer,134,18,152,1989,29,SDG,16,11,134,521,3.9,3,32.6,24,53.7,24,18,112,6.2,0,7,75,4.7,5,54.2,152,521,633,633,0,RB
6171,Sylvester Stamps,29,15,44,1989,28,TAM,10,1,29,141,4.9,1,14.1,5,37.9,24,15,82,5.5,0,8.2,62.5,3.4,5,37.5,44,141,223,368,145,RB
6172,John Stephens,244,21,265,1989,23,NWE,14,12,244,833,3.4,7,59.5,57,46.7,36,21,207,9.9,0,14.8,58.3,5.8,8,47.2,265,833,1040,1040,0,RB
6173,Curtis Stewart,0,0,0,1989,26,DAL,2,0,0,0,,0,0,0,,0,0,0,,0,0,,,0,,0,0,0,0,0,RB
6174,Steve Strachan,0,0,0,1989,26,RAI,16,0,0,0,,0,0,0,,1,0,0,,0,0,0,0,0,0,0,0,0,0,0,RB
6175,Troy Stradford,66,25,91,1989,25,MIA,7,4,66,240,3.6,1,34.3,14,45.5,42,25,233,9.3,0,33.3,59.5,5.5,11,54.8,91,240,473,602,129,RB
6176,Matt Suhey,20,9,29,1989,31,CHI,16,0,20,51,2.6,1,3.2,4,50,12,9,73,8.1,1,4.6,75,6.1,4,66.7,29,51,124,217,93,RB
6177,Harry Sydney,9,9,18,1989,30,SFO,7,0,9,56,6.2,0,8,3,44.4,10,9,71,7.9,0,10.1,90,7.1,4,50,18,56,127,143,16,RB
6178,Lars Tate,167,11,178,1989,23,TAM,15,14,167,589,3.5,8,39.3,39,44.9,13,11,75,6.8,1,5,84.6,5.8,3,53.8,178,589,664,664,0,RB
6179,Mosi Tatupu,11,10,21,1989,34,NWE,14,0,11,38,3.5,0,2.7,2,36.4,14,10,54,5.4,0,3.9,71.4,3.9,2,50,21,53,92,94,2,RB
6180,Junior Tautalatasi,6,17,23,1989,27,DAL,13,0,6,15,2.5,0,1.2,1,33.3,25,17,157,9.2,0,12.1,68,6.3,7,56,23,15,172,182,9,RB
6181,Brian Taylor,2,0,2,1989,22,CHI,5,0,2,7,3.5,0,1.4,0,0,0,0,0,,0,0,,,0,,2,7,7,7,0,FB
6182,Craig Taylor,30,4,34,1989,23,CIN,12,0,30,111,3.7,3,9.3,9,46.7,5,4,44,11,2,3.7,80,8.8,3,60,34,111,155,160,5,RB
6183,Thurman Thomas,298,60,358,1989,23,BUF,16,16,298,1244,4.2,6,77.8,68,47.7,81,60,669,11.2,6,41.8,74.1,8.3,31,63,358,1244,1913,1913,0,RB
6184,Lewis Tillman,79,1,80,1989,23,NYG,16,0,79,290,3.7,0,18.1,14,44.3,1,1,9,9,0,0.6,100,9,0,100,80,290,299,299,0,RB
6185,Spencer Tillman,0,0,0,1989,25,SFO,15,0,0,0,,0,0,0,,0,0,0,,0,0,,,0,,0,0,0,206,206,RB
6186,Anthony Toney,172,19,191,1989,27,PHI,14,14,172,582,3.4,3,41.6,31,37.8,24,19,124,6.5,0,8.9,79.2,5.2,7,37.5,191,582,706,703,0,FB
6187,Tim Tyrrell,1,0,1,1989,28,PIT,7,0,1,3,3,0,0.4,0,0,0,0,0,,0,0,,,0,,1,3,3,3,0,RB
6188,Roger Vick,112,34,146,1989,25,NYJ,16,10,112,434,3.9,5,27.1,26,45.5,48,34,241,7.1,2,15.1,70.8,5,10,54.2,146,434,675,675,0,FB
6189,Herschel Walker,250,40,290,1989,27,"DAL,MIN",16,14,250,915,3.7,7,57.2,52,41.6,64,40,423,10.6,2,26.4,62.5,6.6,20,46.9,290,915,1338,1712,374,RB
6190,Ray Wallace,5,0,5,1989,26,PIT,9,0,5,10,2,1,1.1,2,60,3,0,0,,0,0,0,0,0,0,5,10,10,10,0,RB
6191,Curt Warner,194,23,217,1989,28,SEA,16,15,194,631,3.3,3,39.4,39,44.3,36,23,153,6.7,1,9.6,63.9,4.3,8,41.7,217,631,784,784,0,RB
6192,Lorenzo White,104,6,110,1989,23,HOU,16,0,104,349,3.4,5,21.8,19,50,7,6,37,6.2,0,2.3,85.7,5.3,1,42.9,110,349,386,689,303,RB
6193,James Wilder,70,36,106,1989,31,TAM,15,4,70,244,3.5,0,16.3,13,42.9,42,36,335,9.3,3,22.3,85.7,8,17,57.1,106,244,579,621,42,RB
6194,Eric Wilkerson,0,0,0,1989,23,PIT,1,0,0,0,,0,0,0,,0,0,0,,0,0,,,0,,0,0,0,0,0,RB
6195,John Williams,146,76,222,1989,25,SEA,15,15,146,499,3.4,1,33.3,29,41.8,95,76,657,8.6,6,43.8,80,6.9,29,48.4,222,499,1156,1156,0,FB
6196,Warren Williams,37,6,43,1989,24,PIT,5,2,37,131,3.5,1,26.2,10,48.6,11,6,48,8,0,9.6,54.5,4.4,1,45.5,43,131,179,179,0,RB
6197,Sammy Winder,110,14,124,1989,30,DEN,16,2,110,351,3.2,2,21.9,24,50,16,14,91,6.5,0,5.7,87.5,5.7,3,43.8,124,351,442,442,0,RB
6198,Ron Wolfley,13,5,18,1989,27,PHO,16,1,13,36,2.8,1,2.3,6,53.8,5,5,38,7.6,0,2.4,100,7.6,1,40,18,36,74,74,0,RB
6199,George Wonsley,2,0,2,1989,29,NWE,5,0,2,-2,-1,0,-0.4,0,0,0,0,0,,0,0,,,0,,2,-2,-2,67,69,RB
6200,Ickey Woods,29,0,29,1989,23,CIN,2,2,29,94,3.2,2,47,8,51.7,1,0,0,,0,0,0,0,0,0,29,94,94,94,0,RB
6201,Keith Woodside,46,59,105,1989,25,GNB,16,16,46,273,5.9,1,17.1,13,47.8,87,59,527,8.9,0,32.9,67.8,6.1,21,54,105,273,800,838,38,RB
6202,Vince Workman,4,0,4,1989,21,GNB,15,0,4,8,2,1,0.5,4,100,0,0,0,,0,0,,,0,,4,8,8,555,547,RB
6203,Tim Worley,195,15,210,1989,23,PIT,15,14,195,770,3.9,5,51.3,34,46.7,20,15,113,7.5,0,7.5,75,5.7,4,50,210,770,883,883,0,RB
6204,Walter Abercrombie,5,1,6,1988,29,PHI,5,0,5,14,2.8,0,2.8,0,0,2,1,-2,-2,0,-0.4,50,-1,0,0,6,14,12,99,87,RB
6205,Curtis Adams,38,0,38,1988,26,SDG,7,1,38,149,3.9,1,21.3,12,60.5,2,0,0,,0,0,0,0,0,0,38,149,149,162,13,RB
6206,George Adams,29,27,56,1988,26,NYG,16,1,29,76,2.6,0,4.8,5,31,38,27,174,6.4,0,10.9,71.1,4.6,5,36.8,56,76,250,250,0,RB
6207,Tommie Agee,1,3,4,1988,24,SEA,16,0,1,2,2,0,0.1,0,100,5,3,31,10.3,0,1.9,60,6.2,2,60,4,2,33,33,0,RB
6208,Marcus Allen,223,34,257,1988,28,RAI,15,15,223,831,3.7,7,55.4,55,50.2,66,34,303,8.9,1,20.2,51.5,4.6,15,42.4,257,851,1134,1134,0,RB
6209,Marvin Allen,7,0,7,1988,23,NWE,11,0,7,40,5.7,0,3.6,2,57.1,0,0,0,,0,0,,,0,,7,40,40,431,391,RB
6210,Alfred Anderson,87,23,110,1988,27,MIN,16,13,87,300,3.4,7,18.8,30,54,37,23,242,10.5,1,15.1,62.2,6.5,12,48.6,110,300,542,542,0,FB
6211,Gary Anderson,225,32,257,1988,27,SDG,14,13,225,1119,5,3,79.9,54,52.9,46,32,182,5.7,0,13,69.6,4,6,39.1,257,1119,1301,1301,0,RB
6212,Neal Anderson,249,39,288,1988,24,CHI,16,16,249,1106,4.4,12,69.1,57,45,60,39,371,9.5,0,23.2,65,6.2,13,45,288,1106,1477,1477,0,RB
6213,Ottis Anderson,65,9,74,1988,31,NYG,16,0,65,208,3.2,8,13,28,61.5,15,9,57,6.3,0,3.6,60,3.8,2,46.7,74,208,265,270,0,RB
6214,Rick Badanjek,0,0,0,1988,26,ATL,6,0,0,0,,0,0,0,,1,0,0,,0,0,0,0,0,0,0,0,0,0,0,RB
6215,Tony Baker,3,0,3,1988,24,CLE,4,0,3,19,6.3,0,4.8,1,66.7,0,0,0,,0,0,,,0,,3,19,19,19,0,RB
6216,Marion Barber Jr.,0,0,0,1988,29,NYJ,16,1,0,0,,0,0,0,,2,0,0,,0,0,0,0,0,0,0,0,0,11,11,RB
6217,Greg Bell,288,24,312,1988,26,RAM,16,13,288,1212,4.2,16,75.8,76,50,29,24,124,5.2,2,7.8,82.8,4.3,7,48.3,312,1212,1336,1336,0,RB
6218,Ken Bell,9,0,9,1988,24,DEN,16,0,9,36,4,0,2.3,3,66.7,0,0,0,,0,0,,,0,,9,36,36,802,766,RB
6219,Woody Bennett,31,2,33,1988,33,MIA,16,7,31,115,3.7,0,7.2,6,54.8,4,2,16,8,0,1,50,4,1,50,33,115,131,131,0,FB
6220,Albert Bentley,45,26,71,1988,28,IND,16,2,45,230,5.1,2,14.4,15,60,46,26,252,9.7,1,15.8,56.5,5.5,13,43.5,71,230,482,1257,775,RB
6221,Reggie Branch,0,0,0,1988,26,WAS,7,0,0,0,,0,0,0,,0,0,0,,0,0,,,0,,0,0,0,0,0,RB
6222,James Brooks,182,29,211,1988,30,CIN,15,15,182,931,5.1,8,62.1,48,51.6,47,29,287,9.9,6,19.1,61.7,6.1,17,42.6,211,931,1218,1212,-6,RB
6223,Kelvin Bryant,108,42,150,1988,28,WAS,10,4,108,498,4.6,1,49.8,24,52.8,57,42,447,10.6,5,44.7,73.7,7.8,24,57.9,150,498,945,945,0,RB
6224,Keith Byars,152,72,224,1988,25,PHI,16,16,152,517,3.4,6,32.3,22,42.8,112,72,705,9.8,4,44.1,64.3,6.3,37,50,224,517,1222,1256,20,RB
6225,Earnest Byner,157,59,216,1988,26,CLE,16,16,157,576,3.7,3,36,29,39.5,82,59,576,9.8,2,36,72,7,26,64.6,216,576,1152,1152,0,RB
6226,Carl Byrum,28,2,30,1988,25,BUF,15,1,28,91,3.3,0,6.1,8,53.6,3,2,0,0,0,0,66.7,0,0,0,30,91,91,100,9,RB
6227,Paul Ott Carruth,49,24,73,1988,27,GNB,15,4,49,114,2.3,0,7.6,5,32.7,37,24,211,8.8,0,14.1,64.9,5.7,7,37.8,73,114,325,325,0,RB
6228,Maurice Carthon,46,19,65,1988,27,NYG,16,14,46,146,3.2,2,9.1,14,50,30,19,194,10.2,1,12.1,63.3,6.5,8,53.3,65,146,340,340,0,FB
6229,Rodney Carter,36,32,68,1988,24,PIT,14,1,36,216,6,3,15.4,8,55.6,55,32,363,11.3,2,25.9,58.2,6.6,21,47.3,68,272,579,579,0,RB
6230,Darryl Clack,11,17,28,1988,25,DAL,15,0,11,54,4.9,0,3.6,3,54.5,19,17,126,7.4,1,8.4,89.5,6.6,6,52.6,28,54,180,870,690,RB
6231,Jessie Clark,0,0,0,1988,28,"PHO,DET",9,0,0,0,,0,0,0,,0,0,0,,0,0,,,0,,0,0,0,10,10,RB
6232,Patrick Collins,2,2,4,1988,22,GNB,5,0,2,2,1,0,0.4,0,0,3,2,17,8.5,0,3.4,66.7,5.7,0,0,4,2,19,19,0,RB
6233,Roger Craig,310,76,386,1988,28,SFO,16,15,310,1502,4.8,9,93.9,79,53.9,111,76,534,7,1,33.4,68.5,4.8,29,42.3,386,1502,2036,2068,32,RB
6234,Joe Cribbs,5,0,5,1988,30,"IND,MIA",13,0,5,21,4.2,0,1.6,2,80,0,0,0,,0,0,,,0,,5,21,21,884,863,RB
6235,Ron Davenport,55,30,85,1988,26,MIA,16,5,55,273,5,0,17.1,15,54.5,39,30,282,9.4,0,17.6,76.9,7.2,16,64.1,85,273,555,596,41,FB
6236,Elgin Davis,0,0,0,1988,23,NWE,5,0,0,0,,0,0,0,,0,0,0,,0,0,,,0,,0,0,0,106,106,RB
6237,Kenneth Davis,39,11,50,1988,26,GNB,9,7,39,121,3.1,1,13.4,6,41,16,11,81,7.4,0,9,68.8,5.1,3,56.3,50,121,202,202,0,RB
6238,Robert Delpino,34,30,64,1988,23,RAM,15,3,34,147,4.3,0,9.8,9,58.8,40,30,312,10.4,2,20.8,75,7.8,15,60,64,147,459,792,333,RB
6239,Eric Dickerson,388,36,424,1988,28,IND,16,16,388,1659,4.3,14,103.7,106,51.3,55,36,377,10.5,1,23.6,65.5,6.9,11,38.2,424,1659,2036,2036,0,RB
6240,Tony Dorsett,181,16,197,1988,34,DEN,16,13,181,703,3.9,5,43.9,36,51.4,29,16,122,7.6,0,7.6,55.2,4.2,5,41.4,197,710,825,825,0,RB
6241,D.J. Dozier,42,5,47,1988,23,MIN,8,1,42,167,4,2,20.9,8,47.6,8,5,49,9.8,0,6.1,62.5,6.1,3,37.5,47,167,216,321,105,RB
6242,Doug DuBose,24,6,30,1988,24,SFO,14,0,24,116,4.8,2,8.3,6,66.7,6,6,57,9.5,0,4.1,100,9.5,3,83.3,30,116,173,781,608,RB
6243,Reggie Dupard,52,34,86,1988,25,NWE,16,2,52,151,2.9,2,9.4,11,34.6,47,34,232,6.8,0,14.5,72.3,4.9,12,36.2,86,151,383,383,0,RB
6244,Bobby Joe Edmonds,0,0,0,1988,24,SEA,16,0,0,0,,0,0,0,,0,0,0,,0,0,,,0,,0,0,0,1240,1240,RB
6245,Nuu Faaola,1,0,1,1988,24,NYJ,16,0,1,13,13,0,0.8,1,100,0,0,0,,0,0,,,0,,1,13,13,22,9,RB
6246,Rick Fenney,55,15,70,1988,24,MIN,13,3,55,271,4.9,3,20.8,23,63.6,22,15,224,14.9,0,17.2,68.2,10.2,8,68.2,70,271,495,495,0,RB
6247,Earl Ferrell,202,38,240,1988,30,PHO,16,16,202,924,4.6,7,57.8,56,59.4,52,38,315,8.3,2,19.7,73.1,6.1,16,55.8,240,924,1239,1270,25,FB
6248,Terrence Flagler,3,4,7,1988,24,SFO,3,0,3,5,1.7,0,1.7,0,66.7,4,4,72,18,0,24,100,18,2,75,7,5,77,77,0,RB
6249,Herman Fontenot,28,19,47,1988,25,CLE,16,1,28,87,3.1,0,5.4,3,35.7,30,19,170,8.9,1,10.6,63.3,5.7,10,53.3,47,87,257,692,435,RB
6250,Brent Fullwood,101,20,121,1988,25,GNB,14,10,101,483,4.8,7,34.5,30,61.4,25,20,128,6.4,1,9.1,80,5.1,5,48,121,483,611,1032,421,FB
6251,Kenny Gamble,0,1,1,1988,23,KAN,16,0,0,0,,0,0,0,,1,1,-7,-7,0,-0.4,100,-7,0,0,1,0,-7,286,291,RB
6252,Kerry Goode,63,7,70,1988,23,TAM,14,5,63,231,3.7,0,16.5,9,38.1,11,7,68,9.7,0,4.9,63.6,6.2,3,54.5,70,231,299,299,0,RB
6253,Mel Gray,0,0,0,1988,27,NOR,14,0,0,0,,0,0,0,,0,0,0,,0,0,,,0,,0,0,0,975,975,RB
6254,Gaston Green,35,6,41,1988,22,RAM,10,0,35,117,3.3,0,11.7,5,34.3,8,6,57,9.5,0,5.7,75,7.1,3,62.5,41,117,174,519,345,RB
6255,Keith Griffin,6,2,8,1988,27,WAS,8,0,6,23,3.8,0,2.9,0,16.7,3,2,9,4.5,1,1.1,66.7,3,1,33.3,8,23,32,77,45,RB
6256,Mike Guman,1,0,1,1988,30,RAM,1,0,1,1,1,0,1,0,0,0,0,0,,0,0,,,0,,1,1,1,1,0,RB
6257,Michael Haddix,57,12,69,1988,27,PHI,16,3,57,185,3.2,0,11.6,11,40.4,20,12,82,6.8,0,5.1,60,4.1,5,40,69,185,267,267,0,RB
6258,Lorenzo Hampton,117,23,140,1988,26,MIA,16,10,117,414,3.5,9,25.9,28,53.8,33,23,204,8.9,3,12.8,69.7,6.2,8,48.5,140,414,618,834,216,RB
6259,Kevin Harmon,2,0,2,1988,22,SEA,5,0,2,13,6.5,0,2.6,1,100,0,0,0,,0,0,,,0,,2,13,13,75,62,RB
6260,Ronnie Harmon,57,37,94,1988,24,BUF,16,1,57,212,3.7,1,13.3,8,42.1,63,37,427,11.5,3,26.7,58.7,6.8,22,49.2,94,212,639,888,249,RB
6261,Darryl Harris,34,6,40,1988,22,MIN,14,0,34,151,4.4,1,10.8,7,44.1,6,6,30,5,0,2.1,100,5,0,33.3,40,151,181,1010,833,RB
6262,Herman Heard,106,20,126,1988,27,KAN,12,5,106,438,4.1,0,36.5,20,44.3,33,20,198,9.9,0,16.5,60.6,6,8,48.5,126,438,636,636,0,RB
6263,Johnny Hector,137,26,163,1988,28,NYJ,16,1,137,561,4.1,10,35.1,49,57.7,46,26,237,9.1,0,14.8,56.5,5.2,13,39.1,163,561,798,798,0,RB
6264,Craig Heyward,74,13,87,1988,22,NOR,11,8,74,355,4.8,1,32.3,16,41.9,21,13,105,8.1,0,9.5,61.9,5,6,52.4,87,355,460,460,0,FB
6265,Mark Higgs,0,0,0,1988,22,DAL,5,0,0,0,,0,0,0,,0,0,0,,0,0,,,0,,0,0,0,31,31,RB
6266,Alonzo Highsmith,94,12,106,1988,23,HOU,16,16,94,466,5,2,29.1,26,50,17,12,131,10.9,0,8.2,70.6,7.7,4,58.8,106,466,597,597,0,FB
6267,Dalton Hilliard,204,34,238,1988,24,NOR,16,8,204,823,4,5,51.4,52,48.5,47,34,335,9.9,1,20.9,72.3,7.1,16,55.3,238,850,1158,1269,111,RB
6268,Merril Hoge,170,50,220,1988,23,PIT,16,8,170,705,4.1,3,44.1,43,54.1,69,50,487,9.7,3,30.4,72.5,7.1,26,46.4,220,705,1192,1192,0,FB
6269,Bobby Howard,0,0,0,1988,24,TAM,1,0,0,0,,0,0,0,,0,0,0,,0,0,,,0,,0,0,0,0,0,RB
6270,William Howard,115,11,126,1988,24,TAM,15,9,115,452,3.9,1,30.1,24,51.3,19,11,97,8.8,0,6.5,57.9,5.1,5,47.4,126,452,549,570,21,FB
6271,Bo Jackson,136,9,145,1988,26,RAI,10,9,136,580,4.3,3,58,28,46.3,20,9,79,8.8,0,7.9,45,4,5,35,145,580,659,659,0,FB
6272,Earnest Jackson,74,9,83,1988,29,PIT,12,6,74,315,4.3,3,26.3,14,50,11,9,84,9.3,0,7,81.8,7.6,3,72.7,83,315,399,399,0,FB
6273,Craig James,4,14,18,1988,27,NWE,6,0,4,15,3.8,1,2.5,1,50,24,14,171,12.2,0,28.5,58.3,7.1,7,37.5,18,15,186,186,0,RB
6274,Garry James,182,39,221,1988,25,DET,16,16,182,552,3,5,34.5,33,38.5,69,39,382,9.8,2,23.9,56.5,5.5,19,39.1,221,552,934,934,0,RB
6275,Lionel James,23,36,59,1988,26,SDG,16,1,23,105,4.6,0,6.6,3,26.1,51,36,279,7.8,1,17.4,70.6,5.5,14,45.1,59,97,384,662,278,RB
6276,Tony Jeffery,3,0,3,1988,24,PHO,3,0,3,8,2.7,0,2.7,0,0,0,0,0,,0,0,,,0,,3,8,8,19,11,RB
6277,Keyvan Jenkins,0,0,0,1988,27,KAN,2,0,0,0,,0,0,0,,0,0,0,,0,0,,,0,,0,0,0,12,12,RB
6278,Stanford Jennings,17,5,22,1988,26,CIN,16,1,17,47,2.8,1,2.9,4,41.2,7,5,75,15,0,4.7,71.4,10.7,4,71.4,22,47,122,806,684,RB
6279,Jim Jensen,10,58,68,1988,30,MIA,16,4,10,68,6.8,0,4.3,8,80,75,58,652,11.2,5,40.8,77.3,8.7,36,66.7,68,68,720,720,0,RB
6280,James Jones,96,29,125,1988,27,DET,14,14,96,314,3.3,0,22.4,11,40.6,41,29,259,8.9,0,18.5,70.7,6.3,11,39,125,314,573,573,0,FB
6281,Buford Jordan,19,5,24,1988,26,NOR,14,4,19,115,6.1,0,8.2,5,68.4,7,5,70,14,0,5,71.4,10,4,57.1,24,115,185,192,0,RB
6282,Tony Jordan,61,4,65,1988,23,PHO,9,2,61,160,2.6,3,17.8,15,42.6,5,4,24,6,0,2.7,80,4.8,1,60,65,160,184,184,0,RB
6283,Mark Konecny,0,1,1,1988,25,PHI,16,0,0,0,,0,0,0,,1,1,18,18,0,1.1,100,18,0,0,1,0,18,527,509,RB
6284,Gene Lang,53,37,90,1988,26,ATL,16,3,53,191,3.6,0,11.9,7,45.3,46,37,398,10.8,1,24.9,80.4,8.7,19,54.3,90,191,589,601,12,RB
6285,Marc Logan,2,2,4,1988,23,CIN,9,0,2,10,5,0,1.1,0,50,2,2,20,10,0,2.2,100,10,1,50,4,10,30,110,80,RB
6286,Kevin Mack,123,11,134,1988,26,CLE,11,11,123,485,3.9,3,44.1,33,52.8,16,11,87,7.9,0,7.9,68.8,5.4,2,37.5,134,485,572,572,0,FB
6287,Tim Manoa,99,10,109,1988,24,CLE,16,4,99,389,3.9,2,24.3,22,50.5,16,10,54,5.4,0,3.4,62.5,3.4,1,50,109,389,443,443,0,RB
6288,Larry Mason,48,8,56,1988,27,GNB,15,2,48,194,4,0,12.9,8,47.9,14,8,84,10.5,1,5.6,57.1,6,5,42.9,56,194,278,278,0,RB
6289,Rueben Mayes,170,11,181,1988,25,NOR,16,9,170,628,3.7,3,39.3,25,41.8,14,11,103,9.4,0,6.4,78.6,7.4,4,50,181,628,731,863,132,RB
6290,Derrick McAdoo,0,0,0,1988,23,"PHO,TAM",9,0,0,0,,0,0,0,,0,0,0,,0,0,,,0,,0,0,0,311,311,RB
6291,Craig McEwen,0,23,23,1988,23,WAS,14,8,0,0,,0,0,0,,38,23,323,14,0,23.1,60.5,8.5,14,55.3,23,0,323,323,0,RB
6292,Buford McGee,22,16,38,1988,28,RAM,16,10,22,69,3.1,0,4.3,2,50,25,16,117,7.3,3,7.3,64,4.7,10,60,38,69,186,186,0,FB
6293,Chris McLemore,0,0,0,1988,25,RAI,7,0,0,0,,0,0,0,,0,0,0,,0,0,,,0,,0,0,0,0,0,RB
6294,Freeman McNeil,219,34,253,1988,29,NYJ,16,16,219,944,4.3,6,59,37,50.7,52,34,288,8.5,1,18,65.4,5.5,14,48.1,253,944,1232,1232,0,RB
6295,Stump Mitchell,164,25,189,1988,29,PHO,14,14,164,726,4.4,4,51.9,36,47.6,28,25,214,8.6,1,15.3,89.3,7.6,10,64.3,189,726,940,1158,221,RB
6296,Ricky Moore,0,1,1,1988,25,PHO,8,0,0,0,,0,0,0,,1,1,15,15,0,1.9,100,15,1,100,1,0,15,15,0,RB
6297,Larry Moriarty,20,6,26,1988,30,KAN,9,3,20,62,3.1,0,6.9,6,75,6,6,40,6.7,0,4.4,100,6.7,3,66.7,26,62,102,102,0,RB
6298,Jamie Morris,126,1,127,1988,23,WAS,16,4,126,437,3.5,2,27.3,26,46,2,1,3,3,0,0.2,50,1.5,0,0,127,437,440,853,413,RB
6299,Joe Morris,307,22,329,1988,28,NYG,16,15,307,1083,3.5,5,67.7,63,46.9,38,22,166,7.5,0,10.4,57.9,4.4,4,47.4,329,1083,1249,1249,0,RB
6300,Randall Morris,3,0,3,1988,27,"DET,SEA",12,0,3,6,2,0,0.5,0,0,0,0,0,,0,0,,,0,,3,6,6,265,259,RB
6301,Jamie Mueller,81,8,89,1988,24,BUF,15,15,81,296,3.7,0,19.7,17,39.5,9,8,42,5.3,0,2.8,88.9,4.7,1,44.4,89,296,338,338,0,FB
6302,Vance Mueller,17,5,22,1988,24,RAI,14,1,17,60,3.5,0,4.3,2,47.1,10,5,63,12.6,0,4.5,50,6.3,2,50,22,60,123,220,97,RB
6303,Brad Muster,44,21,65,1988,23,CHI,16,0,44,197,4.5,0,12.3,9,50,32,21,236,11.2,1,14.8,65.6,7.4,10,43.8,65,197,433,466,33,RB
6304,Darrin Nelson,112,16,128,1988,29,MIN,13,11,112,380,3.4,1,29.2,15,45.5,24,16,105,6.6,0,8.1,66.7,4.4,3,33.3,128,380,485,695,210,RB
6305,Timmy Newsome,32,30,62,1988,30,DAL,9,8,32,75,2.3,3,8.3,9,46.9,43,30,236,7.9,0,26.2,69.8,5.5,11,51.2,62,75,311,311,0,FB
6306,Christian Okoye,105,8,113,1988,27,KAN,9,9,105,473,4.5,3,52.6,23,58.1,13,8,51,6.4,0,5.7,61.5,3.9,1,53.8,113,473,524,524,0,FB
6307,Mike Oliphant,8,15,23,1988,25,WAS,8,0,8,30,3.8,0,3.8,1,25,25,15,111,7.4,0,13.9,60,4.4,5,36,23,30,141,292,151,RB
6308,Tony Paige,52,11,63,1988,26,DET,16,2,52,207,4,0,12.9,11,55.8,15,11,100,9.1,0,6.3,73.3,6.7,5,60,63,207,307,307,0,RB
6309,Carl Painter,17,1,18,1988,24,DET,12,0,17,42,2.5,0,3.5,1,23.5,5,1,1,1,0,0.1,20,0.2,0,0,18,42,43,390,347,RB
6310,Paul Palmer,134,53,187,1988,24,KAN,15,11,134,452,3.4,2,30.1,24,41.8,72,53,611,11.5,4,40.7,73.6,8.5,21,45.8,187,452,1063,1427,364,RB
6311,Bob Perryman,146,17,163,1988,24,NWE,16,16,146,448,3.1,6,28,30,44.5,21,17,134,7.9,0,8.4,81,6.4,6,71.4,163,448,582,582,0,FB
6312,Allen Pinkett,122,12,134,1988,24,HOU,16,2,122,513,4.2,7,32.1,30,53.3,16,12,114,9.5,2,7.1,75,7.1,5,31.3,134,513,627,764,137,RB
6313,Frank Pollard,31,2,33,1988,31,PIT,10,3,31,93,3,0,9.3,6,41.9,4,2,22,11,0,2.2,50,5.5,0,25,33,93,115,115,0,RB
6314,James Primus,35,8,43,1988,24,ATL,16,6,35,95,2.7,1,5.9,4,22.9,18,8,42,5.3,0,2.6,44.4,2.3,1,27.8,43,95,137,150,13,RB
6315,Tom Rathman,102,42,144,1988,26,SFO,16,16,102,427,4.2,2,26.7,28,52,53,42,382,9.1,0,23.9,79.2,7.2,16,64.2,144,427,809,809,0,FB
6316,Barry Redden,19,1,20,1988,28,SDG,8,2,19,30,1.6,3,3.8,10,57.9,2,1,11,11,0,1.4,50,5.5,1,50,20,30,41,41,0,RB
6317,Allen Rice,110,30,140,1988,26,MIN,16,4,110,322,2.9,6,20.1,19,33.6,44,30,279,9.3,0,17.4,68.2,6.3,10,36.4,140,322,601,601,0,RB
6318,Robb Riddick,111,30,141,1988,31,BUF,15,0,111,438,3.9,12,29.2,53,67.6,38,30,282,9.4,1,18.8,78.9,7.4,15,57.9,141,469,720,820,100,RB
6319,Gerald Riggs,113,22,135,1988,28,ATL,9,9,113,488,4.3,1,54.2,33,48.7,33,22,171,7.8,0,19,66.7,5.2,5,57.6,135,488,659,659,0,RB
6320,Del Rodgers,0,0,0,1988,28,SFO,1,0,0,0,,0,0,0,,0,0,0,,0,0,,,0,,0,0,0,98,98,RB
6321,Lee Rouson,1,4,5,1988,26,NYG,16,0,1,1,1,0,0.1,1,100,5,4,61,15.3,0,3.8,80,12.2,2,80,5,1,62,192,130,RB
6322,Mike Rozier,251,11,262,1988,27,HOU,15,14,251,1002,4,10,66.8,62,50.6,17,11,99,9,1,6.6,64.7,5.8,6,52.9,262,1002,1101,1101,0,RB
6323,Thomas Sanders,95,9,104,1988,26,CHI,16,0,95,332,3.5,3,20.8,22,38.9,16,9,94,10.4,0,5.9,56.3,5.9,2,18.8,104,332,426,674,248,RB
6324,James Saxon,60,19,79,1988,22,KAN,16,4,60,236,3.9,2,14.8,21,60,30,19,177,9.3,0,11.1,63.3,5.9,8,43.3,79,236,413,453,40,FB
6325,Kevin Scott,0,0,0,1988,25,SDG,1,0,0,0,,0,0,0,,0,0,0,,0,0,,,0,,0,0,0,0,0,RB
6326,John Settle,232,68,300,1988,23,ATL,16,13,232,1024,4.4,7,64,49,48.7,103,68,570,8.4,1,35.6,66,5.5,31,49.5,300,1024,1594,1594,0,FB
6327,Steve Sewell,32,38,70,1988,25,DEN,16,3,32,135,4.2,1,8.4,7,34.4,65,38,507,13.3,5,31.7,58.5,7.8,26,50.8,70,135,642,646,0,RB
6328,Vai Sikahema,0,0,0,1988,26,PHO,12,0,0,0,,0,0,0,,0,0,0,,0,0,,,0,,0,0,0,816,816,RB
6329,Don Smith,13,12,25,1988,25,TAM,10,3,13,46,3.5,1,4.6,2,46.2,23,12,138,11.5,0,13.8,52.2,6,9,43.5,25,46,184,372,188,RB
6330,Jeff Smith,20,16,36,1988,26,TAM,16,3,20,87,4.4,0,5.4,3,30,24,16,134,8.4,0,8.4,66.7,5.6,7,41.7,36,87,221,446,225,RB
6331,Steve Smith,38,26,64,1988,24,RAI,16,6,38,162,4.3,3,10.1,13,63.2,34,26,299,11.5,6,18.7,76.5,8.8,11,47.1,64,162,461,507,46,FB
6332,Timmy Smith,155,8,163,1988,24,WAS,14,8,155,470,3,3,33.6,31,40.6,13,8,53,6.6,0,3.8,61.5,4.1,3,46.2,163,470,523,523,0,FB
6333,Tim Spencer,44,1,45,1988,28,SDG,16,1,44,215,4.9,0,13.4,7,52.3,4,1,14,14,0,0.9,25,3.5,1,25,45,215,229,245,16,RB
6334,Sylvester Stamps,3,5,8,1988,27,ATL,4,1,3,0,0,0,0,0,0,8,5,22,4.4,0,5.5,62.5,2.8,0,0,8,0,22,241,219,RB
6335,John Stephens,297,14,311,1988,22,NWE,16,14,297,1168,3.9,4,73,62,50.2,18,14,98,7,0,6.1,77.8,5.4,5,61.1,311,1168,1266,1270,0,RB
6336,Dwight Stone,40,11,51,1988,24,PIT,16,6,40,127,3.2,0,7.9,4,47.5,24,11,196,17.8,1,12.3,45.8,8.2,5,37.5,51,127,323,933,610,RB
6337,Steve Strachan,4,3,7,1988,25,RAI,16,0,4,12,3,0,0.8,1,50,3,3,19,6.3,1,1.2,100,6.3,1,66.7,7,12,31,31,0,RB
6338,Troy Stradford,95,56,151,1988,24,MIA,15,6,95,335,3.5,2,22.3,17,47.4,78,56,426,7.6,1,28.4,71.8,5.5,16,50,151,335,761,761,0,RB
6339,Matt Suhey,87,20,107,1988,30,CHI,16,16,87,253,2.9,2,15.8,19,47.1,26,20,154,7.7,0,9.6,76.9,5.9,8,46.2,107,253,407,407,0,FB
6340,Harry Sydney,9,2,11,1988,29,SFO,16,0,9,50,5.6,0,3.1,3,66.7,2,2,18,9,0,1.1,100,9,1,100,11,50,68,76,8,RB
6341,Lars Tate,122,5,127,1988,22,TAM,15,5,122,467,3.8,7,31.1,28,41.8,10,5,23,4.6,1,1.5,50,2.3,1,30,127,467,490,490,0,RB
6342,Mosi Tatupu,22,8,30,1988,33,NWE,16,0,22,75,3.4,2,4.7,8,45.5,10,8,58,7.3,0,3.6,80,5.8,3,70,30,75,133,146,13,RB
6343,Junior Tautalatasi,14,5,19,1988,26,PHI,10,0,14,28,2,0,2.8,1,28.6,6,5,48,9.6,0,4.8,83.3,8,4,83.3,19,28,76,76,0,RB
6344,Calvin Thomas,6,0,6,1988,28,"CHI,DEN",3,0,6,20,3.3,0,6.7,1,33.3,0,0,0,,0,0,,,0,,6,20,20,20,0,RB
6345,Lavale Thomas,0,0,0,1988,25,GNB,1,0,0,0,,0,0,0,,0,0,0,,0,0,,,0,,0,0,0,0,0,RB
6346,Thurman Thomas,207,18,225,1988,22,BUF,15,15,207,881,4.3,2,58.7,40,48.3,27,18,208,11.6,0,13.9,66.7,7.7,8,55.6,225,881,1089,1089,0,RB
6347,Spencer Tillman,3,0,3,1988,24,HOU,16,0,3,5,1.7,0,0.3,0,0,0,0,0,,0,0,,,0,,3,5,5,18,13,RB
6348,Anthony Toney,139,34,173,1988,26,PHI,15,13,139,502,3.6,4,33.5,25,46.8,46,34,256,7.5,1,17.1,73.9,5.6,10,50,173,502,758,758,0,FB
6349,Tim Tyrrell,0,0,0,1988,27,RAM,12,0,0,0,,0,0,0,,0,0,0,,0,0,,,0,,0,0,0,0,0,RB
6350,Roger Vick,128,19,147,1988,24,NYJ,16,12,128,540,4.2,3,33.8,26,60.2,26,19,120,6.3,0,7.5,73.1,4.6,5,50,147,540,660,660,0,FB
6351,Herschel Walker,361,53,414,1988,26,DAL,16,16,361,1514,4.2,5,94.6,77,47.4,83,53,505,9.5,2,31.6,63.9,6.1,17,39.8,414,1514,2019,2019,0,RB
6352,Curt Warner,266,22,288,1988,27,SEA,16,16,266,1025,3.9,10,64.1,62,47.7,40,22,154,7,2,9.6,55,3.9,7,32.5,288,1025,1179,1169,0,RB
6353,Charles White,88,6,94,1988,30,RAM,12,3,88,323,3.7,0,26.9,13,53.4,7,6,36,6,0,3,85.7,5.1,1,42.9,94,323,359,396,37,RB
6354,Lorenzo White,31,0,31,1988,22,HOU,11,0,31,115,3.7,0,10.5,5,45.2,0,0,0,,0,0,,,0,,31,115,115,311,196,RB
6355,James Wilder,86,15,101,1988,30,TAM,7,7,86,343,4,1,49,17,50,18,15,124,8.3,0,17.7,83.3,6.9,4,50,101,343,467,467,0,FB
6356,Gerald Willhite,13,32,45,1988,29,DEN,11,1,13,39,3,2,3.5,5,53.8,40,32,238,7.4,0,21.6,80,6,9,50,45,39,277,367,90,RB
6357,John Williams,189,58,247,1988,24,SEA,16,16,189,877,4.6,4,54.8,53,57.1,83,58,651,11.2,3,40.7,69.9,7.8,26,49.4,247,877,1528,1526,0,FB
6358,Scott Williams,9,3,12,1988,26,DET,11,0,9,22,2.4,1,2,1,33.3,4,3,46,15.3,0,4.2,75,11.5,1,50,12,22,68,68,0,RB
6359,Warren Williams,87,11,98,1988,23,PIT,15,8,87,409,4.7,0,27.3,15,43.7,21,11,66,6,1,4.4,52.4,3.1,4,28.6,98,409,475,485,10,RB
6360,Stanley Wilson,112,9,121,1988,27,CIN,15,6,112,398,3.6,2,26.5,20,50.9,13,9,110,12.2,1,7.3,69.2,8.5,5,61.5,121,398,508,508,0,FB
6361,Sammy Winder,149,17,166,1988,29,DEN,16,12,149,543,3.6,4,33.9,30,52.3,31,17,103,6.1,1,6.4,54.8,3.3,5,41.9,166,543,646,657,11,FB
6362,Ron Wolfley,9,2,11,1988,26,PHO,16,0,9,43,4.8,0,2.7,5,77.8,4,2,11,5.5,0,0.7,50,2.8,1,50,11,43,54,54,0,RB
6363,George Wonsley,26,0,26,1988,28,IND,16,0,26,48,1.8,1,3,5,30.8,0,0,0,,0,0,,,0,,26,48,48,48,0,RB
6364,Ickey Woods,203,21,224,1988,22,CIN,16,10,203,1066,5.3,15,66.6,73,60.6,23,21,199,9.5,0,12.4,91.3,8.7,10,69.6,224,1066,1265,1265,0,FB
6365,Keith Woodside,83,39,122,1988,24,GNB,16,9,83,195,2.3,3,12.2,10,32.5,61,39,352,9,2,22,63.9,5.8,14,52.5,122,195,547,890,343,RB
6366,Butch Woolfolk,1,0,1,1988,28,DET,3,0,1,4,4,0,1.3,0,0,1,0,0,,0,0,0,0,0,0,1,4,4,103,99,RB
6367,Barry Word,0,0,0,1988,25,NOR,2,0,0,0,,0,0,0,,0,0,0,,0,0,,,0,,0,0,0,0,0,RB
6368,Walter Abercrombie,123,24,147,1987,28,PIT,12,12,123,459,3.7,2,38.3,25,43.1,39,24,209,8.7,0,17.4,61.5,5.4,8,43.6,147,459,668,670,0,RB
6369,Curtis Adams,90,4,94,1987,25,SDG,12,4,90,343,3.8,1,28.6,15,48.9,6,4,38,9.5,0,3.2,66.7,6.3,1,66.7,94,343,381,413,32,RB
6370,David Adams,7,1,8,1987,23,DAL,3,0,7,49,7,1,16.3,2,71.4,2,1,8,8,0,2.7,50,4,0,50,8,49,57,170,113,RB
6371,George Adams,61,35,96,1987,25,NYG,12,7,61,169,2.8,1,14.1,10,39.3,46,35,298,8.5,1,24.8,76.1,6.5,10,52.2,96,169,467,633,166,FB
6372,Vincent Alexander,21,2,23,1987,23,NOR,1,0,21,71,3.4,1,71,6,47.6,3,2,15,7.5,0,15,66.7,5,1,33.3,23,71,86,86,0,RB
6373,Marcus Allen,200,51,251,1987,27,RAI,12,12,200,754,3.8,5,62.8,38,46.5,63,51,410,8,0,34.2,81,6.5,20,58.7,251,774,1164,1164,0,RB
6374,Alfred Anderson,68,7,75,1987,26,MIN,10,10,68,319,4.7,2,31.9,20,58.8,16,7,69,9.9,0,6.9,43.8,4.3,2,31.3,75,319,388,388,0,FB
6375,Gary Anderson,80,47,127,1987,26,SDG,12,7,80,260,3.3,3,21.7,14,42.5,77,47,503,10.7,2,41.9,61,6.5,23,41.6,127,260,763,1196,433,RB
6376,Neal Anderson,129,47,176,1987,23,CHI,11,10,129,586,4.5,3,53.3,26,45,72,47,467,9.9,3,42.5,65.3,6.5,17,52.8,176,586,1053,1053,0,FB
6377,Ottis Anderson,2,2,4,1987,30,NYG,4,0,2,6,3,0,1.5,0,0,3,2,16,8,0,4,66.7,5.3,0,0,4,6,22,22,0,RB
6378,Cliff Austin,19,5,24,1987,27,TAM,3,2,19,32,1.7,1,10.7,2,42.1,7,5,51,10.2,0,17,71.4,7.3,3,71.4,24,32,83,83,0,RB
6379,Rick Badanjek,29,6,35,1987,25,ATL,2,2,29,87,3,1,43.5,6,48.3,7,6,35,5.8,0,17.5,85.7,5,2,57.1,35,87,122,149,27,RB
6380,Clarence Bailey,10,0,10,1987,24,MIA,3,1,10,55,5.5,0,18.3,3,90,0,0,0,,0,0,,,0,,10,55,55,55,0,RB
6381,Chuck Banks,50,9,59,1987,23,IND,3,1,50,245,4.9,0,81.7,10,48,12,9,50,5.6,0,16.7,75,4.2,1,8.3,59,245,295,295,0,RB
6382,Marion Barber Jr.,0,0,0,1987,28,NYJ,12,0,0,0,,0,0,0,,0,0,0,,0,0,,,0,,0,0,0,5,5,RB
6383,Steve Bartalo,9,1,10,1987,23,TAM,9,0,9,30,3.3,1,3.3,1,33.3,3,1,5,5,0,0.6,33.3,1.7,0,33.3,10,30,35,50,15,RB
6384,Earl Beecham,5,0,5,1987,22,NYG,1,0,5,22,4.4,0,22,2,40,0,0,0,,0,0,,,0,,5,22,22,92,70,RB
6385,Greg Bell,22,9,31,1987,25,"BUF,RAM",4,3,22,86,3.9,0,21.5,4,45.5,14,9,96,10.7,1,24,64.3,6.9,4,42.9,31,86,182,182,0,RB
6386,Ken Bell,13,1,14,1987,23,DEN,12,1,13,43,3.3,0,3.6,1,30.8,1,1,8,8,0,0.7,100,8,0,0,14,43,51,374,323,RB
6387,Woody Bennett,25,4,29,1987,32,MIA,12,11,25,102,4.1,0,8.5,6,60,7,4,18,4.5,0,1.5,57.1,2.6,1,28.6,29,102,120,120,0,FB
6388,Albert Bentley,142,34,176,1987,27,IND,12,4,142,631,4.4,7,52.6,43,58.5,47,34,447,13.1,2,37.3,72.3,9.5,17,55.3,176,631,1078,1578,500,RB
6389,Karl Bernard,45,13,58,1987,23,DET,8,3,45,187,4.2,2,23.4,11,62.2,22,13,91,7,0,11.4,59.1,4.1,7,54.5,58,187,278,332,54,RB
6390,Dwight Beverly,62,1,63,1987,26,NOR,3,3,62,217,3.5,2,72.3,11,45.2,2,1,8,8,0,2.7,50,4,0,0,63,217,225,271,46,RB
6391,Frank Bianchini,0,0,0,1987,26,NWE,1,0,0,0,,0,0,0,,0,0,0,,0,0,,,0,,0,0,0,0,0,RB
6392,Dennis Bligen,31,11,42,1987,25,NYJ,6,2,31,128,4.1,1,21.3,9,54.8,17,11,81,7.4,0,13.5,64.7,4.8,4,35.3,42,128,209,209,0,RB
6393,Alvin Blount,46,1,47,1987,22,DAL,2,2,46,125,2.7,3,62.5,9,45.7,2,1,5,5,0,2.5,50,2.5,0,0,47,125,130,130,0,RB
6394,Tony Boddie,3,9,12,1987,27,DEN,5,0,3,7,2.3,1,1.4,2,100,9,9,85,9.4,0,17,100,9.4,6,77.8,12,7,92,92,0,RB
6395,Greg Boone,1,0,1,1987,25,TAM,2,0,1,2,2,0,1,0,0,0,0,0,,0,0,,,0,,1,2,2,2,0,RB
6396,Danny Bradley,0,7,7,1987,24,DET,3,1,0,0,,0,0,0,,15,7,50,7.1,2,16.7,46.7,3.3,4,46.7,7,0,50,291,241,RB
6397,Reggie Branch,4,0,4,1987,25,WAS,12,0,4,9,2.3,1,0.8,4,100,0,0,0,,0,0,,,0,,4,9,9,70,61,RB
6398,Chris Brewer,24,5,29,1987,25,CHI,3,1,24,55,2.3,2,18.3,4,33.3,8,5,56,11.2,1,18.7,62.5,7,4,62.5,29,55,111,111,0,RB
6399,James Brooks,94,22,116,1987,29,CIN,9,7,94,290,3.1,1,32.2,12,41.5,37,22,272,12.4,2,30.2,59.5,7.4,11,37.8,116,290,562,604,42,RB
6400,Gordon Brown,19,0,19,1987,24,IND,3,0,19,85,4.5,1,28.3,2,52.6,0,0,0,,0,0,,,0,,19,85,85,85,0,RB
6401,Jim Browne,2,2,4,1987,25,RAI,2,1,2,1,0.5,0,0.5,0,0,2,2,8,4,0,4,100,4,0,0,4,1,9,9,0,RB
6402,Reggie Brown,39,8,47,1987,27,PHI,3,3,39,136,3.5,0,45.3,5,38.5,11,8,53,6.6,0,17.7,72.7,4.8,3,54.5,47,136,189,209,20,RB
6403,Tom Brown,3,1,4,1987,23,MIA,1,0,3,3,1,0,3,1,66.7,1,1,6,6,0,6,100,6,1,100,4,3,9,9,0,RB
6404,Cullen Bryant,1,0,1,1987,36,RAM,3,0,1,2,2,0,0.7,1,100,0,0,0,,0,0,,,0,,1,2,2,2,0,RB
6405,Kelvin Bryant,77,43,120,1987,27,WAS,11,1,77,406,5.3,1,36.9,18,46.8,71,43,490,11.4,5,44.5,60.6,6.9,22,47.9,120,406,896,896,0,RB
6406,Joe Burke,0,0,0,1987,26,NYJ,2,0,0,0,,0,0,0,,0,0,0,,0,0,,,0,,0,0,0,0,0,RB
6407,Tony Burse,7,0,7,1987,22,SEA,12,0,7,36,5.1,0,3,2,57.1,0,0,0,,0,0,,,0,,7,36,36,37,1,RB
6408,Jerry Butler,1,2,3,1987,26,ATL,1,0,1,1,1,0,1,0,0,3,2,7,3.5,0,7,66.7,2.3,0,0,3,1,8,31,23,RB
6409,Keith Byars,116,21,137,1987,24,PHI,10,8,116,426,3.7,3,42.6,17,42.2,27,21,177,8.4,1,17.7,77.8,6.6,8,55.6,137,426,603,603,0,RB
6410,Earnest Byner,105,52,157,1987,25,CLE,12,12,105,432,4.1,8,36,36,57.1,68,52,552,10.6,2,46,76.5,8.1,25,66.2,157,432,984,986,2,RB
6411,Carl Byrum,66,3,69,1987,24,BUF,13,8,66,280,4.2,0,21.5,15,51.5,7,3,23,7.7,0,1.8,42.9,3.3,1,28.6,69,280,303,303,0,FB
6412,Scott Caldwell,16,4,20,1987,24,DEN,3,1,16,53,3.3,0,17.7,3,37.5,7,4,34,8.5,0,11.3,57.1,4.9,0,14.3,20,53,87,87,0,RB
6413,Rick Calhoun,7,1,8,1987,24,RAI,3,0,7,36,5.1,0,12,1,28.6,1,1,17,17,0,5.7,100,17,0,0,8,36,53,362,309,RB
6414,Paul Ott Carruth,64,10,74,1987,26,GNB,12,5,64,192,3,3,16,17,48.4,21,10,78,7.8,1,6.5,47.6,3.7,3,38.1,74,195,270,278,8,RB
6415,Maurice Carthon,26,8,34,1987,26,NYG,11,5,26,60,2.3,0,5.5,7,42.3,12,8,71,8.9,0,6.5,66.7,5.9,4,50,34,60,131,131,0,FB
6416,Rodney Carter,5,16,21,1987,23,PIT,11,2,5,12,2.4,0,1.1,0,40,26,16,180,11.3,3,16.4,61.5,6.9,12,53.8,21,12,192,192,0,RB
6417,Mel Carver,2,0,2,1987,28,IND,1,0,2,3,1.5,0,3,1,50,0,0,0,,0,0,,,0,,2,3,3,3,0,RB
6418,Tony Cherry,13,0,13,1987,24,SFO,1,1,13,65,5,1,65,5,61.5,0,0,0,,0,0,,,0,,13,65,65,65,0,RB
6419,Joe Chetti,0,1,1,1987,24,BUF,2,0,0,0,,0,0,0,,1,1,9,9,0,4.5,100,9,0,0,1,0,9,9,0,RB
6420,John Chirico,12,4,16,1987,22,NYJ,3,1,12,22,1.8,1,7.3,3,33.3,5,4,18,4.5,0,6,80,3.6,2,60,16,22,40,40,0,RB
6421,Darryl Clack,0,0,0,1987,24,DAL,12,0,0,0,,0,0,0,,0,0,0,,0,0,,,0,,0,0,0,635,635,RB
6422,Darryl Clark,5,0,5,1987,26,CHI,3,0,5,11,2.2,0,3.7,0,0,1,0,0,,0,0,0,0,0,0,5,11,11,11,0,RB
6423,Jessie Clark,56,22,78,1987,27,GNB,12,10,56,211,3.8,0,17.6,10,44.6,29,22,119,5.4,1,9.9,75.9,4.1,7,37.9,78,211,330,330,0,FB
6424,Spark Clark,0,0,0,1987,22,PIT,1,0,0,0,,0,0,0,,0,0,0,,0,0,,,0,,0,0,0,18,18,RB
6425,Michael Clemons,2,0,2,1987,22,KAN,8,0,2,7,3.5,0,0.9,0,0,0,0,0,,0,0,,,0,,2,7,7,172,165,RB
6426,Topper Clemons,3,1,4,1987,24,PHI,3,0,3,0,0,0,0,0,0,2,1,13,13,1,4.3,50,6.5,1,50,4,0,13,13,0,RB
6427,Eric Cobble,9,0,9,1987,23,HOU,3,0,9,23,2.6,0,7.7,1,33.3,1,0,0,,0,0,0,0,0,0,9,23,23,23,0,RB
6428,Tony Collins,147,44,191,1987,28,NWE,13,11,147,474,3.2,3,36.5,19,35.4,78,44,347,7.9,3,26.7,56.4,4.4,19,46.2,191,474,821,839,18,RB
6429,Kelly Cook,2,0,2,1987,25,GNB,11,0,2,3,1.5,0,0.3,0,0,0,0,0,,0,0,,,0,,2,3,3,150,147,RB
6430,Jaime Covington,4,1,5,1987,25,NYG,2,0,4,0,0,0,0,1,25,5,1,9,9,0,4.5,20,1.8,0,20,5,0,9,9,0,RB
6431,Tom Cox,0,0,0,1987,25,RAM,3,0,0,0,,0,0,0,,0,0,0,,0,0,,,0,,0,0,0,0,0,FB
6432,Roger Craig,215,66,281,1987,27,SFO,14,14,215,815,3.8,3,58.2,44,45.1,85,66,492,7.5,1,35.1,77.6,5.8,23,49.4,281,815,1307,1307,0,RB/FB
6433,Charles Crawford,0,0,0,1987,23,PHI,2,0,0,0,,0,0,0,,0,0,0,,0,0,,,0,,0,0,0,0,0,RB
6434,Mike Crawford,0,0,0,1987,23,CLE,3,0,0,0,,0,0,0,,0,0,0,,0,0,,,0,,0,0,0,0,0,RB
6435,Joe Cribbs,70,9,79,1987,29,SFO,11,3,70,300,4.3,1,27.3,20,57.1,11,9,70,7.8,0,6.4,81.8,6.4,4,72.7,79,300,370,697,327,RB
6436,Ron Davenport,32,27,59,1987,25,MIA,10,1,32,114,3.6,1,11.4,8,50,33,27,249,9.2,1,24.9,81.8,7.5,10,66.7,59,114,363,363,0,RB
6437,Elgin Davis,9,0,9,1987,22,NWE,4,0,9,43,4.8,0,10.8,2,33.3,3,0,0,,0,0,0,0,0,0,9,43,43,177,134,RB
6438,Johnny Davis,1,0,1,1987,31,CLE,1,0,1,7,7,0,7,0,0,0,0,0,,0,0,,,0,,1,7,7,7,0,RB
6439,Kenneth Davis,109,14,123,1987,25,GNB,10,8,109,413,3.8,3,41.3,13,38.5,23,14,110,7.9,0,11,60.9,4.8,3,26.1,123,413,523,523,0,RB
6440,Eric Dickerson,283,18,301,1987,27,"IND,RAM",12,10,283,1288,4.6,6,107.3,65,49.8,30,18,171,9.5,0,14.3,60,5.7,6,46.7,301,1288,1459,1459,0,RB
6441,Fred DiRenzo,1,0,1,1987,26,NYG,1,0,1,5,5,0,5,0,0,0,0,0,,0,0,,,0,,1,5,5,5,0,FB
6442,Robert DiRico,25,2,27,1987,24,NYG,3,1,25,90,3.6,0,30,6,48,4,2,22,11,0,7.3,50,5.5,2,50,27,90,112,143,31,RB
6443,Tony Dollinger,8,3,11,1987,25,DET,2,1,8,22,2.8,0,11,1,25,4,3,25,8.3,0,12.5,75,6.3,1,50,11,22,47,47,0,RB
6444,Tony Dorsett,130,19,149,1987,33,DAL,12,6,130,456,3.5,1,38,20,42.3,30,19,177,9.3,1,14.8,63.3,5.9,5,36.7,149,456,633,633,0,RB
6445,D.J. Dozier,69,12,81,1987,22,MIN,9,3,69,257,3.7,5,28.6,22,55.1,20,12,89,7.4,2,9.9,60,4.5,5,45,81,257,346,369,23,RB
6446,Stacey Driver,9,0,9,1987,23,CLE,2,0,9,31,3.4,0,15.5,1,33.3,0,0,0,,0,0,,,0,,9,31,31,47,16,RB
6447,Doug DuBose,10,4,14,1987,23,SFO,2,0,10,33,3.3,0,16.5,1,40,4,4,37,9.3,0,18.5,100,9.3,2,100,14,33,70,70,0,RB
6448,Joe Dudek,35,7,42,1987,23,DEN,2,2,35,154,4.4,2,77,10,71.4,7,7,41,5.9,0,20.5,100,5.9,2,71.4,42,154,195,195,0,RB
6449,Reggie Dupard,94,3,97,1987,24,NWE,8,3,94,318,3.4,3,39.8,10,38.3,3,3,1,0.3,0,0.1,100,0.3,0,0,97,318,319,380,61,RB
6450,Bobby Joe Edmonds,0,0,0,1987,23,SEA,11,0,0,0,,0,0,0,,0,0,0,,0,0,,,0,,0,0,0,815,815,RB
6451,Stan Edwards,32,7,39,1987,27,DET,3,3,32,69,2.2,0,23,4,15.6,13,7,82,11.7,0,27.3,53.8,6.3,4,46.2,39,69,151,128,0,RB
6452,Gary Ellerson,47,5,52,1987,24,DET,8,2,47,196,4.2,3,24.5,13,53.2,9,5,48,9.6,1,6,55.6,5.3,3,44.4,52,196,244,244,0,RB
6453,Craig Ellis,33,5,38,1987,26,RAI,3,1,33,138,4.2,2,46,8,51.5,7,5,39,7.8,0,13,71.4,5.6,2,42.9,38,138,177,177,0,RB
6454,Larry Emery,1,5,6,1987,23,ATL,5,0,1,5,5,0,1,0,0,6,5,31,6.2,0,6.2,83.3,5.2,1,50,6,5,36,476,440,RB
6455,Donald Evans,3,0,3,1987,23,RAM,1,0,3,10,3.3,0,10,0,0,0,0,0,,0,0,,,0,,3,10,10,10,0,RB
6456,James Evans,0,0,0,1987,24,KAN,2,0,0,0,,0,0,0,,1,0,0,,0,0,0,0,0,0,0,0,0,0,0,RB
6457,Major Everett,34,8,42,1987,27,"ATL,CLE",11,3,34,95,2.8,0,8.6,8,44.1,13,8,41,5.1,0,3.7,61.5,3.2,1,38.5,42,95,136,169,33,RB
6458,Nuu Faaola,14,1,15,1987,23,NYJ,12,0,14,43,3.1,2,3.6,10,71.4,1,1,16,16,0,1.3,100,16,1,100,15,43,59,66,4,RB
6459,Rick Fenney,42,7,49,1987,23,MIN,11,0,42,174,4.1,2,15.8,18,54.8,9,7,27,3.9,0,2.5,77.8,3,1,22.2,49,174,201,201,0,RB
6460,Earl Ferrell,113,23,136,1987,29,STL,11,11,113,512,4.5,7,46.5,33,57.5,33,23,262,11.4,0,23.8,69.7,7.9,11,51.5,136,512,774,784,10,FB
6461,Terrence Flagler,6,2,8,1987,23,SFO,3,1,6,11,1.8,0,3.7,0,16.7,4,2,28,14,0,9.3,50,7,1,50,8,11,39,70,31,RB
6462,Kenny Flowers,14,7,21,1987,23,ATL,8,1,14,61,4.4,0,7.6,3,50,9,7,50,7.1,0,6.3,77.8,5.6,3,33.3,21,61,111,183,72,RB
6463,Herman Fontenot,15,4,19,1987,24,CLE,12,0,15,33,2.2,0,2.8,1,26.7,8,4,40,10,0,3.3,50,5,1,37.5,19,47,73,203,130,RB
6464,Derrick Foster,1,1,2,1987,24,NYJ,3,0,1,9,9,0,3,0,0,2,1,9,9,0,3,50,4.5,0,0,2,9,18,26,8,RB
6465,Jon Francis,35,8,43,1987,23,RAM,9,0,35,138,3.9,0,15.3,6,48.6,10,8,38,4.8,2,4.2,80,3.8,3,70,43,138,176,176,0,RB
6466,Pat Franklin,0,0,0,1987,24,CIN,2,0,0,0,,0,0,0,,0,0,0,,0,0,,,0,,0,0,0,0,0,RB
6467,Phil Frye,4,3,7,1987,29,MIN,1,1,4,4,1,0,4,0,0,4,3,25,8.3,0,25,75,6.3,1,50,7,4,29,29,0,RB
6468,Brent Fullwood,84,2,86,1987,24,GNB,11,1,84,274,3.3,5,24.9,19,46.4,3,2,11,5.5,0,1,66.7,3.7,1,33.3,86,274,285,795,510,RB
6469,Tony Galbreath,10,26,36,1987,33,NYG,12,0,10,74,7.4,0,6.2,4,50,28,26,248,9.5,0,20.7,92.9,8.9,12,67.9,36,74,322,322,0,RB
6470,Owen Gill,0,0,0,1987,25,RAM,1,0,0,0,,0,0,0,,0,0,0,,0,0,,,0,,0,0,0,0,0,RB
6471,Charles Gladman,12,2,14,1987,21,TAM,2,0,12,29,2.4,0,14.5,3,33.3,2,2,8,4,0,4,100,4,0,0,14,29,37,53,16,RB
6472,Don Goodman,0,0,0,1987,30,STL,3,0,0,0,,0,0,0,,0,0,0,,0,0,,,0,,0,0,0,0,0,RB
6473,Norm Granger,6,2,8,1987,26,ATL,3,1,6,12,2,0,4,1,16.7,3,2,34,17,0,11.3,66.7,11.3,1,66.7,8,12,46,46,0,RB
6474,Mel Gray,8,6,14,1987,26,NOR,12,1,8,37,4.6,1,3.1,3,62.5,14,6,30,5,0,2.5,42.9,2.1,3,28.6,14,37,67,1055,988,RB
6475,Boyce Green,21,0,21,1987,27,SEA,2,2,21,77,3.7,0,38.5,4,42.9,1,0,0,,0,0,0,0,0,0,21,77,77,97,20,RB
6476,Keith Griffin,62,3,65,1987,26,WAS,9,2,62,242,3.9,0,26.9,10,43.5,4,3,13,4.3,1,1.4,75,3.3,2,50,65,242,255,733,478,RB
6477,Stephen Griffin,0,0,0,1987,23,KAN,1,0,0,0,,0,0,0,,0,0,0,,0,0,,,0,,0,0,0,16,16,RB
6478,Steve Griffin,1,0,1,1987,24,ATL,4,0,1,-2,-2,0,-0.5,0,0,1,0,0,,0,0,0,0,0,0,1,-2,-2,19,21,RB
6479,Mike Guman,36,22,58,1987,29,RAM,12,8,36,98,2.7,1,8.2,8,50,32,22,263,12,0,21.9,68.8,8.2,15,65.6,58,98,361,379,18,FB
6480,Michael Haddix,59,7,66,1987,26,PHI,12,4,59,165,2.8,0,13.8,7,35.6,9,7,58,8.3,0,4.8,77.8,6.4,2,66.7,66,165,223,239,16,RB
6481,Mike Hagen,2,0,2,1987,28,SEA,2,1,2,3,1.5,0,1.5,0,0,0,0,0,,0,0,,,0,,2,3,3,3,0,RB
6482,Lorenzo Hampton,75,23,98,1987,25,MIA,12,7,75,289,3.9,1,24.1,15,38.7,34,23,223,9.7,0,18.6,67.6,6.6,8,50,98,289,512,816,304,RB
6483,Bruce Hansen,16,1,17,1987,26,NWE,6,2,16,44,2.8,0,7.3,3,43.8,3,1,22,22,0,3.7,33.3,7.3,1,33.3,17,44,66,80,14,RB
6484,Andre Hardy,7,1,8,1987,26,SFO,1,0,7,48,6.9,0,48,2,85.7,1,1,7,7,0,7,100,7,0,100,8,48,55,55,0,RB
6485,Jimmy Hargrove,11,1,12,1987,30,GNB,2,2,11,38,3.5,1,19,4,54.5,2,1,6,6,0,3,50,3,0,50,12,38,44,44,0,RB
6486,Ronnie Harmon,116,56,172,1987,23,BUF,12,10,116,485,4.2,2,40.4,25,48.3,95,56,477,8.5,2,39.8,58.9,5,22,37.9,172,485,962,992,30,RB
6487,Frank Harris,6,0,6,1987,23,CHI,3,0,6,23,3.8,0,7.7,0,0,2,0,0,,0,0,0,0,0,0,6,23,23,23,0,RB
6488,Rob Harrison,9,2,11,1987,24,RAI,2,1,9,49,5.4,0,24.5,2,88.9,3,2,18,9,0,9,66.7,6,0,66.7,11,49,67,67,0,RB
6489,Sam Harrell,5,3,8,1987,30,MIN,1,1,5,8,1.6,0,8,1,40,3,3,20,6.7,0,20,100,6.7,0,33.3,8,8,28,32,4,RB
6490,Steve Harris,4,2,6,1987,25,MIN,2,0,4,3,0.8,0,1.5,0,0,3,2,17,8.5,0,8.5,66.7,5.7,1,33.3,6,3,20,20,0,RB
6491,Allen Harvin,0,0,0,1987,28,WAS,1,0,0,0,,0,0,0,,0,0,0,,0,0,,,0,,0,0,0,0,0,RB
6492,Frank Hawkins,4,1,5,1987,28,RAI,2,1,4,24,6,0,12,1,50,1,1,6,6,0,3,100,6,0,0,5,24,30,30,0,RB
6493,Greg Hawthorne,0,3,3,1987,31,IND,3,3,0,0,,0,0,0,,4,3,41,13.7,0,13.7,75,10.3,2,75,3,0,41,41,0,RB
6494,Herman Heard,82,14,96,1987,26,KAN,12,6,82,466,5.7,3,38.8,23,58.5,23,14,118,8.4,0,9.8,60.9,5.1,8,56.5,96,466,584,584,0,RB
6495,Johnny Hector,111,32,143,1987,27,NYJ,11,6,111,435,3.9,11,39.5,30,45.9,47,32,249,7.8,0,22.6,68.1,5.3,13,44.7,143,435,684,684,0,RB
6496,Lakei Heimuli,34,5,39,1987,22,CHI,3,3,34,128,3.8,0,42.7,7,58.8,8,5,51,10.2,1,17,62.5,6.4,3,50,39,128,179,179,0,RB
6497,Alonzo Highsmith,29,4,33,1987,22,HOU,8,3,29,106,3.7,1,13.3,8,44.8,8,4,55,13.8,1,6.9,50,6.9,2,25,33,106,161,161,0,RB
6498,Dalton Hilliard,123,23,146,1987,23,NOR,12,1,123,508,4.1,7,42.3,27,39.8,31,23,264,11.5,1,22,74.2,8.5,12,48.4,146,531,772,1020,248,RB
6499,Merril Hoge,3,7,10,1987,22,PIT,13,0,3,8,2.7,0,0.6,0,33.3,14,7,97,13.9,1,7.5,50,6.9,6,42.9,10,8,105,118,13,RB
6500,Walter Holman,2,0,2,1987,28,WAS,3,0,2,7,3.5,0,2.3,0,0,0,0,0,,0,0,,,0,,2,7,7,7,0,RB
6501,Ethan Horton,31,3,34,1987,25,RAI,4,2,31,95,3.1,0,23.8,4,48.4,4,3,44,14.7,1,11,75,11,1,75,34,95,139,139,0,RB
6502,Bobby Howard,30,10,40,1987,23,TAM,12,0,30,100,3.3,1,8.3,4,30,16,10,123,12.3,0,10.3,62.5,7.7,5,43.8,40,100,223,228,5,RB
6503,Eddie Hunter,56,7,63,1987,22,"NYJ,TAM",6,3,56,210,3.8,0,35,7,44.6,12,7,28,4,2,4.7,58.3,2.3,2,41.7,63,210,238,349,123,RB
6504,Herman Hunter,34,3,37,1987,26,HOU,3,0,34,144,4.2,0,48,6,47.1,4,3,17,5.7,0,5.7,75,4.3,1,25,37,144,161,240,79,RB
6505,Tony Hunter,1,0,1,1987,24,GNB,1,0,1,0,0,0,0,0,0,0,0,0,,0,0,,,0,,1,0,0,0,0,RB
6506,Rickey Isom,9,1,10,1987,24,MIA,3,1,9,41,4.6,1,13.7,6,88.9,2,1,11,11,0,3.7,50,5.5,1,50,10,41,52,63,11,RB
6507,Andrew Jackson,60,10,70,1987,23,HOU,7,3,60,232,3.9,1,33.1,13,48.3,13,10,44,4.4,0,6.3,76.9,3.4,1,23.1,70,232,276,276,0,RB
6508,Bo Jackson,81,16,97,1987,25,RAI,7,5,81,554,6.8,4,79.1,22,50.6,21,16,136,8.5,2,19.4,76.2,6.5,5,52.4,97,554,690,690,0,FB
6509,Earnest Jackson,180,7,187,1987,28,PIT,12,9,180,696,3.9,1,58,36,48.3,10,7,52,7.4,0,4.3,70,5.2,2,20,187,696,748,748,0,FB
6510,Arrike James,0,1,1,1987,22,HOU,3,0,0,0,,0,0,0,,2,1,14,14,0,4.7,50,7,1,50,1,0,14,14,0,RB
6511,Craig James,4,0,4,1987,26,NWE,2,0,4,10,2.5,0,5,0,0,0,0,0,,0,0,,,0,,4,10,10,10,0,RB
6512,Garry James,82,16,98,1987,24,DET,8,7,82,270,3.3,4,33.8,18,48.8,25,16,215,13.4,0,26.9,64,8.6,10,52,98,270,485,485,0,RB
6513,Garland Jean-Batiste,8,0,8,1987,22,NOR,3,0,8,18,2.3,0,6,0,0,1,0,0,,0,0,0,0,0,0,8,18,18,18,0,RB
6514,Keyvan Jenkins,22,8,30,1987,26,SDG,3,3,22,88,4,0,29.3,3,54.5,13,8,40,5,0,13.3,61.5,3.1,3,38.5,30,88,128,174,46,RB
6515,Stanford Jennings,70,35,105,1987,25,CIN,12,5,70,314,4.5,1,26.2,18,51.4,58,35,277,7.9,2,23.1,60.3,4.8,17,46.6,105,314,591,623,32,RB
6516,Tim Jessie,10,1,11,1987,24,WAS,3,0,10,37,3.7,1,12.3,2,40,1,1,8,8,0,2.7,100,8,0,0,11,37,45,118,73,RB
6517,Bill Johnson,39,3,42,1987,27,CIN,11,4,39,205,5.3,1,18.6,13,61.5,6,3,19,6.3,0,1.7,50,3.2,0,33.3,42,205,224,224,0,RB
6518,Nate Johnson,0,0,0,1987,24,NOR,1,0,0,0,,0,0,0,,0,0,0,,0,0,,,0,,0,0,0,0,0,RB
6519,E.J. Jones,2,3,5,1987,25,DAL,3,0,2,7,3.5,0,2.3,0,0,4,3,16,5.3,0,5.3,75,4,0,0,5,7,23,23,0,RB
6520,James Jones,96,34,130,1987,26,DET,11,11,96,342,3.6,0,31.1,18,47.9,49,34,262,7.7,0,23.8,69.4,5.3,8,46.9,130,342,604,604,0,FB
6521,Kirk Jones,0,0,0,1987,22,CLE,1,0,0,0,,0,0,0,,0,0,0,,0,0,,,0,,0,0,0,0,0,RB
6522,Buford Jordan,12,2,14,1987,25,NOR,12,4,12,36,3,2,3,5,75,3,2,13,6.5,0,1.1,66.7,4.3,1,33.3,14,36,49,90,41,RB
6523,John Kamana,0,7,7,1987,26,ATL,2,1,0,0,,0,0,0,,11,7,51,7.3,1,25.5,63.6,4.6,3,45.5,7,0,51,51,0,RB
6524,Bruce King,9,1,10,1987,24,BUF,3,2,9,28,3.1,0,9.3,2,33.3,1,1,3,3,0,1,100,3,0,0,10,28,31,31,0,RB
6525,Larry Kinnebrew,145,9,154,1987,28,CIN,11,8,145,570,3.9,8,51.8,43,59.3,13,9,114,12.7,0,10.4,69.2,8.8,5,61.5,154,570,684,684,0,FB
6526,Mark Konecny,6,6,12,1987,24,MIA,3,0,6,46,7.7,0,15.3,1,66.7,7,6,26,4.3,0,8.7,85.7,3.7,1,42.9,12,46,72,72,0,RB
6527,Nick Kowgios,1,1,2,1987,25,DET,3,0,1,2,2,0,0.7,0,0,1,1,3,3,0,1,100,3,0,0,2,2,5,5,0,RB
6528,Ken Lacy,14,0,14,1987,27,KAN,3,1,14,49,3.5,0,16.3,6,57.1,0,0,0,,0,0,,,0,,14,49,49,93,44,RB
6529,Dan Land,9,0,9,1987,22,TAM,3,2,9,20,2.2,0,6.7,2,33.3,1,0,0,,0,0,0,0,0,0,9,20,20,20,0,RB
6530,Eric Lane,13,4,17,1987,28,SEA,12,2,13,40,3.1,0,3.3,2,38.5,5,4,30,7.5,0,2.5,80,6,1,60,17,40,70,104,34,RB
6531,Gene Lang,89,17,106,1987,25,DEN,12,8,89,303,3.4,2,25.3,17,44.9,30,17,130,7.6,2,10.8,56.7,4.3,7,30,106,296,433,511,78,FB
6532,Robert Lavette,0,1,1,1987,24,"DAL,PHI",5,0,0,0,,0,0,0,,2,1,6,6,0,1.2,50,3,1,50,1,0,6,115,109,RB
6533,Michael LeBlanc,49,2,51,1987,25,NWE,4,2,49,170,3.5,1,42.5,9,36.7,3,2,3,1.5,0,0.8,66.7,1,0,0,51,170,173,204,31,RB
6534,Zeph Lee,0,0,0,1987,24,"DEN,RAI",3,0,0,0,,0,0,0,,0,0,0,,0,0,,,0,,0,0,0,0,0,FB
6535,Marc Logan,37,3,40,1987,22,CIN,3,3,37,203,5.5,1,67.7,8,37.8,6,3,14,4.7,0,4.7,50,2.3,1,16.7,40,203,217,248,31,RB
6536,Warren Loving,0,0,0,1987,27,BUF,2,0,0,0,,0,0,0,,0,0,0,,0,0,,,0,,0,0,0,0,0,RB
6537,Kevin Mack,201,32,233,1987,25,CLE,12,12,201,735,3.7,5,61.3,41,50.7,44,32,223,7,1,18.6,72.7,5.1,12,47.7,233,735,958,958,0,FB
6538,Tim Manoa,23,1,24,1987,23,CLE,12,0,23,116,5,0,9.7,4,47.8,2,1,8,8,0,0.7,50,4,0,50,24,116,124,138,14,RB
6539,Warren Marshall,0,0,0,1987,23,DEN,1,0,0,0,,0,0,0,,0,0,0,,0,0,,,0,,0,0,0,0,0,RB
6540,Larry Mason,56,5,61,1987,26,CLE,3,3,56,207,3.7,2,69,12,48.2,14,5,26,5.2,1,8.7,35.7,1.9,2,21.4,61,207,233,233,0,RB
6541,Rueben Mayes,243,15,258,1987,24,NOR,12,12,243,917,3.8,5,76.4,44,42,20,15,68,4.5,0,5.7,75,3.4,4,45,258,917,985,985,0,RB
6542,Derrick McAdoo,53,2,55,1987,22,STL,15,2,53,230,4.3,3,15.3,19,49.1,3,2,12,6,0,0.8,66.7,4,1,66.7,55,230,242,686,444,RB
6543,David McCluskey,29,1,30,1987,24,CIN,3,3,29,94,3.2,1,31.3,6,51.7,1,1,8,8,0,2.7,100,8,0,100,30,94,102,102,0,RB
6544,Buford McGee,3,7,10,1987,27,RAM,3,1,3,6,2,1,2,1,66.7,9,7,40,5.7,0,13.3,77.8,4.4,2,55.6,10,6,46,46,0,RB
6545,Joe McIntosh,5,3,8,1987,25,ATL,2,0,5,11,2.2,0,5.5,3,60,4,3,15,5,1,7.5,75,3.8,2,75,8,11,26,134,108,RB
6546,Chris McLemore,17,2,19,1987,24,"IND,RAI",5,2,17,58,3.4,0,11.6,3,52.9,3,2,9,4.5,0,1.8,66.7,3,0,0,19,58,67,67,0,RB
6547,Freeman McNeil,121,24,145,1987,28,NYJ,9,8,121,530,4.4,0,58.9,23,44.6,31,24,262,10.9,1,29.1,77.4,8.5,10,51.6,145,530,792,792,0,RB
6548,Chuck McSwain,9,0,9,1987,26,NWE,3,1,9,23,2.6,0,7.7,1,33.3,0,0,0,,0,0,,,0,,9,23,23,66,32,RB
6549,Frank Middleton,28,8,36,1987,27,SDG,3,1,28,74,2.6,1,24.7,5,35.7,10,8,43,5.4,0,14.3,80,4.3,2,20,36,74,117,117,0,RB
6550,Stump Mitchell,203,45,248,1987,28,STL,12,12,203,781,3.8,3,65.1,41,48.3,55,45,397,8.8,2,33.1,81.8,7.2,16,63.6,248,798,1178,1178,0,RB
6551,Carl Monroe,2,3,5,1987,27,SFO,3,2,2,26,13,0,8.7,1,100,10,3,66,22,1,22,30,6.6,2,20,5,26,92,183,91,RB
6552,Alvin Moore,3,0,3,1987,28,SEA,1,0,3,15,5,0,15,1,33.3,0,0,0,,0,0,,,0,,3,15,15,15,0,RB
6553,Leonard Moore,4,1,5,1987,24,MIN,1,1,4,11,2.8,0,11,1,50,1,1,8,8,0,8,100,8,0,0,5,11,19,19,0,RB
6554,Ricky Moore,7,3,10,1987,24,HOU,3,3,7,22,3.1,0,7.3,1,42.9,5,3,21,7,0,7,60,4.2,2,40,10,22,43,43,0,RB
6555,Larry Moriarty,30,10,40,1987,29,KAN,12,4,30,107,3.6,0,8.9,6,56.7,12,10,37,3.7,1,3.1,83.3,3.1,4,50,40,107,144,246,102,RB
6556,Joe Morris,193,11,204,1987,27,NYG,11,10,193,658,3.4,3,59.8,35,44,15,11,114,10.4,0,10.4,73.3,7.6,5,73.3,204,658,772,772,0,RB
6557,Larry Morris,8,0,8,1987,25,GNB,2,0,8,18,2.3,0,9,1,12.5,0,0,0,,0,0,,,0,,8,18,18,18,0,RB
6558,Randall Morris,21,0,21,1987,26,SEA,10,0,21,71,3.4,0,7.1,4,28.6,0,0,0,,0,0,,,0,,21,71,71,220,149,RB
6559,Bobby Morse,6,1,7,1987,22,PHI,11,0,6,14,2.3,0,1.3,1,33.3,1,1,8,8,0,0.7,100,8,1,100,7,14,22,529,507,RB
6560,Michael Morton,19,0,19,1987,27,SEA,2,0,19,52,2.7,1,26,4,36.8,1,0,0,,0,0,0,0,0,0,19,52,52,52,0,RB
6561,Anthony Mosley,18,2,20,1987,22,CHI,2,2,18,80,4.4,0,40,4,55.6,4,2,16,8,0,8,50,4,1,25,20,80,96,113,17,RB
6562,Jamie Mueller,82,3,85,1987,23,BUF,12,6,82,354,4.3,2,29.5,22,52.4,5,3,13,4.3,0,1.1,60,2.6,0,40,85,354,367,419,74,FB
6563,Vance Mueller,37,11,48,1987,23,RAI,12,0,37,175,4.7,1,14.6,8,51.4,14,11,95,8.6,0,7.9,78.6,6.8,4,71.4,48,175,270,858,588,RB
6564,Tony Nathan,4,10,14,1987,31,MIA,6,0,4,20,5,0,3.3,0,75,12,10,77,7.7,0,12.8,83.3,6.4,3,83.3,14,20,97,97,0,RB
6565,Darrin Nelson,131,26,157,1987,28,MIN,10,9,131,642,4.9,2,64.2,27,44.3,47,26,129,5,0,12.9,55.3,2.7,5,34,157,642,771,935,164,RB
6566,Tim Newman,0,0,0,1987,23,NYJ,1,0,0,0,,0,0,0,,0,0,0,,0,0,,,0,,0,0,0,0,0,RB
6567,Timmy Newsome,25,34,59,1987,29,DAL,11,8,25,121,4.8,2,11,8,52,48,34,274,8.1,2,24.9,70.8,5.7,15,39.6,59,121,395,417,22,FB
6568,Christian Okoye,157,24,181,1987,26,KAN,12,12,157,660,4.2,3,55,39,51.6,30,24,169,7,0,14.1,80,5.6,4,66.7,181,660,829,829,0,FB
6569,Darryl Oliver,1,1,2,1987,23,ATL,2,0,1,0,0,0,0,0,0,1,1,2,2,0,1,100,2,0,0,2,0,2,92,90,RB
6570,Tony Paige,4,2,6,1987,25,DET,5,0,4,13,3.3,0,2.6,0,0,3,2,1,0.5,0,0.2,66.7,0.3,0,0,6,13,14,14,0,RB
6571,Paul Palmer,24,4,28,1987,23,KAN,12,1,24,155,6.5,0,12.9,5,50,6,4,27,6.8,0,2.3,66.7,4.5,1,50,28,155,182,1105,923,RB
6572,Mike Panepinto,0,0,0,1987,22,BUF,1,0,0,0,,0,0,0,,0,0,0,,0,0,,,0,,0,0,0,0,0,RB
6573,Freddie Parker,8,3,11,1987,25,GNB,1,0,8,33,4.1,0,33,1,50,3,3,22,7.3,0,22,100,7.3,1,66.7,11,33,55,55,0,RB
6574,Kaulana Park,6,1,7,1987,25,NYG,2,2,6,11,1.8,0,5.5,0,0,2,1,6,6,0,3,50,3,0,0,7,11,17,17,0,RB
6575,Robert Parker,47,7,54,1987,24,KAN,3,2,47,150,3.2,1,50,11,46.8,12,7,44,6.3,0,14.7,58.3,3.7,2,41.7,54,150,194,243,49,RB
6576,Rick Parros,13,1,14,1987,29,SEA,1,1,13,32,2.5,1,32,1,46.2,2,1,7,7,0,7,50,3.5,0,50,14,32,39,39,0,RB
6577,Walter Payton,146,33,179,1987,34,CHI,12,12,146,533,3.7,4,44.4,38,48.6,39,33,217,6.6,1,18.1,84.6,5.6,8,56.4,179,533,750,750,0,RB
6578,Bob Perryman,41,3,44,1987,23,NWE,9,1,41,187,4.6,0,20.8,11,48.8,4,3,13,4.3,0,1.4,75,3.3,1,50,44,187,200,243,43,RB
6579,Allen Pinkett,31,1,32,1987,23,HOU,8,0,31,149,4.8,2,18.6,7,41.9,2,1,7,7,0,0.9,50,3.5,0,50,32,149,156,478,322,RB
6580,Woodie Pippens,3,2,5,1987,24,KAN,2,0,3,16,5.3,0,8,0,0,3,2,12,6,0,6,66.7,4,0,0,5,16,28,28,0,RB
6581,Frank Pollard,128,14,142,1987,30,PIT,12,7,128,536,4.2,3,44.7,29,47.7,22,14,77,5.5,0,6.4,63.6,3.5,4,27.3,142,536,613,614,0,FB
6582,Nathan Poole,28,1,29,1987,31,DEN,2,0,28,126,4.5,1,63,11,67.9,1,1,9,9,0,4.5,100,9,0,100,29,126,135,135,0,RB
6583,Shelley Poole,0,0,0,1987,23,ATL,1,0,0,0,,0,0,0,,0,0,0,,0,0,,,0,,0,0,0,0,0,RB
6584,Kerry Porter,2,0,2,1987,23,BUF,6,0,2,0,0,0,0,1,50,0,0,0,,0,0,,,0,,2,0,0,0,0,RB
6585,Ricky Porter,47,9,56,1987,27,BUF,9,0,47,177,3.8,0,19.7,6,40.4,15,9,70,7.8,0,7.8,60,4.7,3,40,56,177,247,466,219,RB
6586,Jeff Powell,0,0,0,1987,24,SDG,1,0,0,0,,0,0,0,,0,0,0,,0,0,,,0,,0,0,0,0,0,RB
6587,Tom Rathman,62,30,92,1987,25,SFO,12,7,62,257,4.1,1,21.4,16,46.8,39,30,329,11,3,27.4,76.9,8.4,20,61.5,92,257,586,623,37,FB
6588,Barry Redden,11,7,18,1987,27,SDG,12,0,11,36,3.3,0,3,1,36.4,8,7,46,6.6,0,3.8,87.5,5.8,3,50,18,36,82,82,0,RB
6589,Dan Reeder,2,0,2,1987,26,PIT,2,0,2,8,4,0,4,1,100,0,0,0,,0,0,,,0,,2,8,8,8,0,RB
6590,Alan Reid,0,0,0,1987,27,PHI,1,0,0,0,,0,0,0,,0,0,0,,0,0,,,0,,0,0,0,58,58,RB
6591,Allen Rice,51,19,70,1987,25,MIN,12,2,51,131,2.6,1,10.9,8,31.4,23,19,201,10.6,1,16.8,82.6,8.7,10,65.2,70,131,332,361,29,RB
6592,Dan Rice,18,0,18,1987,24,CIN,3,0,18,59,3.3,0,19.7,5,55.6,1,0,0,,0,0,0,0,0,0,18,59,59,59,0,RB
6593,Harold Ricks,24,1,25,1987,25,TAM,3,1,24,76,3.2,1,25.3,3,33.3,6,1,12,12,0,4,16.7,2,1,16.7,25,76,88,114,26,RB
6594,Robb Riddick,59,15,74,1987,30,BUF,6,1,59,221,3.7,5,36.8,22,57.6,19,15,96,6.4,3,16,78.9,5.1,6,47.4,74,256,317,468,151,RB
6595,Gerald Riggs,203,25,228,1987,27,ATL,12,12,203,875,4.3,2,72.9,42,53.2,36,25,199,8,0,16.6,69.4,5.5,7,50,228,875,1074,1074,0,RB
6596,Jacque Robinson,24,2,26,1987,24,PHI,3,3,24,114,4.8,0,38,5,58.3,3,2,9,4.5,0,3,66.7,3,1,66.7,26,114,123,123,0,FB
6597,Jeff Rodenberger,17,2,19,1987,28,NOR,3,3,17,35,2.1,0,11.7,7,64.7,4,2,17,8.5,0,5.7,50,4.3,1,25,19,35,52,52,0,RB
6598,Del Rodgers,11,2,13,1987,27,SFO,7,0,11,46,4.2,1,6.6,3,45.5,4,2,45,22.5,0,6.4,50,11.3,2,50,13,46,91,449,358,RB
6599,George Rogers,163,4,167,1987,29,WAS,11,9,163,613,3.8,6,55.7,37,48.5,8,4,23,5.8,0,2.1,50,2.9,0,37.5,167,613,636,636,0,RB
6600,Dave Romasko,0,0,0,1987,24,CIN,3,3,0,0,,0,0,0,,1,0,0,,0,0,0,0,0,0,0,0,0,0,0,RB
6601,Alvin Ross,14,5,19,1987,24,PHI,2,0,14,54,3.9,1,27,4,50,6,5,41,8.2,0,20.5,83.3,6.8,2,50,19,54,95,95,0,RB
6602,Pete Roth,3,0,3,1987,25,MIA,3,0,3,10,3.3,0,3.3,0,0,0,0,0,,0,0,,,0,,3,10,10,59,49,RB
6603,Lee Rouson,41,11,52,1987,25,NYG,12,2,41,155,3.8,0,12.9,6,41.5,15,11,129,11.7,1,10.8,73.3,8.6,4,66.7,52,155,284,781,497,RB
6604,Mike Rozier,229,27,256,1987,26,HOU,11,11,229,957,4.2,3,87,52,47.6,38,27,192,7.1,0,17.5,71.1,5.1,7,36.8,256,957,1149,1149,0,RB
6605,Chuck Sanders,11,1,12,1987,23,PIT,5,0,11,65,5.9,1,13,4,54.5,1,1,11,11,0,2.2,100,11,1,100,12,65,76,76,0,RB
6606,Thomas Sanders,23,3,26,1987,25,CHI,12,0,23,122,5.3,1,10.2,8,73.9,3,3,53,17.7,0,4.4,100,17.7,2,100,26,122,175,524,349,RB
6607,Broderick Sargent,18,2,20,1987,25,STL,15,1,18,90,5,0,6,6,61.1,3,2,19,9.5,0,1.3,66.7,6.3,1,66.7,20,90,109,146,37,RB
6608,Martin Sartin,19,6,25,1987,24,SDG,3,1,19,52,2.7,1,17.3,5,57.9,9,6,19,3.2,0,6.3,66.7,2.1,1,33.3,25,52,71,188,117,RB
6609,Ronald Scott,47,2,49,1987,24,MIA,3,2,47,199,4.2,3,66.3,14,61.7,4,2,7,3.5,0,2.3,50,1.8,0,25,49,199,206,228,22,RB
6610,John Settle,19,11,30,1987,22,ATL,9,1,19,72,3.8,0,8,3,36.8,22,11,153,13.9,0,17,50,7,8,50,30,72,225,383,158,RB
6611,Steve Sewell,19,13,32,1987,24,DEN,7,0,19,83,4.4,2,11.9,5,57.9,18,13,209,16.1,1,29.9,72.2,11.6,9,55.6,32,74,292,292,0,RB
6612,Johnny Shepherd,12,1,13,1987,30,BUF,2,1,12,42,3.5,0,21,2,33.3,2,1,2,2,0,1,50,1,0,0,13,42,44,44,0,RB
6613,Vai Sikahema,0,0,0,1987,25,STL,15,0,0,0,,0,0,0,,2,0,0,,0,0,0,0,0,0,0,0,0,1311,1311,RB
6614,Chris Smith,26,2,28,1987,24,KAN,3,3,26,114,4.4,0,38,3,46.2,3,2,21,10.5,0,7,66.7,7,2,66.7,28,114,135,135,0,RB
6615,Jeff Smith,100,20,120,1987,25,TAM,12,8,100,309,3.1,2,25.8,17,44,27,20,197,9.9,2,16.4,74.1,7.3,8,63,120,309,506,590,84,RB
6616,Jimmy Smith,7,0,7,1987,27,MIN,1,1,7,13,1.9,0,13,0,0,1,0,0,,0,0,0,0,0,0,7,13,13,55,42,RB
6617,Steve Smith,5,3,8,1987,23,RAI,7,3,5,18,3.6,0,2.6,1,20,3,3,46,15.3,0,6.6,100,15.3,1,100,8,18,64,64,0,RB
6618,Timmy Smith,29,1,30,1987,23,WAS,7,0,29,126,4.3,0,18,5,51.7,3,1,-2,-2,0,-0.3,33.3,-0.7,0,0,30,126,124,124,0,RB
6619,Tim Spencer,73,17,90,1987,27,SDG,12,7,73,228,3.1,0,19,8,37,17,17,123,7.2,0,10.3,100,7.2,4,52.9,90,228,351,351,0,FB
6620,Todd Spencer,14,2,16,1987,25,SDG,3,2,14,24,1.7,0,8,1,28.6,3,2,47,23.5,0,15.7,66.7,15.7,1,33.3,16,24,71,71,0,RB
6621,Chad Stark,0,0,0,1987,22,SEA,2,0,0,0,,0,0,0,,0,0,0,,0,0,,,0,,0,0,0,0,0,RB
6622,Anthony Steels,1,1,2,1987,28,SDG,2,0,1,3,3,0,1.5,0,0,2,1,4,4,0,2,50,2,0,0,2,3,7,7,0,RB
6623,John Sterling,5,0,5,1987,23,GNB,2,0,5,20,4,0,10,1,60,0,0,0,,0,0,,,0,,5,20,20,20,0,RB
6624,Ralph Stockemer,1,1,2,1987,25,KAN,2,0,1,2,2,0,1,0,0,1,1,4,4,0,2,100,4,0,0,2,2,6,6,0,RB
6625,Dwight Stone,17,1,18,1987,23,PIT,14,0,17,135,7.9,0,9.6,5,41.2,4,1,22,22,0,1.6,25,5.5,1,25,18,135,157,725,568,RB
6626,Steve Strachan,28,4,32,1987,24,RAI,11,3,28,108,3.9,0,9.8,7,42.9,4,4,42,10.5,0,3.8,100,10.5,3,75,32,108,150,150,0,RB
6627,Troy Stradford,145,48,193,1987,23,MIA,12,5,145,619,4.3,6,51.6,40,52.4,62,48,457,9.5,1,38.1,77.4,7.4,20,56.5,193,625,1076,1334,258,RB
6628,Matt Suhey,7,7,14,1987,29,CHI,12,2,7,24,3.4,0,2,2,42.9,10,7,54,7.7,0,4.5,70,5.4,2,60,14,24,78,87,9,RB
6629,George Swarn,0,0,0,1987,23,CLE,1,0,0,0,,0,0,0,,0,0,0,,0,0,,,0,,0,0,0,0,0,RB
6630,Harry Sydney,29,1,30,1987,28,SFO,14,0,29,125,4.3,0,8.9,11,51.7,3,1,3,3,0,0.2,33.3,1,0,0,30,175,128,371,243,RB
6631,John Tagliaferri,13,12,25,1987,23,MIA,3,1,13,45,3.5,1,15,4,76.9,23,12,117,9.8,0,39,52.2,5.1,6,43.5,25,45,162,162,0,RB
6632,Mosi Tatupu,79,15,94,1987,32,NWE,12,9,79,248,3.1,0,20.7,12,40.5,18,15,136,9.1,0,11.3,83.3,7.6,7,66.7,94,263,384,384,0,FB
6633,Junior Tautalatasi,26,25,51,1987,25,PHI,12,1,26,69,2.7,0,5.8,4,42.3,36,25,176,7,0,14.7,69.4,4.9,7,33.3,51,69,245,298,53,RB
6634,Andre Thomas,6,2,8,1987,27,MIN,1,0,6,4,0.7,0,4,1,33.3,3,2,13,6.5,0,13,66.7,4.3,0,33.3,8,4,17,17,0,RB
6635,Calvin Thomas,25,0,25,1987,27,CHI,12,0,25,88,3.5,0,7.3,5,44,0,0,0,,0,0,,,0,,25,88,88,88,0,RB
6636,Derrick Thomas,1,0,1,1987,22,TAM,1,0,1,2,2,0,2,0,0,0,0,0,,0,0,,,0,,1,2,2,2,0,RB
6637,Lavale Thomas,5,2,7,1987,24,GNB,1,1,5,19,3.8,0,19,2,100,2,2,52,26,1,52,100,26,2,100,7,19,71,74,0,RB
6638,Spencer Tillman,12,0,12,1987,23,HOU,5,1,12,29,2.4,1,5.8,3,33.3,0,0,0,,0,0,,,0,,12,29,29,29,0,RB
6639,Casey Tiumalu,0,0,0,1987,26,RAM,3,0,0,0,,0,0,0,,0,0,0,,0,0,,,0,,0,0,0,158,158,RB
6640,Anthony Toney,127,39,166,1987,25,PHI,11,11,127,473,3.7,5,43,32,41.7,59,39,341,8.7,1,31,66.1,5.8,16,44.1,166,473,814,814,0,FB
6641,Maurice Turner,0,0,0,1987,27,NYJ,1,0,0,0,,0,0,0,,0,0,0,,0,0,,,0,,0,0,0,0,0,RB
6642,Willie Turral,0,0,0,1987,23,PHI,1,0,0,0,,0,0,0,,0,0,0,,0,0,,,0,,0,0,0,21,21,RB
6643,Tim Tyrrell,11,6,17,1987,26,RAM,11,0,11,44,4,0,4,2,36.4,9,6,59,9.8,0,5.4,66.7,6.6,3,44.4,17,44,103,219,116,RB
6644,Ira Valentine,5,2,7,1987,24,HOU,7,0,5,10,2,0,1.4,0,0,2,2,10,5,0,1.4,100,5,0,0,7,10,20,33,13,RB
6645,Mike Varajon,18,3,21,1987,23,SFO,3,1,18,82,4.6,0,27.3,5,66.7,4,3,25,8.3,0,8.3,75,6.3,1,25,21,82,107,120,13,RB
6646,Roger Vick,77,13,90,1987,23,NYJ,12,10,77,257,3.3,1,21.4,13,41.6,21,13,108,8.3,0,9,61.9,5.1,5,38.1,90,257,365,365,0,FB
6647,Lionel Vital,80,1,81,1987,24,WAS,3,3,80,346,4.3,2,115.3,16,53.8,1,1,13,13,0,4.3,100,13,1,100,81,346,359,390,31,RB
6648,Adam Walker,5,2,7,1987,24,MIN,2,0,5,24,4.8,0,12,1,40,2,2,3,1.5,0,1.5,100,1.5,0,0,7,24,27,27,0,RB
6649,Herschel Walker,209,60,269,1987,25,DAL,12,11,209,891,4.3,7,74.3,43,42.6,87,60,715,11.9,1,59.6,69,8.2,33,51.7,269,891,1606,1606,0,RB
6650,Ray Wallace,19,7,26,1987,24,HOU,12,9,19,102,5.4,0,8.5,5,42.1,11,7,34,4.9,0,2.8,63.6,3.1,1,45.5,26,102,136,136,0,FB
6651,Curt Warner,234,17,251,1987,26,SEA,12,12,234,985,4.2,8,82.1,58,58.5,20,17,167,9.8,2,13.9,85,8.4,6,75,251,985,1152,1152,0,RB
6652,Lee Weigel,10,1,11,1987,24,GNB,2,0,10,26,2.6,0,13,0,30,1,1,17,17,0,8.5,100,17,1,100,11,26,43,43,0,RB
6653,Cleve Wester,33,0,33,1987,23,DET,3,1,33,113,3.4,0,37.7,4,39.4,0,0,0,,0,0,,,0,,33,113,113,113,0,RB
6654,Charles White,324,23,347,1987,29,RAM,15,12,324,1374,4.2,11,91.6,74,47.5,34,23,121,5.3,0,8.1,67.6,3.6,7,29.4,347,1374,1495,1568,73,RB
6655,Gerald White,1,5,6,1987,23,DAL,3,3,1,-4,-4,0,-1.3,0,0,9,5,46,9.2,0,15.3,55.6,5.1,2,55.6,6,-4,42,42,0,RB
6656,James Wilder,106,40,146,1987,29,TAM,12,12,106,488,4.6,0,40.7,16,47.2,53,40,328,8.2,1,27.3,75.5,6.2,12,52.8,146,488,816,816,0,FB
6657,Alonzo Williams,2,0,2,1987,24,RAM,3,0,2,9,4.5,0,3,0,0,0,0,0,,0,0,,,0,,2,9,9,123,114,RB
6658,Gerald Willhite,26,9,35,1987,28,DEN,3,1,26,141,5.4,0,47,6,53.8,9,9,25,2.8,0,8.3,100,2.8,3,66.7,35,141,166,188,22,RB
6659,Jim Williams,0,0,0,1987,24,SEA,1,0,0,0,,0,0,0,,0,0,0,,0,0,,,0,,0,0,0,0,0,RB
6660,John Williams,113,38,151,1987,23,SEA,12,10,113,500,4.4,1,41.7,34,69,44,38,420,11.1,3,35,86.4,9.5,18,77.3,151,500,920,920,0,FB
6661,John Williams,0,0,0,1987,27,IND,2,0,0,0,,0,0,0,,0,0,0,,0,0,,,0,,0,0,0,0,0,RB
6662,Kevin Willhite,53,6,59,1987,24,GNB,3,3,53,251,4.7,0,83.7,8,47.2,6,6,37,6.2,0,12.3,100,6.2,1,50,59,251,288,325,37,RB
6663,Leonard Williams,9,1,10,1987,27,BUF,2,0,9,25,2.8,0,12.5,3,44.4,1,1,5,5,0,2.5,100,5,0,0,10,25,30,30,0,RB
6664,Michael Williams,14,9,23,1987,26,ATL,3,1,14,49,3.5,0,16.3,1,42.9,13,9,70,7.8,0,23.3,69.2,5.4,5,61.5,23,49,119,134,15,RB
6665,Ricky Williams,0,0,0,1987,27,RAI,1,0,0,0,,0,0,0,,0,0,0,,0,0,,,0,,0,0,0,0,0,RB
6666,Scott Williams,8,4,12,1987,25,DET,5,2,8,29,3.6,0,5.8,2,37.5,5,4,16,4,1,3.2,80,3.2,1,40,12,29,45,45,0,RB
6667,Van Williams,29,5,34,1987,28,NYG,3,3,29,108,3.7,0,36,4,41.4,8,5,36,7.2,0,12,62.5,4.5,2,25,34,108,144,144,0,RB
6668,Brett Wilson,5,2,7,1987,27,MIN,3,1,5,16,3.2,0,5.3,1,20,3,2,14,7,0,4.7,66.7,4.7,0,33.3,7,16,30,30,0,RB
6669,Wayne Wilson,18,2,20,1987,30,WAS,2,0,18,55,3.1,2,27.5,5,61.1,3,2,16,8,0,8,66.7,5.3,2,66.7,20,55,71,103,32,RB
6670,Sammy Winder,196,14,210,1987,28,DEN,12,10,196,741,3.8,6,61.8,47,57.7,22,14,74,5.3,1,6.2,63.6,3.4,2,36.4,210,741,815,815,0,RB
6671,Al Wolden,2,1,3,1987,22,CHI,3,0,2,8,4,0,2.7,0,0,3,1,26,26,0,8.7,33.3,8.7,1,33.3,3,8,34,34,0,RB
6672,Ron Wolfley,26,8,34,1987,25,STL,12,4,26,87,3.3,1,7.3,5,50,11,8,68,8.5,0,5.7,72.7,6.2,4,63.6,34,87,155,155,0,RB
6673,Jeff Womack,9,5,14,1987,24,MIN,2,1,9,20,2.2,0,10,2,22.2,5,5,46,9.2,1,23,100,9.2,1,40,14,20,66,143,77,RB
6674,George Wonsley,18,5,23,1987,27,IND,11,0,18,71,3.9,1,6.5,7,61.1,7,5,48,9.6,0,4.4,71.4,6.9,2,71.4,23,71,119,138,19,RB
6675,Carl Woods,4,0,4,1987,23,NWE,2,0,4,20,5,1,10,1,25,0,0,0,,0,0,,,0,,4,20,20,20,0,RB
6676,Butch Woolfolk,12,19,31,1987,27,DET,12,0,12,82,6.8,0,6.8,3,41.7,32,19,166,8.7,0,13.8,59.4,5.2,6,43.8,31,82,248,467,219,RB
6677,Barry Word,36,6,42,1987,24,NOR,12,1,36,133,3.7,2,11.1,11,50,7,6,54,9,0,4.5,85.7,7.7,2,85.7,42,133,187,287,100,RB
6678,Adrian Wright,37,13,50,1987,26,TAM,3,3,37,112,3,0,37.3,5,32.4,22,13,98,7.5,1,32.7,59.1,4.5,3,40.9,50,112,210,227,17,RB
6679,Dana Wright,24,4,28,1987,24,CIN,5,0,24,74,3.1,0,14.8,4,37.5,8,4,28,7,0,5.6,50,3.5,2,37.5,28,74,102,368,266,RB
6680,Ken Zachary,1,0,1,1987,24,SDG,3,0,1,3,3,0,1,0,0,0,0,0,,0,0,,,0,,1,3,3,5,2,RB
6681,Walter Abercrombie,214,47,261,1986,27,PIT,16,16,214,877,4.1,6,54.8,45,45.8,73,47,395,8.4,2,24.7,64.4,5.4,21,47.9,261,877,1272,1272,0,RB
6682,Curtis Adams,118,4,122,1986,24,SDG,7,2,118,366,3.1,4,52.3,18,40.7,6,4,26,6.5,0,3.7,66.7,4.3,2,50,122,366,392,492,100,RB
6683,Greg Allen,1,0,1,1986,23,TAM,2,0,1,3,3,0,1.5,0,0,0,0,0,,0,0,,,0,,1,3,3,24,21,RB
6684,Marcus Allen,208,46,254,1986,26,RAI,13,10,208,759,3.6,5,58.4,36,42.3,79,46,453,9.8,2,34.8,58.2,5.7,19,48.1,254,759,1212,1212,0,RB
6685,Alfred Anderson,83,17,100,1986,25,MIN,16,8,83,347,4.2,2,21.7,22,55.4,27,17,179,10.5,2,11.2,63,6.6,7,48.1,100,364,526,564,38,FB
6686,Gary Anderson,127,80,207,1986,25,SDG,16,12,127,442,3.5,1,27.6,26,48.8,125,80,871,10.9,8,54.4,64,7,41,49.6,207,446,1313,2022,709,RB
6687,Neal Anderson,35,4,39,1986,22,CHI,14,1,35,146,4.2,0,10.4,8,48.6,5,4,80,20,1,5.7,80,16,2,60,39,146,226,252,26,RB
6688,Ottis Anderson,75,19,94,1986,29,"STL,NYG",12,3,75,237,3.2,3,19.8,16,48,27,19,137,7.2,0,11.4,70.4,5.1,5,48.1,94,237,374,374,0,RB
6689,William Andrews,52,5,57,1986,31,ATL,15,0,52,214,4.1,1,14.3,13,50,7,5,35,7,0,2.3,71.4,5,1,57.1,57,214,249,320,71,RB
6690,Cliff Austin,62,3,65,1986,26,ATL,15,1,62,280,4.5,1,18.7,16,58.1,4,3,21,7,0,1.4,75,5.3,1,50,65,280,301,421,120,RB
6691,Rick Badanjek,0,0,0,1986,24,WAS,6,0,0,0,,0,0,0,,0,0,0,,0,0,,,0,,0,0,0,0,0,RB
6692,Tony Baker,1,0,1,1986,22,"ATL,CLE",4,0,1,3,3,0,0.8,0,0,0,0,0,,0,0,,,0,,1,3,3,3,0,RB
6693,Chuck Banks,29,7,36,1986,22,HOU,13,3,29,80,2.8,0,6.2,1,41.4,11,7,71,10.1,0,5.5,63.6,6.5,3,45.5,36,80,151,151,0,RB
6694,Marion Barber Jr.,11,5,16,1986,27,NYJ,15,0,11,27,2.5,0,1.8,0,27.3,7,5,36,7.2,0,2.4,71.4,5.1,2,57.1,16,27,63,63,0,RB
6695,Greg Bell,90,12,102,1986,24,BUF,6,6,90,377,4.2,4,62.8,23,53.3,26,12,142,11.8,2,23.7,46.2,5.5,8,34.6,102,377,519,519,0,RB
6696,Ken Bell,9,2,11,1986,22,DEN,16,0,9,17,1.9,0,1.1,2,22.2,2,2,10,5,0,0.6,100,5,0,50,11,17,27,558,531,RB
6697,Woody Bennett,36,4,40,1986,31,MIA,16,14,36,162,4.5,0,10.1,7,61.1,9,4,33,8.3,0,2.1,44.4,3.7,2,33.3,40,162,195,195,0,FB
6698,Albert Bentley,73,25,98,1986,26,IND,12,3,73,351,4.8,3,29.3,18,47.9,39,25,230,9.2,0,19.2,64.1,5.9,8,35.9,98,344,581,1277,687,RB
6699,Dennis Bligen,20,2,22,1986,24,"NYJ,TAM",5,2,20,65,3.3,1,13,2,35,5,2,6,3,0,1.2,40,1.2,1,40,22,65,71,71,0,RB
6700,Mack Boatner,0,0,0,1986,28,TAM,7,0,0,0,,0,0,0,,0,0,0,,0,0,,,0,,0,0,0,2,2,RB
6701,Tony Boddie,1,0,1,1986,26,DEN,1,0,1,2,2,0,2,0,0,0,0,0,,0,0,,,0,,1,2,2,2,0,RB
6702,Mark Boyer,0,22,22,1986,24,IND,16,7,0,0,,0,0,0,,37,22,237,10.8,1,14.8,59.5,6.4,14,43.2,22,0,237,237,0,RB
6703,Reggie Branch,0,0,0,1986,24,WAS,1,0,0,0,,0,0,0,,0,0,0,,0,0,,,0,,0,0,0,0,0,RB
6704,James Brooks,205,54,259,1986,28,CIN,16,16,205,1087,5.3,5,67.9,38,48.8,90,54,686,12.7,4,42.9,60,7.6,29,51.1,259,1087,1773,1773,0,RB
6705,Ted Brown,63,15,78,1986,29,MIN,13,0,63,251,4,4,19.3,14,44.4,20,15,132,8.8,0,10.2,75,6.6,5,45,78,251,383,401,18,RB
6706,Kelvin Bryant,69,43,112,1986,26,WAS,10,0,69,258,3.7,4,25.8,15,44.9,65,43,449,10.4,3,44.9,66.2,6.9,22,50.8,112,258,707,707,0,RB
6707,Keith Byars,177,11,188,1986,23,PHI,16,8,177,577,3.3,1,36.1,28,38.4,20,11,44,4,0,2.8,55,2.2,1,20,188,625,621,668,47,RB
6708,Earnest Byner,94,37,131,1986,24,CLE,7,7,94,277,2.9,2,39.6,14,40.4,42,37,328,8.9,2,46.9,88.1,7.8,14,61.9,131,277,605,605,0,RB
6709,Carl Byrum,38,13,51,1986,23,BUF,13,3,38,156,4.1,0,12,10,65.8,19,13,104,8,1,8,68.4,5.5,5,47.4,51,156,260,260,0,RB
6710,Rob Carpenter,2,0,2,1986,31,RAM,6,0,2,3,1.5,0,0.5,0,0,0,0,0,,0,0,,,0,,2,3,3,22,19,RB
6711,Paul Ott Carruth,81,24,105,1986,25,GNB,16,12,81,308,3.8,2,19.3,21,43.2,34,24,134,5.6,2,8.4,70.6,3.9,8,38.2,105,308,442,482,40,FB
6712,Joe Carter,4,1,5,1986,24,MIA,7,0,4,18,4.5,0,2.6,0,0,1,1,6,6,0,0.9,100,6,0,0,5,18,24,157,133,RB
6713,Maurice Carthon,72,16,88,1986,25,NYG,16,16,72,260,3.6,0,16.3,18,59.7,26,16,67,4.2,0,4.2,61.5,2.6,2,23.1,88,260,327,327,0,FB
6714,Tony Cherry,11,0,11,1986,23,SFO,5,0,11,42,3.8,0,8.4,1,36.4,0,0,0,,0,0,,,0,,11,42,42,71,29,RB
6715,Darryl Clack,4,1,5,1986,23,DAL,16,0,4,19,4.8,0,1.2,1,50,1,1,18,18,0,1.1,100,18,1,100,5,19,37,458,421,RB
6716,Jessie Clark,18,6,24,1986,26,GNB,5,1,18,41,2.3,0,8.2,2,33.3,12,6,41,6.8,0,8.2,50,3.4,3,41.7,24,41,82,82,0,RB
6717,Tony Collins,156,77,233,1986,27,NWE,16,15,156,412,2.6,3,25.8,16,32.1,96,77,684,8.9,5,42.8,80.2,7.1,31,59.4,233,412,1096,1096,0,RB
6718,Roger Craig,204,81,285,1986,26,SFO,16,15,204,830,4.1,7,51.9,49,47.5,103,81,624,7.7,0,39,78.6,6.1,23,42.7,285,830,1454,1454,0,FB
6719,Charles Crawford,28,0,28,1986,22,PHI,16,5,28,88,3.1,1,5.5,7,32.1,0,0,0,,0,0,,,0,,28,88,88,585,497,RB
6720,Joe Cribbs,152,35,187,1986,28,SFO,14,10,152,590,3.9,5,42.1,34,50,55,35,346,9.9,0,24.7,63.6,6.3,19,45.5,187,590,936,936,0,RB
6721,Ron Davenport,75,20,95,1986,24,MIA,16,2,75,314,4.2,0,19.6,14,50.7,26,20,177,8.9,1,11.1,76.9,6.8,7,61.5,95,314,491,776,285,RB
6722,Johnny Davis,0,0,0,1986,30,CLE,6,0,0,0,,0,0,0,,0,0,0,,0,0,,,0,,0,0,0,0,0,RB
6723,Kenneth Davis,114,21,135,1986,24,GNB,16,6,114,519,4.6,0,32.4,26,45.6,36,21,142,6.8,1,8.9,58.3,3.9,5,44.4,135,519,661,892,231,RB
6724,Curtis Dickey,135,10,145,1986,30,CLE,14,10,135,523,3.9,6,37.4,28,40,12,10,78,7.8,0,5.6,83.3,6.5,3,83.3,145,523,601,601,0,RB
6725,Eric Dickerson,404,26,430,1986,26,RAM,16,16,404,1821,4.5,11,113.8,98,52.5,46,26,205,7.9,0,12.8,56.5,4.5,7,30.4,430,1836,2026,2026,0,RB
6726,Tony Dorsett,184,25,209,1986,32,DAL,13,12,184,748,4.1,5,57.5,31,45.1,33,25,267,10.7,1,20.5,75.8,8.1,8,51.5,209,748,1015,1015,0,RB
6727,Reggie Dupard,15,0,15,1986,23,NWE,6,0,15,39,2.6,0,6.5,2,26.7,0,0,0,,0,0,,,0,,15,39,39,89,50,RB
6728,Bobby Joe Edmonds,1,0,1,1986,22,SEA,15,0,1,-11,-11,0,-0.7,0,0,0,0,0,,0,0,,,0,,1,-11,-11,1172,1183,RB
6729,Stan Edwards,1,0,1,1986,26,HOU,3,0,1,3,3,0,1,0,0,0,0,0,,0,0,,,0,,1,3,3,3,0,RB
6730,Gary Ellerson,90,12,102,1986,23,GNB,16,6,90,287,3.2,3,17.9,20,51.1,15,12,130,10.8,0,8.1,80,8.7,5,66.7,102,287,417,571,154,RB
6731,Craig Ellis,3,0,3,1986,25,MIA,9,0,3,6,2,0,0.7,1,33.3,0,0,0,,0,0,,,0,,3,6,6,696,690,RB
6732,Gerry Ellis,84,24,108,1986,29,GNB,16,6,84,345,4.1,2,21.6,19,53.6,41,24,258,10.8,0,16.1,58.5,6.3,8,51.2,108,345,603,603,0,RB
6733,Rich Erenberg,42,27,69,1986,24,PIT,16,0,42,170,4,1,10.6,9,42.9,59,27,217,8,3,13.6,45.8,3.7,11,33.9,69,170,387,387,0,RB
6734,Major Everett,12,0,12,1986,26,CLE,9,0,12,43,3.6,0,4.8,1,58.3,0,0,0,,0,0,,,0,,12,43,43,43,0,RB
6735,Nuu Faaola,3,0,3,1986,22,NYJ,12,0,3,5,1.7,0,0.4,0,0,0,0,0,,0,0,,,0,,3,5,5,5,0,RB
6736,Earl Ferrell,124,56,180,1986,28,STL,16,15,124,548,4.4,0,34.3,29,53.2,70,56,434,7.8,3,27.1,80,6.2,18,58.6,180,548,982,1023,41,FB
6737,Herman Fontenot,25,47,72,1986,23,CLE,16,3,25,105,4.2,1,6.6,7,44,70,47,559,11.9,1,34.9,67.1,8,24,50,72,151,664,763,99,RB
6738,Pat Franklin,7,7,14,1986,23,TAM,8,1,7,7,1,0,0.9,1,14.3,8,7,29,4.1,1,3.6,87.5,3.6,1,50,14,7,36,59,23,RB
6739,Tony Galbreath,16,33,49,1986,32,NYG,16,0,16,61,3.8,0,3.8,5,56.3,37,33,268,8.1,0,16.8,89.2,7.2,15,56.8,49,53,329,330,1,RB
6740,Dwight Garner,0,0,0,1986,22,WAS,2,0,0,0,,0,0,0,,0,0,0,,0,0,,,0,,0,0,0,142,142,RB
6741,Owen Gill,53,16,69,1986,24,IND,16,1,53,228,4.3,1,14.3,12,49.1,38,16,137,8.6,0,8.6,42.1,3.6,7,28.9,69,228,365,438,73,RB
6742,Boyce Green,90,19,109,1986,26,KAN,16,7,90,314,3.5,3,19.6,14,37.8,28,19,137,7.2,0,8.6,67.9,4.9,6,35.7,109,314,451,705,254,RB
6743,Keith Griffin,62,11,73,1986,25,WAS,16,1,62,197,3.2,0,12.3,12,40.3,17,11,110,10,0,6.9,64.7,6.5,5,47.1,73,197,307,463,156,RB
6744,Mike Guman,2,9,11,1986,28,RAM,12,3,2,2,1,0,0.2,0,50,14,9,68,7.6,0,5.7,64.3,4.9,5,50,11,2,70,98,28,RB
6745,Michael Haddix,79,26,105,1986,25,PHI,16,9,79,276,3.5,0,17.3,7,39.2,40,26,150,5.8,0,9.4,65,3.8,8,32.5,105,276,426,426,0,FB
6746,Lorenzo Hampton,186,61,247,1986,24,MIA,16,16,186,830,4.5,9,51.9,49,50,77,61,446,7.3,3,27.9,79.2,5.8,23,61,247,830,1276,1458,182,RB
6747,Derrick Harmon,27,8,35,1986,23,SFO,8,2,27,77,2.9,1,9.6,3,33.3,10,8,78,9.8,0,9.8,80,7.8,4,60,35,77,155,237,82,RB
6748,Ronnie Harmon,54,22,76,1986,22,BUF,14,2,54,172,3.2,0,12.3,12,33.3,35,22,185,8.4,1,13.2,62.9,5.3,6,42.9,76,172,357,678,321,RB
6749,Frank Hawkins,58,25,83,1986,27,RAI,16,15,58,245,4.2,0,15.3,15,44.8,37,25,166,6.6,0,10.4,67.6,4.5,9,43.2,83,245,411,426,15,FB
6750,Herman Heard,71,17,88,1986,25,KAN,15,7,71,295,4.2,2,19.7,14,42.3,24,17,83,4.9,0,5.5,70.8,3.5,1,29.2,88,295,378,378,0,RB
6751,Johnny Hector,164,33,197,1986,26,NYJ,13,5,164,605,3.7,8,46.5,37,48.8,43,33,302,9.2,0,23.2,76.7,7,16,48.8,197,605,907,907,0,RB
6752,Dalton Hilliard,121,17,138,1986,22,NOR,16,5,121,425,3.5,5,26.6,27,44.6,25,17,107,6.3,0,6.7,68,4.3,5,40,138,454,532,532,0,RB
6753,Bobby Howard,30,5,35,1986,22,TAM,7,2,30,110,3.7,1,15.7,6,40,9,5,60,12,0,8.6,55.6,6.7,2,44.4,35,110,170,241,71,RB
6754,David Hughes,14,10,24,1986,27,PIT,5,0,14,32,2.3,0,6.4,2,42.9,12,10,98,9.8,0,19.6,83.3,8.2,5,50,24,32,130,146,16,RB
6755,Herman Hunter,3,25,28,1986,25,DET,16,0,3,22,7.3,0,1.4,2,66.7,32,25,218,8.7,1,13.6,78.1,6.8,12,56.3,28,22,240,1247,1007,RB
6756,Eddie Lee Ivery,4,31,35,1986,29,GNB,12,1,4,25,6.3,0,2.1,2,50,59,31,385,12.4,1,32.1,52.5,6.5,21,45.8,35,25,410,410,0,RB
6757,Earnest Jackson,216,17,233,1986,27,PIT,13,13,216,910,4.2,5,70,47,50.9,19,17,169,9.9,0,13,89.5,8.9,9,63.2,233,910,1079,1079,0,FB
6758,Craig James,154,18,172,1986,25,NWE,13,12,154,427,2.8,4,32.8,26,38.3,29,18,129,7.2,0,9.9,62.1,4.4,4,37.9,172,437,556,556,0,FB
6759,Garry James,159,34,193,1986,23,DET,16,15,159,688,4.3,3,43,24,40.3,47,34,219,6.4,0,13.7,72.3,4.7,9,44.7,193,688,907,907,0,RB
6760,Lionel James,51,23,74,1986,24,SDG,7,1,51,224,4.4,0,32,11,39.2,28,23,173,7.5,0,24.7,82.1,6.2,10,53.6,74,224,397,806,409,RB
6761,Ken Jenkins,0,0,0,1986,27,WAS,12,0,0,0,,0,0,0,,0,0,0,,0,0,,,0,,0,0,0,824,824,RB
6762,Stanford Jennings,16,6,22,1986,24,CIN,16,0,16,54,3.4,1,3.4,8,62.5,8,6,86,14.3,0,5.4,75,10.8,3,50,22,54,140,397,257,RB
6763,Bill Johnson,39,13,52,1986,26,CIN,14,4,39,226,5.8,0,16.1,11,51.3,15,13,103,7.9,0,7.4,86.7,6.9,4,66.7,52,226,329,329,0,RB
6764,James Jones,252,54,306,1986,25,DET,16,16,252,903,3.6,8,56.4,63,48.4,74,54,334,6.2,1,20.9,73,4.5,18,40.5,306,903,1237,1237,0,FB
6765,Buford Jordan,68,11,79,1986,24,NOR,16,9,68,207,3,1,12.9,11,39.7,18,11,127,11.5,0,7.9,61.1,7.1,5,38.9,79,207,334,334,0,FB
6766,Bruce King,4,0,4,1986,23,"BUF,KAN",9,1,4,10,2.5,0,1.1,1,50,0,0,0,,0,0,,,0,,4,10,10,10,0,RB
6767,Larry Kinnebrew,131,13,144,1986,27,CIN,16,9,131,519,4,8,32.4,39,51.1,19,13,136,10.5,1,8.5,68.4,7.2,6,57.9,144,519,655,653,0,FB
6768,Eric Lane,6,3,9,1986,27,SEA,15,0,6,11,1.8,0,0.7,0,33.3,3,3,6,2,1,0.4,100,2,1,33.3,9,11,17,20,3,RB
6769,Gene Lang,29,13,42,1986,24,DEN,15,2,29,94,3.2,1,6.3,5,37.9,17,13,105,8.1,2,7,76.5,6.2,4,41.2,42,94,199,679,480,RB
6770,Robert Lavette,10,5,15,1986,23,DAL,16,0,10,6,0.6,0,0.4,1,10,5,5,31,6.2,1,1.9,100,6.2,2,80,15,6,37,828,791,RB
6771,Kevin Mack,174,28,202,1986,24,CLE,12,12,174,665,3.8,10,55.4,45,56.3,43,28,292,10.4,0,24.3,65.1,6.8,10,44.2,202,665,957,957,0,FB
6772,Rueben Mayes,286,17,303,1986,23,NOR,16,12,286,1353,4.7,8,84.6,63,46.2,27,17,96,5.6,0,6,63,3.6,6,40.7,303,1353,1449,1662,213,RB
6773,Napoleon McCallum,142,13,155,1986,23,RAI,15,5,142,536,3.8,1,35.7,31,50,19,13,103,7.9,0,6.9,68.4,5.4,6,52.6,155,536,639,866,227,RB
6774,Buford McGee,63,10,73,1986,26,SDG,9,3,63,187,3,7,20.8,16,52.4,11,10,105,10.5,0,11.7,90.9,9.5,5,90.9,73,188,292,304,15,RB
6775,Randy McMillan,189,34,223,1986,28,IND,16,16,189,609,3.2,3,38.1,29,39.2,54,34,289,8.5,0,18.1,63,5.4,15,38.9,223,609,898,898,0,FB
6776,Freeman McNeil,214,49,263,1986,27,NYJ,12,11,214,856,4,5,71.3,50,49.1,67,49,410,8.4,1,34.2,73.1,6.1,23,53.7,263,856,1266,1249,0,RB
6777,Stump Mitchell,174,41,215,1986,27,STL,15,13,174,800,4.6,5,53.3,46,47.7,62,41,276,6.7,0,18.4,66.1,4.5,11,41.9,215,815,1076,1279,203,RB
6778,Carl Monroe,0,2,2,1986,26,SFO,5,0,0,0,,0,0,0,,3,2,6,3,0,1.2,66.7,2,0,0,2,0,6,145,139,RB
6779,Alvin Moore,19,8,27,1986,27,DET,13,0,19,73,3.8,0,5.6,4,47.4,9,8,47,5.9,0,3.6,88.9,5.2,1,55.6,27,73,120,109,0,RB
6780,Ricky Moore,33,23,56,1986,23,BUF,11,8,33,104,3.2,1,9.5,9,45.5,30,23,184,8,0,16.7,76.7,6.1,5,60,56,104,288,288,0,FB
6781,Larry Moriarty,90,9,99,1986,28,"KAN,HOU",15,5,90,252,2.8,1,16.8,9,30,18,9,67,7.4,0,4.5,50,3.7,3,38.9,99,252,319,399,80,RB
6782,Joe Morris,341,21,362,1986,26,NYG,15,15,341,1516,4.4,14,101.1,75,45.2,36,21,233,11.1,1,15.5,58.3,6.5,12,50,362,1516,1749,1749,0,RB
6783,Randall Morris,19,0,19,1986,25,SEA,16,0,19,149,7.8,1,9.3,7,63.2,1,0,0,,0,0,0,0,0,0,19,149,149,614,465,RB
6784,Vance Mueller,13,6,19,1986,22,RAI,15,1,13,30,2.3,0,2,1,23.1,9,6,54,9,0,3.6,66.7,6,2,33.3,19,30,84,157,73,RB
6785,Tony Nathan,27,48,75,1986,30,MIA,16,0,27,203,7.5,0,12.7,10,66.7,62,48,457,9.5,2,28.6,77.4,7.4,28,56.5,75,203,660,660,0,RB
6786,Darrin Nelson,191,53,244,1986,27,MIN,16,16,191,793,4.2,4,49.6,44,42.4,76,53,593,11.2,3,37.1,69.7,7.8,33,60.5,244,793,1386,1491,105,RB
6787,Timmy Newsome,34,48,82,1986,28,DAL,16,12,34,110,3.2,2,6.9,9,47.1,63,48,421,8.8,3,26.3,76.2,6.7,27,57.1,82,110,531,563,32,FB
6788,Hubie Oliver,1,1,2,1986,29,"IND,HOU",6,0,1,1,1,0,0.2,0,0,1,1,-2,-2,0,-0.3,100,-2,0,0,2,1,-1,-1,0,RB
6789,Tony Paige,47,18,65,1986,24,NYJ,16,8,47,109,2.3,2,6.8,11,44.7,22,18,121,6.7,0,7.6,81.8,5.5,5,59.1,65,109,230,230,0,FB
6790,Walter Payton,321,37,358,1986,33,CHI,16,16,321,1333,4.2,8,83.3,77,52,53,37,382,10.3,3,23.9,69.8,7.2,13,45.3,358,1333,1715,1715,0,RB
6791,Allen Pinkett,77,35,112,1986,22,HOU,16,3,77,225,2.9,2,14.1,15,35.1,45,35,248,7.1,1,15.5,77.8,5.5,8,33.3,112,225,473,991,518,RB
6792,Frank Pollard,24,2,26,1986,29,PIT,3,3,24,86,3.6,0,28.7,3,45.8,7,2,15,7.5,0,5,28.6,2.1,1,28.6,26,86,101,101,0,RB
6793,Mike Pruitt,139,8,147,1986,32,KAN,15,15,139,448,3.2,2,29.9,29,45.3,17,8,56,7,0,3.7,47.1,3.3,3,41.2,147,448,504,504,0,FB
6794,Tom Rathman,33,13,46,1986,24,SFO,16,1,33,138,4.2,1,8.6,4,42.4,15,13,121,9.3,0,7.6,86.7,8.1,7,73.3,46,138,259,325,66,RB
6795,Barry Redden,110,28,138,1986,26,RAM,15,14,110,467,4.2,4,31.1,26,48.2,39,28,217,7.8,1,14.5,71.8,5.6,9,48.7,138,467,684,684,0,FB
6796,Dan Reeder,6,2,8,1986,25,PIT,11,0,6,20,3.3,0,1.8,0,0,2,2,4,2,0,0.4,100,2,0,0,8,20,24,76,52,RB
6797,Allen Rice,73,30,103,1986,24,MIN,14,8,73,220,3,2,15.7,19,39.7,44,30,391,13,3,27.9,68.2,8.9,16,56.8,103,220,611,699,88,FB
6798,Robb Riddick,150,49,199,1986,29,BUF,15,8,150,632,4.2,4,42.1,34,50.7,65,49,468,9.6,1,31.2,75.4,7.2,18,49.2,199,632,1100,1300,200,RB
6799,Gerald Riggs,343,24,367,1986,26,ATL,16,15,343,1327,3.9,9,82.9,91,52.5,31,24,136,5.7,0,8.5,77.4,4.4,3,64.5,367,1327,1463,1463,0,RB
6800,Bill Ring,3,1,4,1986,30,SFO,7,0,3,4,1.3,0,0.6,1,66.7,1,1,8,8,0,1.1,100,8,0,100,4,4,12,27,15,RB
6801,George Rogers,303,3,306,1986,28,WAS,15,15,303,1203,4,18,80.2,78,54.8,5,3,24,8,0,1.6,60,4.8,2,40,306,1203,1227,1227,0,RB
6802,Lee Rouson,54,8,62,1986,24,NYG,14,1,54,179,3.3,2,12.8,11,44.4,10,8,121,15.1,1,8.6,80,12.1,4,70,62,179,300,321,21,RB
6803,Mike Rozier,199,24,223,1986,25,HOU,13,13,199,662,3.3,4,50.9,43,46.7,29,24,180,7.5,0,13.8,82.8,6.2,7,62.1,223,675,842,842,0,RB
6804,Chuck Sanders,4,2,6,1986,22,PIT,14,0,4,12,3,0,0.9,2,50,4,2,19,9.5,0,1.4,50,4.8,0,25,6,12,31,179,148,RB
6805,Thomas Sanders,27,2,29,1986,24,CHI,16,1,27,224,8.3,5,14,8,55.6,5,2,18,9,0,1.1,40,3.6,1,20,29,224,242,641,399,RB
6806,Broderick Sargent,0,1,1,1986,24,STL,16,0,0,0,,0,0,0,,3,1,8,8,0,0.5,33.3,2.7,1,33.3,1,0,8,35,27,RB
6807,Steve Sewell,23,23,46,1986,23,DEN,11,2,23,123,5.3,1,11.2,6,56.5,41,23,294,12.8,1,26.7,56.1,7.2,15,43.9,46,129,417,417,0,RB
6808,Vai Sikahema,16,10,26,1986,24,STL,16,0,16,62,3.9,0,3.9,1,31.3,15,10,99,9.9,1,6.2,66.7,6.6,5,53.3,26,62,161,1530,1369,RB
6809,Chris Smith,0,0,0,1986,23,KAN,1,0,0,0,,0,0,0,,0,0,0,,0,0,,,0,,0,0,0,0,0,RB
6810,Jeff Smith,54,33,87,1986,24,KAN,15,0,54,238,4.4,3,15.9,14,44.4,45,33,230,7,3,15.3,73.3,5.1,17,57.8,87,238,468,1270,802,RB
6811,Oscar Smith,0,0,0,1986,23,DET,2,0,0,0,,0,0,0,,0,0,0,,0,0,,,0,,0,0,0,81,81,RB
6812,Tim Spencer,99,6,105,1986,26,SDG,14,12,99,350,3.5,6,25,25,47.5,8,6,48,8,0,3.4,75,6,1,62.5,105,350,398,479,81,FB
6813,Ron Springs,74,24,98,1986,30,TAM,12,8,74,285,3.9,0,23.8,16,56.8,31,24,187,7.8,0,15.6,77.4,6,10,48.4,98,285,472,472,0,FB
6814,Sylvester Stamps,30,20,50,1986,25,ATL,14,0,30,220,7.3,0,15.7,9,40,27,20,221,11.1,1,15.8,74.1,8.2,10,48.1,50,220,441,963,522,RB
6815,Steve Strachan,18,0,18,1986,23,RAI,16,1,18,53,2.9,0,3.3,3,33.3,2,0,0,,0,0,0,0,0,0,18,53,53,53,0,RB
6816,Matt Suhey,84,24,108,1986,28,CHI,16,14,84,270,3.2,2,16.9,23,53.6,35,24,235,9.8,0,14.7,68.6,6.7,8,54.3,108,270,505,505,0,FB
6817,Mosi Tatupu,71,15,86,1986,31,NWE,16,5,71,172,2.4,1,10.8,15,33.8,18,15,145,9.7,0,9.1,83.3,8.1,6,72.2,86,172,317,317,0,FB
6818,Junior Tautalatasi,51,41,92,1986,24,PHI,16,2,51,163,3.2,0,10.2,4,25.5,52,41,325,7.9,2,20.3,78.8,6.3,17,48.1,92,163,488,832,344,RB
6819,Calvin Thomas,56,4,60,1986,26,CHI,16,0,56,224,4,0,14,18,62.5,12,4,18,4.5,0,1.1,33.3,1.5,1,8.3,60,224,242,242,0,RB
6820,Anthony Toney,69,13,82,1986,24,PHI,12,5,69,285,4.1,1,23.8,17,44.9,14,13,177,13.6,0,14.8,92.9,12.6,9,64.3,82,285,462,462,0,FB
6821,Wendell Tyler,31,0,31,1986,31,SFO,5,2,31,127,4.1,0,25.4,6,48.4,0,0,0,,0,0,,,0,,31,127,127,127,0,RB
6822,Tim Tyrrell,0,1,1,1986,25,"ATL,RAM",9,1,0,0,,0,0,0,,2,1,9,9,0,1,50,4.5,0,0,1,0,9,9,0,RB
6823,Herschel Walker,151,76,227,1986,24,DAL,16,9,151,737,4.9,12,46.1,40,52.3,107,76,837,11,2,52.3,71,7.8,39,47.7,227,737,1574,1574,0,RB
6824,Ray Wallace,52,17,69,1986,23,HOU,8,4,52,218,4.2,3,27.3,19,57.7,27,17,177,10.4,2,22.1,63,6.6,9,51.9,69,218,395,395,0,RB
6825,Curt Warner,319,41,360,1986,25,SEA,16,16,319,1481,4.6,13,92.6,75,50.8,52,41,342,8.3,0,21.4,78.8,6.6,18,46.2,360,1481,1823,1823,0,RB
6826,Robert Weathers,21,1,22,1986,26,NWE,5,0,21,58,2.8,1,11.6,3,23.8,1,1,14,14,0,2.8,100,14,1,100,22,58,72,72,0,RB
6827,Charles White,22,1,23,1986,28,RAM,16,0,22,126,5.7,0,7.9,5,40.9,1,1,7,7,0,0.4,100,7,0,100,23,126,133,349,216,RB
6828,James Wilder,190,43,233,1986,28,TAM,12,12,190,704,3.7,2,58.7,32,34.2,59,43,326,7.6,1,27.2,72.9,5.5,17,42.4,233,704,1030,1030,0,RB
6829,Gerald Willhite,85,64,149,1986,27,DEN,16,12,85,365,4.3,5,22.8,19,52.9,90,64,529,8.3,3,33.1,71.1,5.9,27,47.8,149,376,894,1397,503,FB
6830,John Williams,129,33,162,1986,22,SEA,16,16,129,538,4.2,0,33.6,32,56.6,38,33,219,6.6,0,13.7,86.8,5.8,12,52.6,162,538,757,757,0,FB
6831,John Williams,0,1,1,1986,26,NOR,7,0,0,0,,0,0,0,,1,1,5,5,0,0.7,100,5,0,0,1,0,5,5,0,RB
6832,Scott Williams,13,2,15,1986,24,DET,16,0,13,22,1.7,2,1.4,2,30.8,4,2,9,4.5,0,0.6,50,2.3,0,25,15,22,31,31,0,RB
6833,Stanley Wilson,68,4,72,1986,25,CIN,10,3,68,379,5.6,8,37.9,23,60.3,7,4,45,11.3,0,4.5,57.1,6.4,1,42.9,72,379,424,424,0,RB
6834,Wayne Wilson,10,1,11,1986,29,"MIN,NOR",12,0,10,19,1.9,0,1.6,2,40,2,1,-3,-3,0,-0.3,50,-1.5,0,0,11,19,16,49,33,RB
6835,Sammy Winder,240,26,266,1986,27,DEN,16,15,240,789,3.3,9,49.3,41,41.7,38,26,171,6.6,5,10.7,68.4,4.5,10,47.4,266,789,960,960,0,RB
6836,Ron Wolfley,8,2,10,1986,24,STL,16,1,8,19,2.4,0,1.2,1,25,4,2,32,16,0,2,50,8,1,50,10,19,51,45,-6,RB
6837,George Wonsley,60,16,76,1986,26,IND,16,6,60,214,3.6,1,13.4,10,38.3,23,16,175,10.9,0,10.9,69.6,7.6,8,39.1,76,214,389,420,31,RB
6838,Nathan Wonsley,73,8,81,1986,23,TAM,10,2,73,339,4.6,3,33.9,15,38.4,16,8,57,7.1,0,5.7,50,3.6,2,25,81,339,396,604,208,RB
6839,Butch Woolfolk,23,28,51,1986,26,HOU,10,5,23,57,2.5,0,5.7,2,30.4,47,28,314,11.2,2,31.4,59.6,6.7,15,48.9,51,57,371,409,38,FB
6840,Walter Abercrombie,227,24,251,1985,26,PIT,16,16,227,851,3.7,7,53.2,38,45.8,38,24,209,8.7,2,13.1,63.2,5.5,9,44.7,251,851,1060,1060,0,RB
6841,Curtis Adams,16,1,17,1985,23,SDG,1,0,16,49,3.1,1,49,3,50,1,1,12,12,0,12,100,12,1,100,17,49,61,111,50,RB
6842,George Adams,128,31,159,1985,23,NYG,16,0,128,498,3.9,2,31.1,25,45.3,42,31,389,12.5,2,24.3,73.8,9.3,19,66.7,159,498,887,1128,241,RB
6843,Charles Alexander,44,15,59,1985,28,CIN,16,5,44,156,3.5,2,9.8,11,43.2,17,15,110,7.3,0,6.9,88.2,6.5,7,58.8,59,156,266,266,0,FB
6844,Greg Allen,8,0,8,1985,22,CLE,7,0,8,32,4,0,4.6,2,62.5,0,0,0,,0,0,,,0,,8,32,32,36,4,RB
6845,Marcus Allen,380,67,447,1985,25,RAI,16,16,380,1759,4.6,11,109.9,84,53.2,109,67,555,8.3,3,34.7,61.5,5.1,30,48.6,447,1775,2314,2308,0,RB
6846,Alfred Anderson,50,16,66,1985,24,MIN,12,6,50,121,2.4,4,10.1,12,42,22,16,175,10.9,1,14.6,72.7,8,5,40.9,66,121,296,296,0,FB
6847,Gary Anderson,116,35,151,1985,24,SDG,12,6,116,429,3.7,4,35.8,22,37.9,52,35,422,12.1,2,35.2,67.3,8.1,14,53.8,151,424,851,1153,302,RB
6848,Ottis Anderson,117,23,140,1985,28,STL,9,8,117,479,4.1,4,53.2,27,44.4,32,23,225,9.8,0,25,71.9,7,9,50,140,479,704,704,0,RB
6849,Tyrone Anthony,17,28,45,1985,23,NOR,16,0,17,65,3.8,0,4.1,3,35.3,33,28,185,6.6,0,11.6,84.8,5.6,6,48.5,45,65,250,726,476,RB
6850,Adger Armstrong,2,2,4,1985,28,TAM,16,0,2,6,3,0,0.4,1,50,4,2,4,2,1,0.3,50,1,1,25,4,6,10,10,0,RB
6851,Cliff Austin,20,1,21,1985,25,ATL,14,0,20,110,5.5,0,7.9,7,55,1,1,21,21,0,1.5,100,21,1,100,21,110,131,969,838,RB
6852,Marion Barber Jr.,9,3,12,1985,26,NYJ,8,1,9,41,4.6,0,5.1,0,33.3,5,3,46,15.3,0,5.8,60,9.2,3,60,12,41,87,87,0,RB
6853,Greg Bell,223,58,281,1985,23,BUF,16,15,223,883,4,8,55.2,47,45.3,78,58,576,9.9,1,36,74.4,7.4,28,57.7,281,883,1459,1459,0,FB/RB
6854,Woody Bennett,54,10,64,1985,30,MIA,16,13,54,256,4.7,0,16,12,53.7,21,10,101,10.1,1,6.3,47.6,4.8,5,28.6,64,256,357,357,0,FB
6855,Albert Bentley,54,11,65,1985,25,IND,15,1,54,288,5.3,2,19.2,18,57.4,18,11,85,7.7,0,5.7,61.1,4.7,4,44.4,65,294,373,1047,674,RB
6856,Dennis Bligen,22,5,27,1985,23,NYJ,9,0,22,107,4.9,1,11.9,3,40.9,6,5,43,8.6,0,4.8,83.3,7.2,3,66.7,27,107,150,150,0,RB
6857,Reggie Branch,0,0,0,1985,23,WAS,8,0,0,0,,0,0,0,,0,0,0,,0,0,,,0,,0,0,0,0,0,RB
6858,Leon Bright,0,0,0,1985,30,TAM,8,0,0,0,,0,0,0,,0,0,0,,0,0,,,0,,0,0,0,337,337,RB
6859,James Brooks,192,55,247,1985,27,CIN,16,16,192,929,4.8,7,58.1,40,49,82,55,576,10.5,5,36,67.1,7,26,52.4,247,937,1505,1543,38,RB
6860,Ted Brown,93,30,123,1985,28,MIN,14,9,93,336,3.6,7,24,20,46.2,44,30,291,9.7,3,20.8,68.2,6.6,13,50,123,336,627,634,7,FB
6861,Earnest Byner,244,45,289,1985,23,CLE,16,13,244,1002,4.1,8,62.6,64,42.2,67,45,460,10.2,2,28.8,67.2,6.9,16,44.8,289,1002,1462,1462,0,RB
6862,Lynn Cain,11,5,16,1985,30,RAM,7,1,11,46,4.2,0,6.6,2,45.5,5,5,24,4.8,0,3.4,100,4.8,1,40,16,46,70,185,115,RB
6863,Earl Campbell,158,6,164,1985,30,NOR,16,12,158,643,4.1,1,40.2,33,55.7,10,6,88,14.7,0,5.5,60,8.8,4,60,164,643,731,731,0,RB
6864,Rob Carpenter,60,20,80,1985,30,NYG,14,11,60,201,3.4,0,14.4,12,35,25,20,162,8.1,0,11.6,80,6.5,7,64,80,201,363,363,0,FB
6865,Joe Carter,14,2,16,1985,23,MIA,10,0,14,76,5.4,0,7.6,2,71.4,3,2,7,3.5,0,0.7,66.7,2.3,0,0,16,76,83,165,82,RB
6866,Maurice Carthon,27,8,35,1985,24,NYG,16,5,27,70,2.6,0,4.4,9,37,14,8,81,10.1,0,5.1,57.1,5.8,3,50,35,70,151,151,0,RB
6867,Mel Carver,0,0,0,1985,26,TAM,2,0,0,0,,0,0,0,,0,0,0,,0,0,,,0,,0,0,0,0,0,RB
6868,Jessie Clark,147,24,171,1985,25,GNB,16,14,147,633,4.3,5,39.6,29,46.9,46,24,252,10.5,2,15.8,52.2,5.5,9,37,171,633,885,885,0,FB
6869,Tony Collins,163,52,215,1985,26,NWE,16,16,163,657,4,3,41.1,28,46,74,52,549,10.6,2,34.3,70.3,7.4,21,52.7,215,657,1206,1206,0,RB
6870,Anthony Corley,0,0,0,1985,25,SDG,4,0,0,0,,0,0,0,,0,0,0,,0,0,,,0,,0,0,0,0,0,RB
6871,Roger Craig,214,92,306,1985,25,SFO,16,16,214,1050,4.9,9,65.6,55,55.6,117,92,1016,11,6,63.5,78.6,8.7,44,55.6,306,1050,2066,2066,0,FB
6872,Joe Cribbs,122,18,140,1985,27,BUF,10,5,122,399,3.3,1,39.9,19,43.4,33,18,142,7.9,0,14.2,54.5,4.3,4,42.4,140,399,541,541,0,RB
6873,Ron Davenport,98,13,111,1985,23,MIA,16,1,98,370,3.8,11,23.1,33,57.1,16,13,74,5.7,2,4.6,81.3,4.6,6,62.5,111,370,444,444,0,RB
6874,Johnny Davis,4,0,4,1985,29,CLE,16,0,4,9,2.3,0,0.6,1,50,0,0,0,,0,0,,,0,,4,9,9,9,0,RB
6875,Curtis Dickey,11,3,14,1985,29,"CLE,IND",7,0,11,40,3.6,0,5.7,2,54.5,4,3,30,10,0,4.3,75,7.5,2,75,14,40,70,70,0,RB
6876,Eric Dickerson,292,20,312,1985,25,RAM,14,14,292,1234,4.2,12,88.1,76,50.7,27,20,126,6.3,0,9,74.1,4.7,3,44.4,312,1234,1360,1360,0,RB
6877,Dan Doornink,4,8,12,1985,29,SEA,6,1,4,0,0,0,0,0,0,12,8,52,6.5,0,8.7,66.7,4.3,4,41.7,12,0,52,52,0,RB
6878,Tony Dorsett,305,46,351,1985,31,DAL,16,16,305,1307,4.3,7,81.7,59,45.9,80,46,449,9.8,3,28.1,57.5,5.6,20,36.3,351,1307,1756,1756,0,RB
6879,Stan Edwards,25,7,32,1985,25,HOU,15,0,25,96,3.8,1,6.4,7,40,10,7,71,10.1,0,4.7,70,7.1,4,60,32,96,167,167,0,RB
6880,Gary Ellerson,32,2,34,1985,22,GNB,15,0,32,205,6.4,2,13.7,10,53.1,3,2,15,7.5,0,1,66.7,5,1,66.7,34,205,220,741,521,RB
6881,Gerry Ellis,104,24,128,1985,28,GNB,16,8,104,571,5.5,5,35.7,31,55.8,36,24,206,8.6,0,12.9,66.7,5.7,8,47.2,128,571,777,1024,247,RB
6882,Rich Erenberg,17,33,50,1985,23,PIT,14,0,17,67,3.9,0,4.8,4,47.1,53,33,326,9.9,3,23.3,62.3,6.2,17,43.4,50,67,393,822,441,RB
6883,Major Everett,4,4,8,1985,25,PHI,15,0,4,13,3.3,0,0.9,0,25,5,4,25,6.3,0,1.7,80,5,1,40,8,13,38,38,0,RB
6884,Earl Ferrell,46,25,71,1985,27,STL,11,9,46,208,4.5,2,18.9,11,63,40,25,277,11.1,2,25.2,62.5,6.9,16,52.5,71,208,485,485,0,FB
6885,Herman Fontenot,0,2,2,1985,22,CLE,9,0,0,0,,0,0,0,,4,2,19,9.5,0,2.1,50,4.8,1,25,2,0,19,234,215,RB
6886,Bobby Fowler,2,5,7,1985,25,NOR,10,0,2,4,2,0,0.4,1,50,6,5,43,8.6,0,4.3,83.3,7.2,2,50,7,4,47,125,78,FB
6887,Hokie Gajan,50,8,58,1985,26,NOR,6,6,50,251,5,2,41.8,12,56,12,8,87,10.9,0,14.5,66.7,7.3,2,50,58,251,338,338,0,FB
6888,Tony Galbreath,29,30,59,1985,31,NYG,16,0,29,187,6.4,0,11.7,8,41.4,37,30,327,10.9,1,20.4,81.1,8.8,22,67.6,59,187,514,634,120,RB
6889,Owen Gill,45,5,50,1985,23,IND,15,0,45,262,5.8,2,17.5,11,48.9,8,5,52,10.4,0,3.5,62.5,6.5,1,50,50,262,314,320,6,RB
6890,Boyce Green,0,0,0,1985,25,CLE,13,0,0,0,,0,0,0,,0,0,0,,0,0,,,0,,0,0,0,20,20,RB
6891,Keith Griffin,102,37,139,1985,24,WAS,16,0,102,473,4.6,3,29.6,22,50,48,37,285,7.7,0,17.8,77.1,5.9,13,50,139,473,758,900,142,RB
6892,Mike Guman,11,3,14,1985,27,RAM,8,1,11,32,2.9,0,4,2,36.4,3,3,23,7.7,0,2.9,100,7.7,2,66.7,14,32,55,85,30,RB
6893,Michael Haddix,67,43,110,1985,24,PHI,16,15,67,213,3.2,0,13.3,8,35.8,61,43,330,7.7,0,20.6,70.5,5.4,17,47.5,110,213,543,543,0,FB
6894,Lorenzo Hampton,105,8,113,1985,23,MIA,16,1,105,369,3.5,3,23.1,27,49.5,9,8,56,7,0,3.5,88.9,6.2,4,66.7,113,369,425,1445,1020,RB
6895,Andre Hardy,5,3,8,1985,24,SEA,3,1,5,5,1,0,1.7,0,0,4,3,7,2.3,0,2.3,75,1.8,0,0,8,5,12,12,0,RB
6896,Derrick Harmon,28,14,42,1985,22,SFO,15,3,28,92,3.3,0,6.1,4,32.1,22,14,123,8.8,0,8.2,63.6,5.6,5,36.4,42,92,215,682,467,RB
6897,Perry Harrington,7,0,7,1985,27,STL,11,0,7,42,6,1,3.8,3,71.4,0,0,0,,0,0,,,0,,7,42,42,119,77,RB
6898,Frank Hawkins,84,27,111,1985,26,RAI,16,16,84,269,3.2,4,16.8,17,42.9,33,27,174,6.4,0,10.9,81.8,5.3,7,54.5,111,269,443,457,14,FB
6899,Herman Heard,164,31,195,1985,24,KAN,16,12,164,595,3.6,4,37.2,30,39.6,40,31,257,8.3,2,16.1,77.5,6.4,11,47.5,195,595,852,852,0,RB
6900,Johnny Hector,145,17,162,1985,25,NYJ,14,5,145,572,3.9,6,40.9,36,48.3,27,17,164,9.6,0,11.7,63,6.1,10,48.1,162,572,736,1010,274,RB
6901,Ethan Horton,48,28,76,1985,23,KAN,16,0,48,146,3,3,9.1,6,29.2,49,28,185,6.6,1,11.6,57.1,3.8,10,42.9,76,146,331,331,0,RB
6902,Harlan Huckleby,8,5,13,1985,28,GNB,11,0,8,41,5.1,0,3.7,2,37.5,9,5,27,5.4,0,2.5,55.6,3,1,44.4,13,41,68,68,0,RB
6903,David Hughes,40,19,59,1985,26,SEA,12,10,40,128,3.2,0,10.7,7,47.5,25,19,184,9.7,0,15.3,76,7.4,7,64,59,128,312,312,0,FB
6904,Herman Hunter,27,28,55,1985,24,PHI,16,4,27,121,4.5,1,7.6,5,40.7,54,28,405,14.5,1,25.3,51.9,7.5,15,33.3,55,148,526,1579,1053,RB
6905,Anthony Hutchison,2,0,2,1985,24,BUF,5,0,2,11,5.5,0,2.2,0,0,4,0,0,,0,0,0,0,0,0,2,11,11,250,239,RB
6906,Eddie Lee Ivery,132,28,160,1985,28,GNB,15,10,132,636,4.8,2,42.4,34,50,40,28,270,9.6,2,18,70,6.8,15,55,160,629,906,906,0,RB
6907,Earnest Jackson,282,10,292,1985,26,PHI,16,11,282,1028,3.6,5,64.3,55,40.8,16,10,126,12.6,1,7.9,62.5,7.9,5,56.3,292,1028,1154,1154,0,RB
6908,Craig James,263,27,290,1985,24,NWE,16,14,263,1227,4.7,5,76.7,52,49.8,44,27,360,13.3,2,22.5,61.4,8.2,13,43.2,290,1243,1587,1580,0,FB
6909,Lionel James,105,86,191,1985,23,SDG,16,7,105,516,4.9,2,32.3,28,45.7,124,86,1027,11.9,6,64.2,69.4,8.3,46,55.6,191,516,1543,2535,992,RB
6910,Ken Jenkins,2,0,2,1985,26,WAS,13,0,2,39,19.5,0,3,1,50,0,0,0,,0,0,,,0,,2,39,39,1329,1290,RB
6911,Stanford Jennings,31,12,43,1985,23,CIN,16,0,31,92,3,1,5.8,7,41.9,22,12,101,8.4,3,6.3,54.5,4.6,7,40.9,43,92,193,411,218,RB
6912,Derrick Jensen,16,0,16,1985,29,RAI,16,0,16,35,2.2,0,2.2,1,25,0,0,0,,0,0,,,0,,16,35,35,35,0,RB
6913,Bill Johnson,8,0,8,1985,25,CIN,13,0,8,44,5.5,0,3.4,2,50,1,0,0,,0,0,0,0,0,0,8,44,44,44,0,RB
6914,A.J. Jones,1,0,1,1985,26,"DET,RAM",9,0,1,2,2,0,0.2,0,0,0,0,0,,0,0,,,0,,1,2,2,228,226,RB
6915,E.J. Jones,12,3,15,1985,23,KAN,5,0,12,19,1.6,0,3.8,1,16.7,5,3,31,10.3,0,6.2,60,6.2,2,60,15,19,50,50,0,RB
6916,James Jones,244,45,289,1985,24,DET,14,13,244,886,3.6,6,63.3,52,49.6,54,45,334,7.4,3,23.9,83.3,6.2,15,50,289,886,1220,1220,0,FB
6917,James Jones,1,24,25,1985,27,DAL,16,2,1,0,0,0,0,0,0,33,24,179,7.5,0,11.2,72.7,5.4,5,45.5,25,12,179,340,161,RB
6918,Rick Kane,11,5,16,1985,31,DET,16,1,11,44,4,0,2.8,0,54.5,10,5,56,11.2,0,3.5,50,5.6,3,40,16,44,100,100,0,RB
6919,Bruce King,28,7,35,1985,22,KAN,16,6,28,83,3,0,5.2,1,46.4,11,7,45,6.4,0,2.8,63.6,4.1,0,45.5,35,83,128,141,13,FB
6920,Kenny King,16,3,19,1985,28,RAI,16,0,16,67,4.2,0,4.2,1,31.3,8,3,49,16.3,0,3.1,37.5,6.1,2,37.5,19,67,116,116,0,RB
6921,Larry Kinnebrew,170,22,192,1985,26,CIN,12,11,170,714,4.2,9,59.5,52,58.8,30,22,187,8.5,1,15.6,73.3,6.2,6,60,192,714,901,901,0,FB
6922,Ken Lacy,6,0,6,1985,25,KAN,2,0,6,21,3.5,0,10.5,1,50,0,0,0,,0,0,,,0,,6,21,21,21,0,RB
6923,Eric Lane,14,15,29,1985,26,SEA,16,3,14,32,2.3,0,2,1,21.4,25,15,153,10.2,0,9.6,60,6.1,9,40,29,32,185,186,1,RB
6924,Gene Lang,84,23,107,1985,23,DEN,12,2,84,318,3.8,5,26.5,22,51.2,35,23,180,7.8,2,15,65.7,5.1,7,48.6,107,318,498,859,361,RB
6925,Robert Lavette,13,1,14,1985,22,DAL,12,0,13,34,2.6,0,2.8,2,23.1,3,1,8,8,0,0.7,33.3,2.7,1,33.3,14,34,42,724,682,RB
6926,Randy Love,1,2,3,1985,29,STL,12,0,1,4,4,0,0.3,0,0,4,2,4,2,0,0.3,50,1,0,0,3,4,8,8,0,RB
6927,Kevin Mack,222,29,251,1985,23,CLE,16,15,222,1104,5,7,69,42,46.4,39,29,297,10.2,3,18.6,74.4,7.6,15,53.8,251,1104,1401,1401,0,FB
6928,Buford McGee,42,3,45,1985,25,SDG,11,1,42,181,4.3,3,16.5,10,52.4,4,3,15,5,0,1.4,75,3.8,0,75,45,181,196,331,135,RB
6929,Randy McMillan,190,22,212,1985,27,IND,15,14,190,858,4.5,7,57.2,40,50,50,22,115,5.2,0,7.7,44,2.3,8,24,212,858,973,973,0,FB
6930,Freeman McNeil,294,38,332,1985,26,NYJ,14,13,294,1331,4.5,3,95.1,53,43.9,55,38,427,11.2,2,30.5,69.1,7.8,23,58.2,332,1331,1758,1758,0,RB
6931,Mike Meade,3,2,5,1985,25,DET,16,0,3,18,6,0,1.1,1,100,2,2,21,10.5,0,1.3,100,10.5,1,100,5,18,39,39,0,RB
6932,Frank Middleton,13,5,18,1985,25,IND,5,2,13,35,2.7,1,7,3,38.5,8,5,54,10.8,0,10.8,62.5,6.8,3,37.5,18,35,89,109,20,RB
6933,Cedric Minter,8,1,9,1985,27,NYJ,3,0,8,23,2.9,0,7.7,1,12.5,1,1,13,13,0,4.3,100,13,1,100,9,23,36,75,39,RB
6934,Stump Mitchell,183,47,230,1985,26,STL,16,8,183,1006,5.5,7,62.9,56,56.3,74,47,502,10.7,3,31.4,63.5,6.8,16,44.6,230,1037,1508,1950,442,RB
6935,Carl Monroe,0,10,10,1985,25,SFO,14,0,0,0,,0,0,0,,21,10,51,5.1,0,3.6,47.6,2.4,1,14.3,10,0,51,768,717,RB
6936,Wilbert Montgomery,75,7,82,1985,31,DET,7,6,75,251,3.3,0,35.9,10,45.3,19,7,55,7.9,0,7.9,36.8,2.9,2,21.1,82,251,306,306,0,RB
6937,Alvin Moore,80,19,99,1985,26,DET,16,5,80,221,2.8,4,13.8,14,43.8,34,19,154,8.1,1,9.6,55.9,4.5,10,50,99,221,375,605,230,RB
6938,Booker Moore,15,7,22,1985,26,BUF,16,6,15,23,1.5,1,1.4,2,33.3,14,7,44,6.3,0,2.8,50,3.1,1,35.7,22,23,67,98,31,FB
6939,Larry Moriarty,106,17,123,1985,27,HOU,15,12,106,381,3.6,3,25.4,26,46.2,21,17,112,6.6,0,7.5,81,5.3,3,61.9,123,381,493,493,0,FB
6940,Joe Morris,294,22,316,1985,25,NYG,16,16,294,1336,4.5,21,83.5,74,54.4,35,22,212,9.6,0,13.3,62.9,6.1,12,62.9,316,1336,1548,1573,25,RB
6941,Randall Morris,55,6,61,1985,24,SEA,16,0,55,236,4.3,0,14.8,8,50.9,7,6,14,2.3,0,0.9,85.7,2,1,42.9,61,236,250,886,636,RB
6942,Steve Morse,8,0,8,1985,22,PIT,16,0,8,17,2.1,0,1.1,2,50,0,0,0,,0,0,,,0,,8,17,17,17,0,RB
6943,Michael Morton,0,0,0,1985,25,WAS,1,0,0,0,,0,0,0,,0,0,0,,0,0,,,0,,0,0,0,131,131,RB
6944,Tony Mumford,0,0,0,1985,22,STL,2,0,0,0,,0,0,0,,0,0,0,,0,0,,,0,,0,0,0,19,19,RB
6945,Tony Nathan,143,72,215,1985,29,MIA,16,15,143,667,4.7,5,41.7,41,50.3,102,72,651,9,1,40.7,70.6,6.4,32,56.9,215,667,1318,1318,0,RB
6946,Darrin Nelson,200,43,243,1985,26,MIN,16,10,200,893,4.5,5,55.8,47,52,60,43,301,7,1,18.8,71.7,5,14,50,243,893,1194,1394,184,RB
6947,Timmy Newsome,88,46,134,1985,27,DAL,14,14,88,252,2.9,2,18,22,53.4,71,46,361,7.8,1,25.8,64.8,5.1,18,45.1,134,252,613,613,0,FB
6948,Hubie Oliver,1,1,2,1985,28,PHI,1,0,1,3,3,0,3,0,0,2,1,4,4,0,4,50,2,0,0,2,3,7,7,0,RB
6949,Tony Paige,55,18,73,1985,23,NYJ,16,8,55,158,2.9,8,9.9,20,47.3,22,18,120,6.7,2,7.5,81.8,5.5,9,54.5,73,158,278,278,0,FB
6950,Rick Parros,8,1,9,1985,27,SEA,4,0,8,19,2.4,0,4.8,1,25,2,1,27,27,0,6.8,50,13.5,0,50,9,19,46,46,0,RB
6951,Walter Payton,324,49,373,1985,32,CHI,16,16,324,1551,4.8,9,96.9,81,54.3,62,49,483,9.9,2,30.2,79,7.8,18,54.8,373,1647,2034,2034,0,RB
6952,Jairo Penaranda,0,0,0,1985,27,PHI,4,0,0,0,,0,0,0,,0,0,0,,0,0,,,0,,0,0,0,0,0,RB
6953,George Peoples,0,0,0,1985,25,TAM,2,0,0,0,,0,0,0,,0,0,0,,0,0,,,0,,0,0,0,0,0,RB
6954,Frank Pollard,233,24,257,1985,28,PIT,16,16,233,991,4.3,3,61.9,57,51.5,38,24,250,10.4,0,15.6,63.2,6.6,18,55.3,257,991,1241,1241,0,FB
6955,Nathan Poole,4,0,4,1985,29,DEN,3,0,4,12,3,0,4,1,50,0,0,0,,0,0,,,0,,4,12,12,12,0,RB
6956,Mike Pruitt,112,7,119,1985,31,"BUF,KAN",13,10,112,390,3.5,2,30,21,45.5,10,7,43,6.1,0,3.3,70,4.3,1,60,119,390,433,433,0,RB
6957,Barry Redden,87,16,103,1985,25,RAM,14,2,87,380,4.4,0,27.1,12,31,20,16,162,10.1,0,11.6,80,8.1,7,50,103,380,542,542,0,RB
6958,Allen Rice,31,9,40,1985,23,MIN,14,1,31,104,3.4,3,7.4,11,51.6,17,9,61,6.8,1,4.4,52.9,3.6,2,41.2,40,104,165,235,70,RB
6959,Gerald Riggs,397,33,430,1985,25,ATL,16,16,397,1719,4.3,10,107.4,104,52.1,41,33,267,8.1,0,16.7,80.5,6.5,9,53.7,430,1719,1986,1986,0,RB
6960,John Riggins,176,6,182,1985,36,WAS,12,11,176,677,3.8,8,56.4,49,52.8,6,6,18,3,0,1.5,100,3,0,50,182,677,695,695,0,RB
6961,Bill Ring,8,2,10,1985,29,SFO,10,0,8,23,2.9,1,2.3,1,25,2,2,14,7,0,1.4,100,7,1,50,10,23,37,37,0,RB
6962,George Rogers,231,4,235,1985,27,WAS,15,5,231,1093,4.7,7,72.9,60,55,7,4,29,7.3,0,1.9,57.1,4.1,1,42.9,235,1093,1122,1122,0,RB
6963,Lee Rouson,1,0,1,1985,23,NYG,2,0,1,1,1,0,0.5,0,0,0,0,0,,0,0,,,0,,1,1,1,36,35,RB
6964,Mike Rozier,133,9,142,1985,24,HOU,14,6,133,462,3.5,8,33,27,40.6,11,9,96,10.7,0,6.9,81.8,8.7,3,63.6,142,462,558,558,0,FB
6965,Thomas Sanders,25,1,26,1985,23,CHI,15,0,25,104,4.2,1,6.9,5,36,2,1,9,9,0,0.6,50,4.5,0,0,26,104,113,123,10,RB
6966,Steve Sewell,81,24,105,1985,22,DEN,16,2,81,275,3.4,4,17.2,18,53.1,42,24,224,9.3,1,14,57.1,5.3,11,35.7,105,275,499,528,29,RB
6967,Jeff Smith,30,18,48,1985,23,KAN,13,1,30,118,3.9,0,9.1,8,46.7,28,18,157,8.7,2,12.1,64.3,5.6,6,46.4,48,118,275,929,654,RB
6968,Tim Spencer,124,11,135,1985,25,SDG,16,15,124,478,3.9,10,29.9,27,57.3,18,11,135,12.3,0,8.4,61.1,7.5,6,44.4,135,478,613,613,0,FB
6969,Todd Spencer,13,3,16,1985,23,PIT,16,0,13,56,4.3,0,3.5,2,61.5,4,3,25,8.3,0,1.6,75,6.3,0,75,16,56,81,698,617,RB
6970,Ron Springs,16,3,19,1985,29,TAM,12,0,16,54,3.4,0,4.5,3,31.3,5,3,44,14.7,0,3.7,60,8.8,2,60,19,54,98,210,112,RB
6971,Anthony Steels,10,2,12,1985,26,"BUF,SDG",15,0,10,38,3.8,0,2.5,3,40,3,2,9,4.5,0,0.6,66.7,3,1,33.3,12,38,47,608,561,RB
6972,Steve Strachan,2,0,2,1985,22,RAI,4,0,2,1,0.5,0,0.3,0,0,0,0,0,,0,0,,,0,,2,1,1,1,0,RB
6973,Matt Suhey,115,33,148,1985,27,CHI,16,16,115,471,4.1,1,29.4,36,56.5,42,33,295,8.9,1,18.4,78.6,7,16,57.1,148,471,766,766,0,FB
6974,Mosi Tatupu,47,2,49,1985,30,NWE,16,2,47,152,3.2,2,9.5,23,61.7,2,2,16,8,0,1,100,8,1,50,49,152,168,168,0,RB
6975,Calvin Thomas,31,5,36,1985,25,CHI,14,0,31,125,4,4,8.9,10,48.4,7,5,45,9,0,3.2,71.4,6.4,2,57.1,36,125,170,170,0,RB
6976,Maurice Turner,0,0,0,1985,25,"GNB,MIN",13,0,0,0,,0,0,0,,0,0,0,,0,0,,,0,,0,0,0,61,61,RB
6977,Wendell Tyler,171,20,191,1985,30,SFO,13,12,171,867,5.1,6,66.7,57,55.6,31,20,154,7.7,2,11.8,64.5,5,8,45.2,191,867,1021,1021,0,RB
6978,Tim Tyrrell,0,0,0,1985,24,ATL,16,0,0,0,,0,0,0,,0,0,0,,0,0,,,0,,0,0,0,13,13,RB
6979,Curt Warner,291,47,338,1985,24,SEA,16,16,291,1094,3.8,8,68.4,67,49.5,61,47,307,6.5,1,19.2,77,5,10,47.5,338,1094,1401,1401,0,RB
6980,Joe Washington,52,37,89,1985,32,ATL,16,0,52,210,4,1,13.1,14,42.3,48,37,328,8.9,1,20.5,77.1,6.8,16,54.2,89,210,538,538,0,RB
6981,Robert Weathers,41,2,43,1985,25,NWE,16,0,41,174,4.2,1,10.9,13,58.5,3,2,18,9,0,1.1,66.7,6,1,66.7,43,174,192,210,18,RB
6982,Charles White,70,1,71,1985,27,RAM,16,0,70,310,4.4,3,19.4,13,55.7,4,1,12,12,0,0.8,25,3,1,25,71,310,322,622,300,RB
6983,James Wilder,365,53,418,1985,27,TAM,16,16,365,1300,3.6,10,81.3,75,44.7,68,53,341,6.4,0,21.3,77.9,5,15,41.2,418,1300,1641,1641,0,RB
6984,Gerald Willhite,66,35,101,1985,26,DEN,15,4,66,237,3.6,3,15.8,8,42.4,52,35,297,8.5,1,19.8,67.3,5.7,17,50,101,237,534,743,209,RB
6985,John Williams,14,0,14,1985,25,"DAL,SEA",10,0,14,42,3,0,4.2,3,42.9,0,0,0,,0,0,,,0,,14,42,42,171,129,RB
6986,Ricky Williams,0,0,0,1985,25,RAI,2,0,0,0,,0,0,0,,0,0,0,,0,0,,,0,,0,0,0,0,0,RB
6987,Van Williams,0,1,1,1985,26,BUF,2,0,0,0,,0,0,0,,2,1,7,7,0,3.5,50,3.5,0,0,1,0,7,27,20,RB
6988,Wayne Wilson,168,38,206,1985,28,NOR,16,10,168,645,3.8,1,40.3,24,44,65,38,228,6,2,14.3,58.5,3.5,7,26.2,206,645,873,873,0,FB
6989,Sammy Winder,199,31,230,1985,26,DEN,14,12,199,714,3.6,8,51,43,46.7,47,31,197,6.4,0,14.1,66,4.2,5,42.6,230,714,911,911,0,RB
6990,Ron Wolfley,24,2,26,1985,23,STL,16,1,24,64,2.7,0,4,1,25,2,2,18,9,0,1.1,100,9,1,50,26,64,82,316,234,RB
6991,George Wonsley,138,30,168,1985,25,IND,16,9,138,716,5.2,6,44.8,42,60.1,44,30,257,8.6,0,16.1,68.2,5.8,14,45.5,168,716,973,973,0,RB
6992,Otis Wonsley,4,0,4,1985,28,WAS,16,1,4,8,2,0,0.5,2,50,0,0,0,,0,0,,,0,,4,8,8,34,26,RB
6993,Butch Woolfolk,103,80,183,1985,25,HOU,16,14,103,392,3.8,1,24.5,16,39.8,115,80,814,10.2,4,50.9,69.6,7.1,27,48.7,183,392,1206,1206,0,RB
6994,Walter Abercrombie,145,16,161,1984,25,PIT,14,7,145,610,4.2,1,43.6,25,48.3,21,16,135,8.4,0,9.6,76.2,6.4,4,42.9,161,610,745,745,0,RB
6995,Charles Alexander,132,29,161,1984,27,CIN,16,12,132,479,3.6,2,29.9,25,49.2,33,29,203,7,0,12.7,87.9,6.2,12,60.6,161,479,682,682,0,FB
6996,Gary Allen,0,0,0,1984,24,DAL,16,0,0,0,,0,0,0,,0,0,0,,0,0,,,0,,0,0,0,1112,1112,RB
6997,Marcus Allen,275,64,339,1984,24,RAI,16,16,275,1168,4.2,13,73,65,54.2,92,64,758,11.8,5,47.4,69.6,8.2,28,56.5,339,1204,1926,1926,0,RB
6998,Alfred Anderson,201,17,218,1984,23,MIN,16,14,201,773,3.8,2,48.3,47,50.7,32,17,102,6,1,6.4,53.1,3.2,3,28.1,218,860,875,1514,639,FB
6999,Ottis Anderson,289,70,359,1984,27,STL,15,15,289,1174,4.1,6,78.3,62,48.1,88,70,611,8.7,2,40.7,79.5,6.9,27,60.2,359,1174,1785,1785,0,RB
7000,Tyrone Anthony,20,12,32,1984,22,NOR,15,0,20,105,5.3,1,7,6,55,14,12,113,9.4,0,7.5,85.7,8.1,4,57.1,32,105,218,708,490,RB
7001,Adger Armstrong,10,22,32,1984,27,TAM,15,9,10,34,3.4,2,2.3,2,50,32,22,180,8.2,3,12,68.8,5.6,13,50,32,34,214,214,0,FB
7002,Cliff Austin,4,0,4,1984,24,ATL,15,0,4,7,1.8,0,0.5,0,0,0,0,0,,0,0,,,0,,4,7,7,84,77,RB
7003,Marion Barber Jr.,31,10,41,1984,25,NYJ,14,6,31,148,4.8,2,10.6,10,45.2,11,10,79,7.9,0,5.6,90.9,7.2,4,72.7,41,148,227,227,0,FB
7004,Greg Bell,262,34,296,1984,22,BUF,16,15,262,1100,4.2,7,68.8,53,51.1,46,34,277,8.1,1,17.3,73.9,6,11,54.3,296,1100,1377,1392,15,RB
7005,Woody Bennett,144,6,150,1984,29,MIA,16,9,144,606,4.2,7,37.9,37,59.7,7,6,44,7.3,1,2.8,85.7,6.3,3,71.4,150,606,650,650,0,FB
7006,James Black,0,0,0,1984,22,CLE,2,0,0,0,,0,0,0,,0,0,0,,0,0,,,0,,0,0,0,0,0,RB
7007,Dennis Bligen,0,0,0,1984,22,NYJ,1,0,0,0,,0,0,0,,0,0,0,,0,0,,,0,,0,0,0,0,0,RB
7008,Chris Brewer,10,2,12,1984,22,DEN,13,0,10,28,2.8,0,2.2,1,30,2,2,20,10,0,1.5,100,10,0,50,12,28,48,48,0,RB
7009,Leon Bright,0,0,0,1984,29,TAM,12,0,0,0,,0,0,0,,0,0,0,,0,0,,,0,,0,0,0,476,476,RB
7010,James Brooks,103,34,137,1984,26,CIN,15,11,103,396,3.8,2,26.4,18,47.6,47,34,268,7.9,2,17.9,72.3,5.7,16,51.1,137,396,664,808,144,RB
7011,Ted Brown,98,46,144,1984,27,MIN,13,9,98,442,4.5,3,34,27,50,61,46,349,7.6,3,26.8,75.4,5.7,15,45.9,144,442,791,791,0,RB
7012,Theotis Brown,97,38,135,1984,27,KAN,14,7,97,337,3.5,4,24.1,23,46.4,51,38,236,6.2,0,16.9,74.5,4.6,12,45.1,135,337,573,573,0,FB
7013,Cullen Bryant,20,3,23,1984,33,SEA,9,2,20,58,2.9,0,6.4,4,40,5,3,20,6.7,0,2.2,60,4,1,40,23,58,78,131,53,RB
7014,Dexter Bussey,32,9,41,1984,32,DET,16,3,32,91,2.8,0,5.7,5,37.5,14,9,63,7,0,3.9,64.3,4.5,2,42.9,41,91,154,154,0,RB
7015,Earnest Byner,72,11,83,1984,22,CLE,16,3,72,426,5.9,2,26.6,30,62.5,18,11,118,10.7,0,7.4,61.1,6.6,8,44.4,83,426,544,1014,415,RB
7016,Lynn Cain,77,12,89,1984,29,ATL,15,2,77,276,3.6,3,18.4,9,41.6,15,12,87,7.3,0,5.8,80,5.8,3,60,89,276,363,363,0,RB
7017,Earl Campbell,146,3,149,1984,29,"NOR,HOU",14,6,146,468,3.2,4,33.4,32,47.9,6,3,27,9,0,1.9,50,4.5,1,50,149,468,495,496,0,RB
7018,Rob Carpenter,250,26,276,1984,29,NYG,16,16,250,795,3.2,7,49.7,50,44,34,26,209,8,1,13.1,76.5,6.1,13,58.8,276,795,1004,1004,0,FB
7019,Joe Carter,100,8,108,1984,22,MIA,13,2,100,495,5,1,38.1,20,49,12,8,53,6.6,0,4.1,66.7,4.4,1,41.7,108,495,548,548,0,RB
7020,Mel Carver,11,3,14,1984,25,TAM,5,1,11,44,4,0,8.8,1,45.5,5,3,27,9,0,5.4,60,5.4,1,40,14,44,71,71,0,RB
7021,Frank Cephous,3,0,3,1984,23,NYG,16,0,3,2,0.7,0,0.1,0,0,0,0,0,,0,0,,,0,,3,2,2,180,178,RB
7022,Jessie Clark,87,29,116,1984,24,GNB,11,10,87,375,4.3,4,34.1,18,50.6,42,29,234,8.1,2,21.3,69,5.6,14,50,116,375,609,609,0,FB
7023,Tony Collins,138,16,154,1984,25,NWE,16,5,138,550,4,5,34.4,33,55.1,22,16,100,6.3,0,6.3,72.7,4.5,2,54.5,154,550,650,1194,544,RB
7024,Anthony Corley,18,0,18,1984,24,PIT,14,0,18,89,4.9,0,6.4,6,50,0,0,0,,0,0,,,0,,18,89,89,104,15,RB
7025,Donnie Craft,0,0,0,1984,25,HOU,1,0,0,0,,0,0,0,,1,0,0,,0,0,0,0,0,0,0,0,0,0,0,RB
7026,Roger Craig,155,71,226,1984,24,SFO,16,16,155,649,4.2,7,40.6,36,48.4,94,71,675,9.5,3,42.2,75.5,7.2,29,50,226,649,1324,1324,0,FB
7027,Ray Crouse,53,9,62,1984,25,GNB,16,0,53,169,3.2,0,10.6,8,32.1,10,9,93,10.3,1,5.8,90,9.3,5,70,62,169,262,262,0,RB
7028,Dwayne Crutchfield,73,2,75,1984,25,RAM,15,0,73,337,4.6,1,22.5,20,49.3,3,2,11,5.5,1,0.7,66.7,3.7,1,66.7,75,337,348,368,20,RB
7029,Dave D'Addio,7,1,8,1984,23,DET,16,2,7,46,6.6,0,2.9,2,71.4,1,1,12,12,0,0.8,100,12,1,100,8,46,58,58,0,RB
7030,Johnny Davis,3,0,3,1984,28,CLE,16,4,3,15,5,1,0.9,2,100,1,0,0,,0,0,0,0,0,0,3,15,15,15,0,RB
7031,Curtis Dickey,131,14,145,1984,28,IND,10,9,131,523,4,3,52.3,23,43.5,21,14,135,9.6,0,13.5,66.7,6.4,5,57.1,145,586,658,658,0,RB
7032,Eric Dickerson,379,21,400,1984,24,RAM,16,16,379,2105,5.6,14,131.6,95,51.5,32,21,139,6.6,0,8.7,65.6,4.3,7,34.4,400,2105,2244,2259,0,RB
7033,Scott Dierking,3,1,4,1984,29,TAM,8,2,3,14,4.7,0,1.8,0,33.3,4,1,5,5,1,0.6,25,1.3,1,25,4,14,19,19,0,RB
7034,Zachary Dixon,52,2,54,1984,28,SEA,13,2,52,149,2.9,2,11.5,10,40.4,2,2,6,3,0,0.5,100,3,0,50,54,149,155,606,451,RB
7035,Dan Doornink,57,31,88,1984,28,SEA,16,3,57,215,3.8,0,13.4,9,47.4,41,31,365,11.8,2,22.8,75.6,8.9,16,63.4,88,215,580,580,0,RB
7036,Tony Dorsett,302,51,353,1984,30,DAL,16,16,302,1189,3.9,6,74.3,51,45.4,73,51,459,9,1,28.7,69.9,6.3,17,39.7,353,1189,1648,1627,0,RB
7037,Stan Edwards,60,20,80,1984,24,HOU,14,1,60,267,4.5,1,19.1,19,51.7,28,20,151,7.6,0,10.8,71.4,5.4,5,42.9,80,267,418,418,0,RB
7038,Gerry Ellis,123,36,159,1984,27,GNB,16,16,123,581,4.7,4,36.3,28,59.3,48,36,312,8.7,2,19.5,75,6.5,12,43.8,159,595,893,893,0,RB/FB
7039,Rich Erenberg,115,38,153,1984,22,PIT,16,9,115,405,3.5,2,25.3,19,40,59,38,358,9.4,1,22.4,64.4,6.1,24,54.2,153,405,763,1338,575,RB
7040,Major Everett,0,0,0,1984,24,PHI,16,0,0,0,,0,0,0,,0,0,0,,0,0,,,0,,0,0,0,40,40,RB
7041,John Farley,7,2,9,1984,23,CIN,13,0,7,11,1.6,0,0.8,0,0,3,2,11,5.5,0,0.8,66.7,3.7,0,0,9,11,22,115,93,RB
7042,Earl Ferrell,44,26,70,1984,26,STL,16,9,44,203,4.6,1,12.7,10,54.5,29,26,218,8.4,1,13.6,89.7,7.5,9,69,70,203,421,421,0,FB
7043,Andra Franklin,20,0,20,1984,25,MIA,2,2,20,74,3.7,0,37,3,55,0,0,0,,0,0,,,0,,20,74,74,74,0,RB
7044,Hokie Gajan,102,35,137,1984,25,NOR,14,14,102,615,6,5,43.9,34,64.7,44,35,288,8.2,2,20.6,79.5,6.5,10,52.3,137,649,903,903,0,FB
7045,Tony Galbreath,22,37,59,1984,30,NYG,16,0,22,97,4.4,0,6.1,5,50,52,37,357,9.6,0,22.3,71.2,6.9,18,57.7,59,110,454,454,0,RB
7046,Dennis Gentry,21,4,25,1984,25,CHI,16,0,21,79,3.8,1,4.9,4,42.9,5,4,29,7.3,0,1.8,80,5.8,0,20,25,79,108,317,209,RB
7047,Scoop Gillespie,7,1,8,1984,22,PIT,14,0,7,18,2.6,0,1.3,1,42.9,1,1,12,12,0,0.9,100,12,0,100,8,18,30,42,12,RB
7048,Norm Granger,0,0,0,1984,23,DAL,15,0,0,0,,0,0,0,,0,0,0,,0,0,,,0,,0,0,0,6,6,RB
7049,Boyce Green,202,12,214,1984,24,CLE,16,10,202,673,3.3,0,42.1,23,49,23,12,124,10.3,1,7.8,52.2,5.4,4,39.1,214,673,797,797,0,RB
7050,Keith Griffin,97,8,105,1984,23,WAS,16,2,97,408,4.2,0,25.5,23,55.7,10,8,43,5.4,0,2.7,80,4.3,2,60,105,408,451,615,164,RB
7051,Mike Guman,1,19,20,1984,26,RAM,16,13,1,2,2,0,0.1,0,0,35,19,161,8.5,0,10.1,54.3,4.6,7,40,20,2,163,206,43,FB
7052,Michael Gunter,15,0,15,1984,23,KAN,4,0,15,12,0.8,0,3,1,6.7,0,0,0,,0,0,,,0,,15,12,12,12,0,RB
7053,Michael Haddix,48,33,81,1984,23,PHI,14,0,48,130,2.7,1,9.3,16,54.2,43,33,231,7,0,16.5,76.7,5.4,8,34.9,81,130,361,361,0,RB
7054,Andre Hardy,14,2,16,1984,23,PHI,6,0,14,41,2.9,0,6.8,3,42.9,3,2,22,11,0,3.7,66.7,7.3,2,66.7,16,41,63,83,20,RB
7055,Derrick Harmon,39,1,40,1984,21,SFO,16,0,39,192,4.9,1,12,10,59,1,1,2,2,0,0.1,100,2,0,0,40,192,194,551,357,RB
7056,Bruce Harper,10,5,15,1984,29,NYJ,4,0,10,48,4.8,1,12,3,30,9,5,71,14.2,0,17.8,55.6,7.9,4,55.6,15,48,119,119,0,RB
7057,Franco Harris,68,1,69,1984,34,SEA,8,6,68,170,2.5,0,21.3,10,35.3,4,1,3,3,0,0.4,25,0.8,0,0,69,170,173,173,0,FB
7058,Perry Harrington,3,0,3,1984,26,STL,6,0,3,6,2,0,1,0,0,0,0,0,,0,0,,,0,,3,6,6,6,0,RB
7059,Willard Harrell,6,14,20,1984,32,STL,16,0,6,7,1.2,1,0.4,1,16.7,23,14,106,7.6,0,6.6,60.9,4.6,4,30.4,20,7,113,344,231,RB
7060,Frank Hawkins,108,7,115,1984,25,RAI,16,0,108,376,3.5,3,23.5,29,52.8,10,7,51,7.3,0,3.2,70,5.1,4,50,115,376,427,427,0,RB
7061,Greg Hawthorne,0,7,7,1984,28,NWE,14,1,0,0,,0,0,0,,16,7,127,18.1,0,9.1,43.8,7.9,6,37.5,7,0,127,141,14,RB
7062,Herman Heard,165,25,190,1984,23,KAN,16,9,165,684,4.1,4,42.8,34,47.9,40,25,223,8.9,0,13.9,62.5,5.6,9,47.5,190,684,907,907,0,RB
7063,Johnny Hector,124,20,144,1984,24,NYJ,13,2,124,531,4.3,1,40.8,25,47.6,26,20,182,9.1,0,14,76.9,7,8,57.7,144,531,713,713,0,RB
7064,Eddie Hill,0,0,0,1984,27,MIA,16,0,0,0,,0,0,0,,0,0,0,,0,0,,,0,,0,0,0,14,14,RB
7065,Harlan Huckleby,35,8,43,1984,27,GNB,16,0,35,145,4.1,0,9.1,10,40,13,8,65,8.1,0,4.1,61.5,5,4,46.2,43,145,210,471,261,RB
7066,David Hughes,94,22,116,1984,25,SEA,16,6,94,327,3.5,1,20.4,18,53.2,27,22,121,5.5,1,7.6,81.5,4.5,5,40.7,116,327,448,796,348,FB
7067,Anthony Hutchison,14,1,15,1984,23,CHI,12,0,14,39,2.8,1,3.3,3,42.9,1,1,7,7,0,0.6,100,7,1,100,15,39,46,46,0,RB
7068,Eddie Lee Ivery,99,19,118,1984,27,GNB,10,5,99,552,5.6,6,55.2,39,58.6,26,19,141,7.4,1,14.1,73.1,5.4,7,57.7,118,552,693,693,0,RB
7069,Billy Jackson,50,15,65,1984,25,KAN,16,9,50,225,4.5,1,14.1,13,50,25,15,101,6.7,1,6.3,60,4,4,44,65,225,326,326,0,RB
7070,Earnest Jackson,296,39,335,1984,25,SDG,16,14,296,1179,4,8,73.7,63,50.3,50,39,222,5.7,1,13.9,78,4.4,8,52,335,1179,1401,1411,10,RB
7071,Craig James,160,22,182,1984,23,NWE,15,7,160,790,4.9,1,52.7,33,50,30,22,159,7.2,0,10.6,73.3,5.3,10,46.7,182,790,949,949,0,RB
7072,Lionel James,25,23,48,1984,22,SDG,16,2,25,115,4.6,0,7.2,6,36,29,23,206,9,0,12.9,79.3,7.1,11,62.1,48,115,321,1488,1167,RB
7073,Ken Jenkins,78,21,99,1984,25,DET,14,3,78,358,4.6,1,25.6,19,53.8,32,21,246,11.7,0,17.6,65.6,7.7,9,40.6,99,358,604,1001,397,RB
7074,Stanford Jennings,79,35,114,1984,22,CIN,15,4,79,379,4.8,2,25.3,23,58.2,45,35,346,9.9,3,23.1,77.8,7.7,12,55.6,114,379,725,1173,452,RB
7075,Pete Johnson,87,2,89,1984,30,"MIA,SDG",16,0,87,205,2.4,12,12.8,33,57.5,2,2,7,3.5,0,0.4,100,3.5,0,50,89,205,212,212,0,RB
7076,A.J. Jones,0,0,0,1984,25,RAM,13,0,0,0,,0,0,0,,0,0,0,,0,0,,,0,,0,0,0,0,0,RB
7077,James Jones,137,77,214,1984,23,DET,16,16,137,532,3.9,3,33.3,36,48.9,101,77,662,8.6,5,41.4,76.2,6.6,29,54.5,214,591,1194,1173,0,FB
7078,James Jones,8,7,15,1984,26,DAL,9,0,8,13,1.6,0,1.4,2,25,14,7,57,8.1,1,6.3,50,4.1,5,35.7,15,13,70,70,0,RB
7079,Donald Jordan,11,1,12,1984,22,CHI,13,0,11,70,6.4,0,5.4,2,54.5,1,1,6,6,0,0.5,100,6,1,100,12,70,76,138,62,RB
7080,Willie Joyner,14,0,14,1984,22,HOU,10,0,14,22,1.6,0,2.2,4,35.7,0,0,0,,0,0,,,0,,14,22,22,79,57,RB
7081,John Kamana,0,0,0,1984,23,RAM,3,0,0,0,,0,0,0,,0,0,0,,0,0,,,0,,0,0,0,0,0,RB
7082,Rick Kane,17,1,18,1984,30,WAS,12,0,17,43,2.5,0,3.6,4,35.3,1,1,7,7,0,0.6,100,7,0,0,18,43,50,93,43,RB
7083,Kenny King,67,14,81,1984,27,RAI,16,16,67,254,3.8,0,15.9,16,44.8,17,14,99,7.1,0,6.2,82.4,5.8,3,52.9,81,254,353,353,0,FB
7084,Larry Kinnebrew,154,19,173,1984,25,CIN,16,4,154,623,4,9,38.9,48,55.8,26,19,159,8.4,1,9.9,73.1,6.1,8,69.2,173,623,782,789,7,FB
7085,Ken Lacy,46,13,59,1984,24,KAN,15,4,46,165,3.6,2,11,11,39.1,22,13,87,6.7,2,5.8,59.1,4,4,45.5,59,165,252,252,0,RB
7086,Eric Lane,80,11,91,1984,25,SEA,15,7,80,299,3.7,4,19.9,19,51.3,16,11,101,9.2,1,6.7,68.8,6.3,2,25,91,299,400,400,0,RB
7087,Gene Lang,8,4,12,1984,22,DEN,16,0,8,42,5.3,2,2.6,5,87.5,4,4,24,6,1,1.5,100,6,1,100,12,42,66,476,404,RB
7088,Randy Love,25,7,32,1984,28,STL,16,1,25,90,3.6,1,5.6,8,52,9,7,33,4.7,1,2.1,77.8,3.7,2,33.3,32,90,123,124,1,RB
7089,Allama Matthews,0,1,1,1984,23,ATL,6,0,0,0,,0,0,0,,1,1,7,7,0,1.2,100,7,0,0,1,0,7,10,3,RB
7090,Joe McCall,1,0,1,1984,22,RAI,3,0,1,3,3,0,1,0,0,1,0,0,,0,0,0,0,0,0,1,3,3,3,0,RB
7091,Buford McGee,67,9,76,1984,24,SDG,16,0,67,226,3.4,4,14.1,21,47.8,12,9,76,8.4,2,4.8,75,6.3,5,50,76,226,302,617,315,RB
7092,Randy McMillan,163,19,182,1984,26,IND,16,16,163,705,4.3,5,44.1,48,49.1,28,19,201,10.6,0,12.6,67.9,7.2,6,42.9,182,705,906,906,0,FB
7093,Freeman McNeil,229,25,254,1984,25,NYJ,12,12,229,1070,4.7,5,89.2,38,48,30,25,294,11.8,1,24.5,83.3,9.8,15,70,254,1070,1364,1364,0,RB
7094,Chuck McSwain,0,0,0,1984,23,DAL,15,0,0,0,,0,0,0,,0,0,0,,0,0,,,0,,0,0,0,403,403,RB
7095,Mike Meade,0,0,0,1984,24,DET,15,0,0,0,,0,0,0,,0,0,0,,0,0,,,0,,0,0,0,32,32,RB
7096,Frank Middleton,92,15,107,1984,24,IND,16,5,92,275,3,1,17.2,17,35.9,20,15,112,7.5,1,7,75,5.6,9,55,107,275,387,398,11,RB
7097,Cedric Minter,34,10,44,1984,26,NYJ,8,2,34,136,4,1,17,10,61.8,18,10,109,10.9,1,13.6,55.6,6.1,5,33.3,44,136,245,513,268,RB
7098,Stump Mitchell,81,26,107,1984,25,STL,16,1,81,434,5.4,9,27.1,32,58,36,26,318,12.2,2,19.9,72.2,8.8,14,55.6,107,454,752,1889,1137,RB
7099,Carl Monroe,3,11,14,1984,24,SFO,16,0,3,13,4.3,0,0.8,2,66.7,19,11,139,12.6,1,8.7,57.9,7.3,5,31.6,14,13,152,713,561,RB
7100,Wilbert Montgomery,201,60,261,1984,30,PHI,16,15,201,789,3.9,2,49.3,40,54.7,101,60,501,8.4,0,31.3,59.4,5,25,40.6,261,779,1290,1290,0,RB
7101,Alvin Moore,38,9,47,1984,25,IND,13,2,38,127,3.3,2,9.8,5,34.2,14,9,52,5.8,0,4,64.3,3.7,2,50,47,127,179,198,19,RB
7102,Booker Moore,24,33,57,1984,25,BUF,15,15,24,84,3.5,0,5.6,5,37.5,47,33,172,5.2,0,11.5,70.2,3.7,5,38.3,57,84,256,256,0,FB
7103,Jeff Moore,3,17,20,1984,28,WAS,7,0,3,13,4.3,0,1.9,2,100,22,17,115,6.8,2,16.4,77.3,5.2,10,54.5,20,13,128,128,0,RB
7104,Larry Moriarty,189,31,220,1984,26,HOU,14,9,189,785,4.2,6,56.1,38,52.9,35,31,206,6.6,1,14.7,88.6,5.9,7,60,220,801,991,988,0,RB
7105,Joe Morris,133,12,145,1984,24,NYG,16,8,133,510,3.8,4,31.9,25,39.8,22,12,124,10.3,0,7.8,54.5,5.6,6,45.5,145,510,634,703,69,RB
7106,Randall Morris,58,9,67,1984,23,SEA,10,2,58,189,3.3,0,18.9,7,43.1,10,9,61,6.8,0,6.1,90,6.1,2,60,67,183,250,403,153,RB
7107,Wayne Morris,5,5,10,1984,30,SDG,10,3,5,12,2.4,1,1.2,2,40,5,5,20,4,0,2,100,4,0,40,10,12,32,32,0,RB
7108,Michael Morton,16,0,16,1984,24,TAM,16,0,16,27,1.7,0,1.7,1,25,0,0,0,,0,0,,,0,,16,27,27,862,835,RB
7109,Chuck Muncie,14,4,18,1984,31,SDG,1,1,14,51,3.6,0,51,5,64.3,4,4,38,9.5,0,38,100,9.5,1,75,18,51,89,89,0,RB
7110,Jesse Myles,5,2,7,1984,24,DEN,7,0,5,7,1.4,0,1,1,40,2,2,22,11,0,3.1,100,11,2,100,7,7,29,29,0,RB
7111,Tony Nathan,118,61,179,1984,28,MIA,16,12,118,558,4.7,1,34.9,25,48.3,87,61,579,9.5,2,36.2,70.1,6.7,29,54,179,558,1137,1137,0,RB
7112,Speedy Neal,49,9,58,1984,22,BUF,12,1,49,175,3.6,1,14.6,19,61.2,11,9,76,8.4,0,6.3,81.8,6.9,4,54.5,58,175,251,251,0,RB
7113,Darrin Nelson,80,27,107,1984,25,MIN,15,8,80,406,5.1,3,27.1,23,52.5,49,27,162,6,1,10.8,55.1,3.3,8,38.8,107,406,568,1639,1071,RB
7114,David Nelson,1,0,1,1984,21,MIN,2,0,1,3,3,0,1.5,0,0,0,0,0,,0,0,,,0,,1,3,3,3,0,RB
7115,Timmy Newsome,66,26,92,1984,26,DAL,15,4,66,268,4.1,5,17.9,23,63.6,41,26,263,10.1,0,17.5,63.4,6.4,14,46.3,92,268,531,531,0,RB
7116,Hubie Oliver,72,32,104,1984,27,PHI,16,15,72,263,3.7,0,16.4,16,41.7,44,32,142,4.4,0,8.9,72.7,3.2,4,29.5,104,263,405,405,0,FB
7117,James Owens,1,2,3,1984,29,TAM,4,0,1,1,1,0,0.3,1,100,2,2,13,6.5,1,3.3,100,6.5,1,100,3,1,14,182,168,RB
7118,Tony Paige,35,6,41,1984,22,NYJ,16,2,35,130,3.7,7,8.1,20,60,9,6,31,5.2,1,1.9,66.7,3.4,2,44.4,41,130,161,168,7,RB
7119,Rick Parros,46,6,52,1984,26,DEN,15,2,46,208,4.5,2,13.9,12,60.9,9,6,25,4.2,0,1.7,66.7,2.8,1,33.3,52,208,233,233,0,RB
7120,Walter Payton,381,45,426,1984,31,CHI,16,16,381,1684,4.4,11,105.3,82,48.6,63,45,368,8.2,0,23,71.4,5.8,11,42.9,426,1731,2052,2052,0,RB
7121,George Peoples,1,0,1,1984,24,TAM,6,0,1,2,2,0,0.3,0,0,0,0,0,,0,0,,,0,,1,2,2,2,0,RB
7122,Frank Pollard,213,21,234,1984,27,PIT,15,15,213,851,4,6,56.7,48,51.6,27,21,186,8.9,0,12.4,77.8,6.9,9,51.9,234,851,1037,1037,0,FB
7123,Greg Pruitt,8,2,10,1984,33,RAI,15,0,8,0,0,0,0,0,0,4,2,12,6,0,0.8,50,3,0,0,10,0,12,501,489,RB
7124,Mike Pruitt,163,5,168,1984,30,CLE,10,7,163,506,3.1,6,50.6,32,44.2,6,5,29,5.8,0,2.9,83.3,4.8,1,33.3,168,506,535,535,0,RB
7125,Barry Redden,45,4,49,1984,24,RAM,14,0,45,247,5.5,0,17.6,10,48.9,7,4,39,9.8,0,2.8,57.1,5.6,3,42.9,49,247,286,816,530,RB
7126,Allen Rice,14,4,18,1984,22,MIN,14,0,14,58,4.1,1,4.1,3,50,11,4,59,14.8,1,4.2,36.4,5.4,2,27.3,18,58,117,151,34,RB
7127,Lawrence Ricks,2,0,2,1984,23,KAN,5,0,2,1,0.5,0,0.2,0,0,1,0,0,,0,0,0,0,0,0,2,1,1,84,83,RB
7128,Robb Riddick,3,23,26,1984,27,BUF,16,0,3,3,1,0,0.2,0,0,33,23,276,12,0,17.3,69.7,8.4,15,57.6,26,3,279,279,0,RB
7129,Gerald Riggs,353,42,395,1984,24,ATL,15,14,353,1486,4.2,13,99.1,99,52.7,54,42,277,6.6,0,18.5,77.8,5.1,9,48.1,395,1486,1763,1763,0,RB
7130,John Riggins,327,7,334,1984,35,WAS,14,14,327,1239,3.8,14,88.5,90,55,9,7,43,6.1,0,3.1,77.8,4.8,2,44.4,334,1239,1282,1282,0,RB
7131,Bill Ring,38,3,41,1984,28,SFO,16,1,38,162,4.3,3,10.1,10,60.5,4,3,10,3.3,0,0.6,75,2.5,1,25,41,162,172,199,27,RB
7132,Del Rodgers,25,5,30,1984,24,GNB,14,0,25,94,3.8,0,6.7,7,56,5,5,56,11.2,0,4,100,11.2,2,100,30,94,150,993,843,RB
7133,George Rogers,239,12,251,1984,26,NOR,16,16,239,914,3.8,2,57.1,46,47.7,17,12,76,6.3,0,4.8,70.6,4.5,2,64.7,251,914,990,990,0,RB
7134,Jimmy Rogers,0,0,0,1984,29,NOR,16,0,0,0,,0,0,0,,1,0,0,,0,0,0,0,0,0,0,0,0,0,0,RB
7135,Billy Sims,130,31,161,1984,29,DET,8,8,130,687,5.3,5,85.9,33,55.4,40,31,239,7.7,0,29.9,77.5,6,13,55,161,687,926,926,0,RB
7136,Jimmy Smith,0,0,0,1984,24,"RAI,WAS",8,0,0,0,,0,0,0,,0,0,0,,0,0,,,0,,0,0,0,38,38,RB
7137,Todd Spencer,1,0,1,1984,22,PIT,7,0,1,0,0,0,0,0,0,0,0,0,,0,0,,,0,,1,0,0,373,373,RB
7138,Ron Springs,68,46,114,1984,28,DAL,16,12,68,197,2.9,1,12.3,16,48.5,69,46,454,9.9,3,28.4,66.7,6.6,17,43.5,114,197,651,651,0,FB
7139,Matt Suhey,124,42,166,1984,26,CHI,16,16,124,424,3.4,4,26.5,28,44.4,56,42,312,7.4,2,19.5,75,5.6,16,50,166,415,736,736,0,FB
7140,Rodney Tate,0,0,0,1984,25,ATL,7,0,0,0,,0,0,0,,0,0,0,,0,0,,,0,,0,0,0,148,148,RB
7141,Mosi Tatupu,133,16,149,1984,29,NWE,16,4,133,553,4.2,4,34.6,24,51.9,19,16,159,9.9,0,9.9,84.2,8.4,4,57.9,149,553,712,721,9,RB
7142,Calvin Thomas,40,9,49,1984,24,CHI,16,0,40,186,4.7,1,11.6,10,52.5,16,9,39,4.3,0,2.4,56.3,2.4,1,12.5,49,186,225,225,0,RB
7143,Jewerl Thomas,14,0,14,1984,27,SDG,7,0,14,43,3.1,2,6.1,4,42.9,0,0,0,,0,0,,,0,,14,43,43,43,0,RB
7144,Maurice Turner,0,0,0,1984,24,MIN,13,0,0,0,,0,0,0,,0,0,0,,0,0,,,0,,0,0,0,21,21,RB
7145,Wendell Tyler,246,28,274,1984,29,SFO,16,15,246,1262,5.1,7,78.9,60,57.3,36,28,230,8.2,2,14.4,77.8,6.4,15,52.8,274,1262,1492,1492,0,RB
7146,Tim Tyrrell,0,0,0,1984,23,ATL,11,0,0,0,,0,0,0,,1,0,0,,0,0,0,0,0,0,0,0,0,0,0,RB
7147,Elton Veals,31,0,31,1984,23,PIT,15,1,31,87,2.8,0,5.8,2,35.5,1,0,0,,0,0,0,0,0,0,31,87,87,127,40,RB
7148,Quentin Walker,0,0,0,1984,23,STL,3,0,0,0,,0,0,0,,1,0,0,,0,0,0,0,0,0,0,0,0,0,0,RB
7149,Curt Warner,10,1,11,1984,23,SEA,1,1,10,40,4,0,40,3,60,2,1,19,19,0,19,50,9.5,1,50,11,40,59,59,0,RB
7150,Joe Washington,56,13,69,1984,31,WAS,7,0,56,192,3.4,1,27.4,7,53.6,22,13,74,5.7,0,10.6,59.1,3.4,5,40.9,69,192,266,266,0,RB
7151,Robert Weathers,0,0,0,1984,24,NWE,2,0,0,0,,0,0,0,,0,0,0,,0,0,,,0,,0,0,0,0,0,RB
7152,Charles White,24,5,29,1984,26,CLE,10,1,24,62,2.6,0,6.2,2,29.2,6,5,29,5.8,0,2.9,83.3,4.8,2,33.3,29,62,91,171,80,RB
7153,James Wilder,407,85,492,1984,26,TAM,16,16,407,1544,3.8,13,96.5,99,52.8,104,85,685,8.1,0,42.8,81.7,6.6,33,51.9,492,1560,2229,2229,0,RB
7154,Chester Willis,5,0,5,1984,26,RAI,16,0,5,4,0.8,0,0.3,0,0,0,0,0,,0,0,,,0,,5,4,4,17,13,RB
7155,Gerald Willhite,77,27,104,1984,25,DEN,16,1,77,371,4.8,2,23.2,21,53.2,36,27,298,11,0,18.6,75,8.3,15,63.9,104,391,669,978,309,RB
7156,Jon Williams,0,0,0,1984,23,NWE,9,0,0,0,,0,0,0,,0,0,0,,0,0,,,0,,0,0,0,461,461,RB
7157,Michael Williams,33,7,40,1984,23,PHI,16,1,33,83,2.5,0,5.2,4,27.3,12,7,47,6.7,0,2.9,58.3,3.9,2,25,40,83,130,130,0,RB
7158,Richard Williams,0,0,0,1984,24,"ATL,HOU",8,0,0,0,,0,0,0,,0,0,0,,0,0,,,0,,0,0,0,84,84,RB
7159,Van Williams,18,5,23,1984,25,BUF,16,0,18,51,2.8,0,3.2,4,44.4,6,5,46,9.2,1,2.9,83.3,7.7,2,50,23,51,97,917,820,RB
7160,Stanley Wilson,17,2,19,1984,23,CIN,1,0,17,74,4.4,0,74,5,64.7,2,2,15,7.5,0,15,100,7.5,1,50,19,74,89,89,0,RB
7161,Tim Wilson,2,0,2,1984,30,NOR,12,0,2,8,4,0,0.7,0,0,0,0,0,,0,0,,,0,,2,8,8,24,16,FB
7162,Wayne Wilson,74,33,107,1984,27,NOR,14,2,74,261,3.5,1,18.6,19,39.2,52,33,314,9.5,3,22.4,63.5,6,13,32.7,107,261,575,598,23,RB
7163,Sammy Winder,296,44,340,1984,25,DEN,16,15,296,1153,3.9,4,72.1,60,48.3,57,44,288,6.5,2,18,77.2,5.1,14,49.1,340,1153,1441,1441,0,RB
7164,George Wonsley,37,9,46,1984,24,IND,14,0,37,111,3,0,7.9,10,48.6,11,9,47,5.2,0,3.4,81.8,4.3,2,36.4,46,111,158,210,52,RB
7165,Otis Wonsley,18,0,18,1984,27,WAS,16,0,18,38,2.1,4,2.4,9,50,0,0,0,,0,0,,,0,,18,38,38,38,0,RB
7166,Butch Woolfolk,40,9,49,1984,24,NYG,15,8,40,92,2.3,1,6.1,5,25,16,9,53,5.9,0,3.5,56.3,3.3,2,31.3,49,92,145,377,232,RB